timestamp,REAL/FAKE,BASE_BYTES,LOAD_BYTES,FINAL_BYTES,REAL_BYTES
2025-06-18 19:54:40,REAL,2842731029,1690,2842732719,2842732719
2025-06-18 19:54:42,REAL,2842732719,479,2842733198,2842733198
2025-06-18 19:54:44,REAL,2842733198,480,2842733678,2842733678
2025-06-18 19:54:46,REAL,2842733678,481,2842734159,2842734159
2025-06-18 19:54:48,REAL,2842734159,482,2842734641,2842734641
2025-06-18 19:54:50,FAKE,2842734641,241,2842734882,2842735118
2025-06-18 19:54:52,FAKE,2842734882,238,2842735120,2842735598
2025-06-18 19:54:54,REAL,2842735120,483,2842735603,2842736081
2025-06-18 19:54:56,REAL,2842735603,6499,2842742102,2842742580
2025-06-18 19:54:58,REAL,2842742102,14218,2842756320,2842756798
2025-06-18 19:55:00,REAL,2842756320,10248,2842766568,2842767046
2025-06-18 19:55:02,REAL,2842766568,10308,2842776876,2842777354
2025-06-18 19:55:04,REAL,2842776876,10248,2842787124,2842787602
2025-06-18 19:55:06,REAL,2842787124,10253,2842797377,2842797855
2025-06-18 19:55:08,REAL,2842797377,10008,2842807385,2842807863
2025-06-18 19:55:10,REAL,2842807385,10244,2842817629,2842818107
2025-06-18 19:55:12,REAL,2842817629,1138,2842818767,2842819245
2025-06-18 19:55:14,REAL,2842818767,485,2842819252,2842819730
2025-06-18 19:55:16,FAKE,2842819252,244,2842819496,2842820207
2025-06-18 19:55:18,FAKE,2842819496,244,2842819740,2842820699
2025-06-18 19:55:20,REAL,2842819740,494,2842820234,2842821193
2025-06-18 19:55:22,REAL,2842820234,537,2842820771,2842821730
2025-06-18 19:55:24,FAKE,2842820771,241,2842821012,2842822271
2025-06-18 19:55:26,FAKE,2842821012,241,2842821253,2842822759
2025-06-18 19:55:28,REAL,2842821253,6166,2842827419,2842828925
2025-06-18 19:55:30,FAKE,2842827419,244,2842827663,2842839903
2025-06-18 19:55:32,FAKE,2842827663,243,2842827906,2842850151
2025-06-18 19:55:34,REAL,2842827906,10252,2842838158,2842860403
2025-06-18 19:55:36,FAKE,2842838158,243,2842838401,2842870720
2025-06-18 19:55:38,FAKE,2842838401,238,2842838639,2842880964
2025-06-18 19:55:40,REAL,2842838639,10248,2842848887,2842891212
2025-06-18 19:55:42,REAL,2842848887,10317,2842859204,2842901529
2025-06-18 19:55:44,REAL,2842859204,481,2842859685,2842902010
2025-06-18 19:55:46,FAKE,2842859685,238,2842859923,2842902546
2025-06-18 19:55:48,REAL,2842859923,477,2842860400,2842903023
2025-06-18 19:55:50,FAKE,2842860400,243,2842860643,2842903502
2025-06-18 19:55:52,REAL,2842860643,535,2842861178,2842904037
2025-06-18 19:55:54,REAL,2842861178,490,2842861668,2842904527
2025-06-18 19:55:56,REAL,2842861668,480,2842862148,2842905007
2025-06-18 19:55:58,FAKE,2842862148,238,2842862386,2842905495
2025-06-18 19:56:00,REAL,2842862386,6962,2842869348,2842912457
2025-06-18 19:56:02,REAL,2842869348,11043,2842880391,2842923500
2025-06-18 19:56:04,REAL,2842880391,10250,2842890641,2842933750
2025-06-18 19:56:06,FAKE,2842890641,243,2842890884,2842944000
2025-06-18 19:56:08,REAL,2842890884,10244,2842901128,2842954244
2025-06-18 19:56:10,REAL,2842901128,10381,2842911509,2842964625
2025-06-18 19:56:12,REAL,2842911509,10253,2842921762,2842974878
2025-06-18 19:56:14,FAKE,2842921762,243,2842922005,2842984541
2025-06-18 19:56:16,FAKE,2842922005,238,2842922243,2842985024
2025-06-18 19:56:18,FAKE,2842922243,243,2842922486,2842985517
2025-06-18 19:56:20,FAKE,2842922486,243,2842922729,2842985998
2025-06-18 19:56:22,REAL,2842922729,488,2842923217,2842986486
2025-06-18 19:56:24,FAKE,2842923217,238,2842923455,2842987028
2025-06-18 19:56:26,FAKE,2842923455,244,2842923699,2842987518
2025-06-18 19:56:28,REAL,2842923699,488,2842924187,2842988006
2025-06-18 19:56:30,REAL,2842924187,484,2842924671,2842988490
2025-06-18 19:56:32,REAL,2842924671,541,2842925212,2842989031
2025-06-18 19:56:34,REAL,2842925212,489,2842925701,2842989520
2025-06-18 19:56:36,REAL,2842925701,478,2842926179,2842989998
2025-06-18 19:56:38,FAKE,2842926179,241,2842926420,2842990487
2025-06-18 19:56:40,FAKE,2842926420,238,2842926658,2842990972
2025-06-18 19:56:42,REAL,2842926658,480,2842927138,2842991452
2025-06-18 19:56:44,REAL,2842927138,482,2842927620,2842991934
2025-06-18 19:56:46,FAKE,2842927620,244,2842927864,2842992419
2025-06-18 19:56:48,REAL,2842927864,483,2842928347,2842992902
2025-06-18 19:56:50,REAL,2842928347,537,2842928884,2842993439
2025-06-18 19:56:52,REAL,2842928884,477,2842929361,2842993916
2025-06-18 19:56:54,REAL,2842929361,542,2842929903,2842994458
2025-06-18 19:56:56,REAL,2842929903,485,2842930388,2842994943
2025-06-18 19:56:58,REAL,2842930388,480,2842930868,2842995423
2025-06-18 19:57:00,FAKE,2842930868,243,2842931111,2842995915
2025-06-18 19:57:02,FAKE,2842931111,241,2842931352,2842996397
2025-06-18 19:57:04,REAL,2842931352,8548,2842939900,2843004945
2025-06-18 19:57:06,REAL,2842939900,10912,2842950812,2843015857
2025-06-18 19:57:08,FAKE,2842950812,238,2842951050,2843026102
2025-06-18 19:57:10,REAL,2842951050,10258,2842961308,2843036360
2025-06-18 19:57:12,FAKE,2842961308,241,2842961549,2843046611
2025-06-18 19:57:14,REAL,2842961549,10253,2842971802,2843056864
2025-06-18 19:57:16,FAKE,2842971802,238,2842972040,2843067184
2025-06-18 19:57:18,FAKE,2842972040,243,2842972283,2843075526
2025-06-18 19:57:20,REAL,2842972283,485,2842972768,2843076011
2025-06-18 19:57:22,REAL,2842972768,491,2842973259,2843076502
2025-06-18 19:57:24,REAL,2842973259,482,2842973741,2843076984
2025-06-18 19:57:26,REAL,2842973741,481,2842974222,2843077465
2025-06-18 19:57:28,FAKE,2842974222,241,2842974463,2843078002
2025-06-18 19:57:30,REAL,2842974463,487,2842974950,2843078489
2025-06-18 19:57:32,REAL,2842974950,490,2842975440,2843078979
2025-06-18 19:57:34,REAL,2842975440,485,2842975925,2843079464
2025-06-18 19:57:36,REAL,2842975925,536,2842976461,2843080000
2025-06-18 19:57:38,FAKE,2842976461,244,2842976705,2843080481
2025-06-18 19:57:40,REAL,2842976705,476,2842977181,2843080957
2025-06-18 19:57:42,REAL,2842977181,487,2842977668,2843081444
2025-06-18 19:57:44,REAL,2842977668,483,2842978151,2843081927
2025-06-18 19:57:46,FAKE,2842978151,241,2842978392,2843082414
2025-06-18 19:57:48,REAL,2842978392,481,2842978873,2843082895
2025-06-18 19:57:50,FAKE,2842978873,241,2842979114,2843083386
2025-06-18 19:57:52,FAKE,2842979114,243,2842979357,2843083876
2025-06-18 19:57:54,REAL,2842979357,546,2842979903,2843084422
2025-06-18 19:57:56,REAL,2842979903,490,2842980393,2843084912
2025-06-18 19:57:58,FAKE,2842980393,238,2842980631,2843085398
2025-06-18 19:58:00,REAL,2842980631,480,2842981111,2843085878
2025-06-18 19:58:02,REAL,2842981111,478,2842981589,2843086356
2025-06-18 19:58:04,REAL,2842981589,485,2842982074,2843086841
2025-06-18 19:58:06,REAL,2842982074,493,2842982567,2843087334
2025-06-18 19:58:08,REAL,2842982567,480,2842983047,2843087814
2025-06-18 19:58:10,REAL,2842983047,489,2842983536,2843088303
2025-06-18 19:58:12,REAL,2842983536,485,2842984021,2843088788
2025-06-18 19:58:14,REAL,2842984021,483,2842984504,2843089271
2025-06-18 19:58:16,REAL,2842984504,531,2842985035,2843089802
2025-06-18 19:58:18,FAKE,2842985035,238,2842985273,2843090352
2025-06-18 19:58:20,REAL,2842985273,488,2842985761,2843090840
2025-06-18 19:58:22,FAKE,2842985761,238,2842985999,2843091329
2025-06-18 19:58:24,FAKE,2842985999,241,2842986240,2843091812
2025-06-18 19:58:26,REAL,2842986240,482,2842986722,2843092294
2025-06-18 19:58:28,FAKE,2842986722,244,2842986966,2843092779
2025-06-18 19:58:30,REAL,2842986966,483,2842987449,2843093262
2025-06-18 19:58:32,FAKE,2842987449,241,2842987690,2843093753
2025-06-18 19:58:34,FAKE,2842987690,244,2842987934,2843094235
2025-06-18 19:58:36,REAL,2842987934,492,2842988426,2843094727
2025-06-18 19:58:38,FAKE,2842988426,244,2842988670,2843095207
2025-06-18 19:58:40,FAKE,2842988670,244,2842988914,2843095688
2025-06-18 19:58:42,REAL,2842988914,535,2842989449,2843096223
2025-06-18 19:58:44,REAL,2842989449,488,2842989937,2843096711
2025-06-18 19:58:46,REAL,2842989937,474,2842990411,2843097185
2025-06-18 19:58:48,REAL,2842990411,482,2842990893,2843097667
2025-06-18 19:58:50,REAL,2842990893,484,2842991377,2843098151
2025-06-18 19:58:52,REAL,2842991377,484,2842991861,2843098635
2025-06-18 19:58:54,REAL,2842991861,486,2842992347,2843099121
2025-06-18 19:58:56,REAL,2842992347,492,2842992839,2843099613
2025-06-18 19:58:58,REAL,2842992839,548,2842993387,2843100161
2025-06-18 19:59:00,REAL,2842993387,486,2842993873,2843100647
2025-06-18 19:59:02,FAKE,2842993873,243,2842994116,2843101131
2025-06-18 19:59:04,FAKE,2842994116,241,2842994357,2843101612
2025-06-18 19:59:06,REAL,2842994357,541,2842994898,2843102153
2025-06-18 19:59:08,REAL,2842994898,487,2842995385,2843102640
2025-06-18 19:59:10,REAL,2842995385,491,2842995876,2843103131
2025-06-18 19:59:12,REAL,2842995876,483,2842996359,2843103614
2025-06-18 19:59:14,FAKE,2842996359,241,2842996600,2843104095
2025-06-18 19:59:16,REAL,2842996600,482,2842997082,2843104577
2025-06-18 19:59:18,REAL,2842997082,490,2842997572,2843105067
2025-06-18 19:59:20,REAL,2842997572,483,2842998055,2843105550
2025-06-18 19:59:22,FAKE,2842998055,238,2842998293,2843106031
2025-06-18 19:59:24,REAL,2842998293,482,2842998775,2843106513
2025-06-18 19:59:26,REAL,2842998775,481,2842999256,2843106994
2025-06-18 19:59:28,REAL,2842999256,487,2842999743,2843107481
2025-06-18 19:59:30,REAL,2842999743,491,2843000234,2843107972
2025-06-18 19:59:32,FAKE,2843000234,244,2843000478,2843108514
2025-06-18 19:59:34,REAL,2843000478,488,2843000966,2843109002
2025-06-18 19:59:36,FAKE,2843000966,241,2843001207,2843109483
2025-06-18 19:59:38,REAL,2843001207,540,2843001747,2843110023
2025-06-18 19:59:40,FAKE,2843001747,241,2843001988,2843110500
2025-06-18 19:59:42,FAKE,2843001988,244,2843002232,2843110985
2025-06-18 19:59:44,REAL,2843002232,12304,2843014536,2843123289
2025-06-18 19:59:46,FAKE,2843014536,243,2843014779,2843133541
2025-06-18 19:59:48,FAKE,2843014779,244,2843015023,2843143798
2025-06-18 19:59:50,FAKE,2843015023,238,2843015261,2843154120
2025-06-18 19:59:52,FAKE,2843015261,238,2843015499,2843164382
2025-06-18 19:59:54,FAKE,2843015499,244,2843015743,2843174632
2025-06-18 19:59:56,FAKE,2843015743,238,2843015981,2843184956
2025-06-18 19:59:58,REAL,2843015981,5231,2843021212,2843190187
2025-06-18 20:00:00,FAKE,2843021212,241,2843021453,2843190674
2025-06-18 20:00:02,REAL,2843021453,490,2843021943,2843191164
2025-06-18 20:00:04,REAL,2843021943,484,2843022427,2843191648
2025-06-18 20:00:06,REAL,2843022427,484,2843022911,2843192132
2025-06-18 20:00:08,FAKE,2843022911,241,2843023152,2843192610
2025-06-18 20:00:10,REAL,2843023152,478,2843023630,2843193088
2025-06-18 20:00:12,REAL,2843023630,485,2843024115,2843193573
2025-06-18 20:00:14,REAL,2843024115,1012,2843025127,2843194585
2025-06-18 20:00:16,REAL,2843025127,12232,2843037359,2843206817
2025-06-18 20:00:18,REAL,2843037359,10246,2843047605,2843217063
2025-06-18 20:00:20,FAKE,2843047605,241,2843047846,2843227442
2025-06-18 20:00:22,REAL,2843047846,10250,2843058096,2843237692
2025-06-18 20:00:24,REAL,2843058096,10256,2843068352,2843247948
2025-06-18 20:00:26,FAKE,2843068352,243,2843068595,2843258206
2025-06-18 20:00:28,REAL,2843068595,10248,2843078843,2843268454
2025-06-18 20:00:30,FAKE,2843078843,241,2843079084,2843273101
2025-06-18 20:00:32,REAL,2843079084,488,2843079572,2843273589
2025-06-18 20:00:34,REAL,2843079572,486,2843080058,2843274075
2025-06-18 20:00:36,REAL,2843080058,481,2843080539,2843274556
2025-06-18 20:00:38,REAL,2843080539,485,2843081024,2843275041
2025-06-18 20:00:40,REAL,2843081024,483,2843081507,2843275524
2025-06-18 20:00:42,REAL,2843081507,490,2843081997,2843276014
2025-06-18 20:00:44,REAL,2843081997,476,2843082473,2843276490
2025-06-18 20:00:46,REAL,2843082473,479,2843082952,2843276969
2025-06-18 20:00:48,REAL,2843082952,538,2843083490,2843277507
2025-06-18 20:00:50,REAL,2843083490,489,2843083979,2843277996
2025-06-18 20:00:52,REAL,2843083979,481,2843084460,2843278477
2025-06-18 20:00:54,FAKE,2843084460,244,2843084704,2843278961
2025-06-18 20:00:56,FAKE,2843084704,243,2843084947,2843279440
2025-06-18 20:00:58,REAL,2843084947,482,2843085429,2843279922
2025-06-18 20:01:00,REAL,2843085429,542,2843085971,2843280464
2025-06-18 20:01:02,REAL,2843085971,479,2843086450,2843280943
2025-06-18 20:01:04,FAKE,2843086450,241,2843086691,2843281429
2025-06-18 20:01:06,FAKE,2843086691,241,2843086932,2843281921
2025-06-18 20:01:08,FAKE,2843086932,241,2843087173,2843282410
2025-06-18 20:01:10,REAL,2843087173,491,2843087664,2843282901
2025-06-18 20:01:12,FAKE,2843087664,238,2843087902,2843283386
2025-06-18 20:01:14,REAL,2843087902,478,2843088380,2843283864
2025-06-18 20:01:16,REAL,2843088380,487,2843088867,2843284351
2025-06-18 20:01:18,REAL,2843088867,3001,2843091868,2843287352
2025-06-18 20:01:20,REAL,2843091868,14081,2843105949,2843301433
2025-06-18 20:01:22,FAKE,2843105949,243,2843106192,2843311684
2025-06-18 20:01:24,REAL,2843106192,10249,2843116441,2843321933
2025-06-18 20:01:26,FAKE,2843116441,241,2843116682,2843332246
2025-06-18 20:01:28,REAL,2843116682,10249,2843126931,2843342495
2025-06-18 20:01:30,REAL,2843126931,10257,2843137188,2843352752
2025-06-18 20:01:32,FAKE,2843137188,243,2843137431,2843363006
2025-06-18 20:01:34,REAL,2843137431,3447,2843140878,2843366453
2025-06-18 20:01:36,REAL,2843140878,494,2843141372,2843366947
2025-06-18 20:01:38,REAL,2843141372,480,2843141852,2843367427
2025-06-18 20:01:40,FAKE,2843141852,241,2843142093,2843367976
2025-06-18 20:01:42,REAL,2843142093,490,2843142583,2843368466
2025-06-18 20:01:44,REAL,2843142583,481,2843143064,2843368947
2025-06-18 20:01:46,REAL,2843143064,479,2843143543,2843369426
2025-06-18 20:01:48,REAL,2843143543,479,2843144022,2843369905
2025-06-18 20:01:50,FAKE,2843144022,241,2843144263,2843373366
2025-06-18 20:01:52,REAL,2843144263,11629,2843155892,2843384995
2025-06-18 20:01:54,REAL,2843155892,10252,2843166144,2843395247
2025-06-18 20:01:56,REAL,2843166144,10316,2843176460,2843405563
2025-06-18 20:01:58,REAL,2843176460,10251,2843186711,2843415814
2025-06-18 20:02:00,FAKE,2843186711,244,2843186955,2843426062
2025-06-18 20:02:02,REAL,2843186955,10251,2843197206,2843436313
2025-06-18 20:02:04,FAKE,2843197206,241,2843197447,2843446562
2025-06-18 20:02:06,REAL,2843197447,2791,2843200238,2843449353
2025-06-18 20:02:08,REAL,2843200238,484,2843200722,2843449837
2025-06-18 20:02:10,FAKE,2843200722,243,2843200965,2843450325
2025-06-18 20:02:12,REAL,2843200965,484,2843201449,2843450809
2025-06-18 20:02:14,REAL,2843201449,489,2843201938,2843451298
2025-06-18 20:02:16,REAL,2843201938,487,2843202425,2843451785
2025-06-18 20:02:18,REAL,2843202425,493,2843202918,2843452278
2025-06-18 20:02:20,REAL,2843202918,484,2843203402,2843452762
2025-06-18 20:02:22,REAL,2843203402,539,2843203941,2843453301
2025-06-18 20:02:24,REAL,2843203941,533,2843204474,2843453834
2025-06-18 20:02:26,REAL,2843204474,494,2843204968,2843454328
2025-06-18 20:02:28,REAL,2843204968,492,2843205460,2843454820
2025-06-18 20:02:30,REAL,2843205460,489,2843205949,2843455309
2025-06-18 20:02:32,FAKE,2843205949,241,2843206190,2843455787
2025-06-18 20:02:34,FAKE,2843206190,244,2843206434,2843456273
2025-06-18 20:02:36,REAL,2843206434,479,2843206913,2843456752
2025-06-18 20:02:38,REAL,2843206913,484,2843207397,2843457236
2025-06-18 20:02:40,REAL,2843207397,478,2843207875,2843457714
2025-06-18 20:02:42,REAL,2843207875,489,2843208364,2843458203
2025-06-18 20:02:44,REAL,2843208364,484,2843208848,2843458687
2025-06-18 20:02:46,REAL,2843208848,485,2843209333,2843459172
2025-06-18 20:02:48,REAL,2843209333,483,2843209816,2843459655
2025-06-18 20:02:50,FAKE,2843209816,241,2843210057,2843460134
2025-06-18 20:02:52,REAL,2843210057,482,2843210539,2843460616
2025-06-18 20:02:54,FAKE,2843210539,243,2843210782,2843465460
2025-06-18 20:02:56,FAKE,2843210782,244,2843211026,2843476577
2025-06-18 20:02:58,FAKE,2843211026,244,2843211270,2843486946
2025-06-18 20:03:00,REAL,2843211270,10251,2843221521,2843497197
2025-06-18 20:03:02,FAKE,2843221521,244,2843221765,2843507451
2025-06-18 20:03:04,FAKE,2843221765,241,2843222006,2843517770
2025-06-18 20:03:06,REAL,2843222006,10252,2843232258,2843528022
2025-06-18 20:03:08,REAL,2843232258,10255,2843242513,2843538277
2025-06-18 20:03:10,REAL,2843242513,1537,2843244050,2843539814
2025-06-18 20:03:12,FAKE,2843244050,241,2843244291,2843540290
2025-06-18 20:03:14,REAL,2843244291,491,2843244782,2843540781
2025-06-18 20:03:16,REAL,2843244782,483,2843245265,2843541264
2025-06-18 20:03:18,FAKE,2843245265,241,2843245506,2843541748
2025-06-18 20:03:20,REAL,2843245506,486,2843245992,2843542234
2025-06-18 20:03:22,REAL,2843245992,489,2843246481,2843542723
2025-06-18 20:03:24,REAL,2843246481,476,2843246957,2843543199
2025-06-18 20:03:26,REAL,2843246957,536,2843247493,2843543735
2025-06-18 20:03:28,REAL,2843247493,494,2843247987,2843544229
2025-06-18 20:03:30,FAKE,2843247987,244,2843248231,2843544707
2025-06-18 20:03:32,REAL,2843248231,488,2843248719,2843545195
2025-06-18 20:03:34,REAL,2843248719,482,2843249201,2843545677
2025-06-18 20:03:36,REAL,2843249201,540,2843249741,2843546217
2025-06-18 20:03:38,REAL,2843249741,483,2843250224,2843546700
2025-06-18 20:03:40,REAL,2843250224,476,2843250700,2843547176
2025-06-18 20:03:42,REAL,2843250700,484,2843251184,2843547660
2025-06-18 20:03:44,REAL,2843251184,486,2843251670,2843548146
2025-06-18 20:03:46,FAKE,2843251670,243,2843251913,2843548634
2025-06-18 20:03:48,REAL,2843251913,477,2843252390,2843549111
2025-06-18 20:03:50,REAL,2843252390,478,2843252868,2843549589
2025-06-18 20:03:52,FAKE,2843252868,238,2843253106,2843550081
2025-06-18 20:03:54,REAL,2843253106,480,2843253586,2843550561
2025-06-18 20:03:56,REAL,2843253586,479,2843254065,2843551040
2025-06-18 20:03:58,REAL,2843254065,7022,2843261087,2843558062
2025-06-18 20:04:00,REAL,2843261087,10986,2843272073,2843569048
2025-06-18 20:04:02,REAL,2843272073,10310,2843282383,2843579358
2025-06-18 20:04:04,REAL,2843282383,10250,2843292633,2843589608
2025-06-18 20:04:06,REAL,2843292633,10258,2843302891,2843599866
2025-06-18 20:04:08,REAL,2843302891,10258,2843313149,2843610124
2025-06-18 20:04:10,REAL,2843313149,10248,2843323397,2843620372
2025-06-18 20:04:12,REAL,2843323397,10109,2843333506,2843630481
2025-06-18 20:04:14,REAL,2843333506,489,2843333995,2843630970
2025-06-18 20:04:16,REAL,2843333995,492,2843334487,2843631462
2025-06-18 20:04:18,REAL,2843334487,490,2843334977,2843631952
2025-06-18 20:04:20,REAL,2843334977,481,2843335458,2843632433
2025-06-18 20:04:22,FAKE,2843335458,238,2843335696,2843632915
2025-06-18 20:04:24,REAL,2843335696,487,2843336183,2843633402
2025-06-18 20:04:26,FAKE,2843336183,244,2843336427,2843633885
2025-06-18 20:04:28,REAL,2843336427,486,2843336913,2843634371
2025-06-18 20:04:30,FAKE,2843336913,238,2843337151,2843642190
2025-06-18 20:04:32,REAL,2843337151,12823,2843349974,2843655013
2025-06-18 20:04:34,FAKE,2843349974,244,2843350218,2843665333
2025-06-18 20:04:36,REAL,2843350218,10249,2843360467,2843675582
2025-06-18 20:04:38,REAL,2843360467,10260,2843370727,2843685842
2025-06-18 20:04:40,REAL,2843370727,10243,2843380970,2843696085
2025-06-18 20:04:42,REAL,2843380970,10325,2843391295,2843706410
2025-06-18 20:04:44,REAL,2843391295,9393,2843400688,2843715803
2025-06-18 20:04:46,REAL,2843400688,479,2843401167,2843716282
2025-06-18 20:04:48,REAL,2843401167,488,2843401655,2843716770
2025-06-18 20:04:50,REAL,2843401655,532,2843402187,2843717302
2025-06-18 20:04:52,FAKE,2843402187,244,2843402431,2843717786
2025-06-18 20:04:54,REAL,2843402431,485,2843402916,2843718271
2025-06-18 20:04:56,REAL,2843402916,488,2843403404,2843718759
2025-06-18 20:04:58,FAKE,2843403404,243,2843403647,2843719234
2025-06-18 20:05:00,REAL,2843403647,486,2843404133,2843719720
2025-06-18 20:05:02,FAKE,2843404133,238,2843404371,2843728067
2025-06-18 20:05:04,REAL,2843404371,10706,2843415077,2843738773
2025-06-18 20:05:06,REAL,2843415077,10250,2843425327,2843749023
2025-06-18 20:05:08,REAL,2843425327,10261,2843435588,2843759284
2025-06-18 20:05:10,REAL,2843435588,10253,2843445841,2843769537
2025-06-18 20:05:12,REAL,2843445841,10253,2843456094,2843779790
2025-06-18 20:05:14,REAL,2843456094,10319,2843466413,2843790109
2025-06-18 20:05:16,FAKE,2843466413,238,2843466651,2843798837
2025-06-18 20:05:18,REAL,2843466651,479,2843467130,2843799316
2025-06-18 20:05:20,FAKE,2843467130,244,2843467374,2843799804
2025-06-18 20:05:22,REAL,2843467374,475,2843467849,2843800279
2025-06-18 20:05:24,FAKE,2843467849,244,2843468093,2843800763
2025-06-18 20:05:26,REAL,2843468093,547,2843468640,2843801310
2025-06-18 20:05:28,REAL,2843468640,479,2843469119,2843801789
2025-06-18 20:05:30,FAKE,2843469119,238,2843469357,2843802266
2025-06-18 20:05:32,REAL,2843469357,480,2843469837,2843802746
2025-06-18 20:05:34,FAKE,2843469837,243,2843470080,2843811359
2025-06-18 20:05:36,FAKE,2843470080,238,2843470318,2843821939
2025-06-18 20:05:38,REAL,2843470318,10316,2843480634,2843832255
2025-06-18 20:05:40,REAL,2843480634,10247,2843490881,2843842502
2025-06-18 20:05:42,REAL,2843490881,10319,2843501200,2843852821
2025-06-18 20:05:44,REAL,2843501200,10252,2843511452,2843863073
2025-06-18 20:05:46,REAL,2843511452,10257,2843521709,2843873330
2025-06-18 20:05:48,REAL,2843521709,8143,2843529852,2843881473
2025-06-18 20:05:50,REAL,2843529852,482,2843530334,2843881955
2025-06-18 20:05:52,FAKE,2843530334,244,2843530578,2843882431
2025-06-18 20:05:54,FAKE,2843530578,243,2843530821,2843882916
2025-06-18 20:05:56,FAKE,2843530821,238,2843531059,2843883394
2025-06-18 20:05:58,FAKE,2843531059,241,2843531300,2843883878
2025-06-18 20:06:00,REAL,2843531300,482,2843531782,2843884360
2025-06-18 20:06:02,REAL,2843531782,547,2843532329,2843884907
2025-06-18 20:06:04,REAL,2843532329,540,2843532869,2843885447
2025-06-18 20:06:06,FAKE,2843532869,243,2843533112,2843894913
2025-06-18 20:06:08,FAKE,2843533112,243,2843533355,2843905558
2025-06-18 20:06:10,REAL,2843533355,10252,2843543607,2843915810
2025-06-18 20:06:12,REAL,2843543607,10250,2843553857,2843926060
2025-06-18 20:06:14,FAKE,2843553857,238,2843554095,2843936378
2025-06-18 20:06:16,FAKE,2843554095,244,2843554339,2843946628
2025-06-18 20:06:18,REAL,2843554339,10254,2843564593,2843956882
2025-06-18 20:06:20,REAL,2843564593,7611,2843572204,2843964493
2025-06-18 20:06:22,REAL,2843572204,481,2843572685,2843964974
2025-06-18 20:06:24,REAL,2843572685,485,2843573170,2843965459
2025-06-18 20:06:26,REAL,2843573170,484,2843573654,2843965943
2025-06-18 20:06:28,FAKE,2843573654,241,2843573895,2843966434
2025-06-18 20:06:30,REAL,2843573895,483,2843574378,2843966917
2025-06-18 20:06:32,REAL,2843574378,484,2843574862,2843967401
2025-06-18 20:06:34,REAL,2843574862,481,2843575343,2843967882
2025-06-18 20:06:36,REAL,2843575343,541,2843575884,2843968423
2025-06-18 20:06:38,REAL,2843575884,10256,2843586140,2843978679
2025-06-18 20:06:40,FAKE,2843586140,244,2843586384,2843989188
2025-06-18 20:06:42,REAL,2843586384,10840,2843597224,2844000028
2025-06-18 20:06:44,FAKE,2843597224,243,2843597467,2844009753
2025-06-18 20:06:46,REAL,2843597467,10244,2843607711,2844019997
2025-06-18 20:06:48,REAL,2843607711,10315,2843618026,2844030312
2025-06-18 20:06:50,REAL,2843618026,10247,2843628273,2844040559
2025-06-18 20:06:52,REAL,2843628273,6884,2843635157,2844047443
2025-06-18 20:06:54,REAL,2843635157,483,2843635640,2844047926
2025-06-18 20:06:56,REAL,2843635640,484,2843636124,2844048410
2025-06-18 20:06:58,FAKE,2843636124,238,2843636362,2844048900
2025-06-18 20:07:00,FAKE,2843636362,241,2843636603,2844049388
2025-06-18 20:07:02,FAKE,2843636603,244,2843636847,2844049875
2025-06-18 20:07:04,REAL,2843636847,489,2843637336,2844050364
2025-06-18 20:07:06,REAL,2843637336,480,2843637816,2844050844
2025-06-18 20:07:08,FAKE,2843637816,243,2843638059,2844051375
2025-06-18 20:07:10,REAL,2843638059,488,2843638547,2844051863
2025-06-18 20:07:12,REAL,2843638547,476,2843639023,2844052339
2025-06-18 20:07:14,REAL,2843639023,480,2843639503,2844052819
2025-06-18 20:07:16,FAKE,2843639503,243,2843639746,2844053300
2025-06-18 20:07:18,FAKE,2843639746,243,2843639989,2844053784
2025-06-18 20:07:20,REAL,2843639989,541,2843640530,2844054325
2025-06-18 20:07:22,REAL,2843640530,483,2843641013,2844054808
2025-06-18 20:07:24,REAL,2843641013,474,2843641487,2844055282
2025-06-18 20:07:26,REAL,2843641487,481,2843641968,2844055763
2025-06-18 20:07:28,FAKE,2843641968,241,2843642209,2844056248
2025-06-18 20:07:30,REAL,2843642209,486,2843642695,2844056734
2025-06-18 20:07:32,FAKE,2843642695,243,2843642938,2844057219
2025-06-18 20:07:34,FAKE,2843642938,238,2843643176,2844057700
2025-06-18 20:07:36,REAL,2843643176,487,2843643663,2844058187
2025-06-18 20:07:38,REAL,2843643663,536,2843644199,2844058723
2025-06-18 20:07:40,FAKE,2843644199,244,2843644443,2844059211
2025-06-18 20:07:42,REAL,2843644443,482,2843644925,2844059693
2025-06-18 20:07:44,REAL,2843644925,489,2843645414,2844060182
2025-06-18 20:07:46,FAKE,2843645414,244,2843645658,2844060668
2025-06-18 20:07:48,FAKE,2843645658,241,2843645899,2844061153
2025-06-18 20:07:50,REAL,2843645899,483,2843646382,2844061636
2025-06-18 20:07:52,FAKE,2843646382,241,2843646623,2844062120
2025-06-18 20:07:54,FAKE,2843646623,243,2843646866,2844062602
2025-06-18 20:07:56,REAL,2843646866,480,2843647346,2844063082
2025-06-18 20:07:58,REAL,2843647346,11708,2843659054,2844074790
2025-06-18 20:08:00,FAKE,2843659054,238,2843659292,2844085042
2025-06-18 20:08:02,FAKE,2843659292,244,2843659536,2844095420
2025-06-18 20:08:04,FAKE,2843659536,238,2843659774,2844105678
2025-06-18 20:08:06,REAL,2843659774,10259,2843670033,2844115937
2025-06-18 20:08:08,REAL,2843670033,10309,2843680342,2844126246
2025-06-18 20:08:10,REAL,2843680342,10252,2843690594,2844136498
2025-06-18 20:08:12,FAKE,2843690594,241,2843690835,2844141865
2025-06-18 20:08:14,REAL,2843690835,486,2843691321,2844142351
2025-06-18 20:08:16,REAL,2843691321,477,2843691798,2844142828
2025-06-18 20:08:18,REAL,2843691798,490,2843692288,2844143318
2025-06-18 20:08:20,FAKE,2843692288,241,2843692529,2844143805
2025-06-18 20:08:22,REAL,2843692529,484,2843693013,2844144289
2025-06-18 20:08:24,REAL,2843693013,475,2843693488,2844144764
2025-06-18 20:08:26,FAKE,2843693488,241,2843693729,2844145254
2025-06-18 20:08:28,REAL,2843693729,949,2843694678,2844146203
2025-06-18 20:08:30,FAKE,2843694678,238,2843694916,2844158170
2025-06-18 20:08:32,REAL,2843694916,10249,2843705165,2844168419
2025-06-18 20:08:34,FAKE,2843705165,243,2843705408,2844178734
2025-06-18 20:08:36,FAKE,2843705408,243,2843705651,2844188991
2025-06-18 20:08:38,FAKE,2843705651,238,2843705889,2844199241
2025-06-18 20:08:40,REAL,2843705889,10246,2843716135,2844209487
2025-06-18 20:08:42,REAL,2843716135,10323,2843726458,2844219810
2025-06-18 20:08:44,REAL,2843726458,4765,2843731223,2844224575
2025-06-18 20:08:46,REAL,2843731223,489,2843731712,2844225064
2025-06-18 20:08:48,REAL,2843731712,476,2843732188,2844225540
2025-06-18 20:08:50,REAL,2843732188,485,2843732673,2844226025
2025-06-18 20:08:52,REAL,2843732673,488,2843733161,2844226513
2025-06-18 20:08:54,REAL,2843733161,480,2843733641,2844226993
2025-06-18 20:08:56,REAL,2843733641,478,2843734119,2844227471
2025-06-18 20:08:58,REAL,2843734119,484,2843734603,2844227955
2025-06-18 20:09:00,REAL,2843734603,2003,2843736606,2844229958
2025-06-18 20:09:02,REAL,2843736606,11706,2843748312,2844241664
2025-06-18 20:09:04,REAL,2843748312,10315,2843758627,2844251979
2025-06-18 20:09:06,REAL,2843758627,10258,2843768885,2844262237
2025-06-18 20:09:08,REAL,2843768885,10260,2843779145,2844272497
2025-06-18 20:09:10,REAL,2843779145,10255,2843789400,2844282752
2025-06-18 20:09:12,REAL,2843789400,10254,2843799654,2844293006
2025-06-18 20:09:14,REAL,2843799654,10260,2843809914,2844303266
2025-06-18 20:09:16,REAL,2843809914,4121,2843814035,2844307387
2025-06-18 20:09:18,FAKE,2843814035,241,2843814276,2844307872
2025-06-18 20:09:20,FAKE,2843814276,241,2843814517,2844308351
2025-06-18 20:09:22,REAL,2843814517,485,2843815002,2844308836
2025-06-18 20:09:24,REAL,2843815002,533,2843815535,2844309369
2025-06-18 20:09:26,REAL,2843815535,486,2843816021,2844309855
2025-06-18 20:09:28,FAKE,2843816021,241,2843816262,2844310341
2025-06-18 20:09:30,REAL,2843816262,484,2843816746,2844310825
2025-06-18 20:09:32,REAL,2843816746,2729,2843819475,2844313554
2025-06-18 20:09:34,REAL,2843819475,11502,2843830977,2844325056
2025-06-18 20:09:36,REAL,2843830977,10259,2843841236,2844335315
2025-06-18 20:09:38,REAL,2843841236,10250,2843851486,2844345565
2025-06-18 20:09:40,REAL,2843851486,10247,2843861733,2844355812
2025-06-18 20:09:42,REAL,2843861733,10309,2843872042,2844366121
2025-06-18 20:09:44,REAL,2843872042,10257,2843882299,2844376378
2025-06-18 20:09:46,REAL,2843882299,10260,2843892559,2844386638
2025-06-18 20:09:48,REAL,2843892559,3458,2843896017,2844390096
2025-06-18 20:09:50,REAL,2843896017,484,2843896501,2844390580
2025-06-18 20:09:52,FAKE,2843896501,238,2843896739,2844391067
2025-06-18 20:09:54,REAL,2843896739,484,2843897223,2844391551
2025-06-18 20:09:56,REAL,2843897223,486,2843897709,2844392037
2025-06-18 20:09:58,FAKE,2843897709,243,2843897952,2844392519
2025-06-18 20:10:00,REAL,2843897952,486,2843898438,2844393005
2025-06-18 20:10:02,FAKE,2843898438,243,2843898681,2844393545
2025-06-18 20:10:04,REAL,2843898681,542,2843899223,2844394087
2025-06-18 20:10:06,FAKE,2843899223,244,2843899467,2844394570
2025-06-18 20:10:08,REAL,2843899467,486,2843899953,2844395056
2025-06-18 20:10:10,FAKE,2843899953,241,2843900194,2844395534
2025-06-18 20:10:12,FAKE,2843900194,238,2843900432,2844396015
2025-06-18 20:10:14,REAL,2843900432,476,2843900908,2844396491
2025-06-18 20:10:16,REAL,2843900908,487,2843901395,2844396978
2025-06-18 20:10:18,REAL,2843901395,492,2843901887,2844397470
2025-06-18 20:10:20,REAL,2843901887,484,2843902371,2844397954
2025-06-18 20:10:22,REAL,2843902371,488,2843902859,2844398442
2025-06-18 20:10:24,REAL,2843902859,480,2843903339,2844398922
2025-06-18 20:10:26,REAL,2843903339,476,2843903815,2844399398
2025-06-18 20:10:28,REAL,2843903815,547,2843904362,2844399945
2025-06-18 20:10:30,REAL,2843904362,486,2843904848,2844400431
2025-06-18 20:10:32,REAL,2843904848,480,2843905328,2844400911
2025-06-18 20:10:34,REAL,2843905328,487,2843905815,2844401398
2025-06-18 20:10:36,FAKE,2843905815,238,2843906053,2844405521
2025-06-18 20:10:38,FAKE,2843906053,244,2843906297,2844416966
2025-06-18 20:10:40,REAL,2843906297,10254,2843916551,2844427220
2025-06-18 20:10:42,FAKE,2843916551,243,2843916794,2844437468
2025-06-18 20:10:44,FAKE,2843916794,241,2843917035,2844447723
2025-06-18 20:10:46,FAKE,2843917035,238,2843917273,2844458089
2025-06-18 20:10:48,REAL,2843917273,10260,2843927533,2844468349
2025-06-18 20:10:50,REAL,2843927533,10249,2843937782,2844478598
2025-06-18 20:10:52,REAL,2843937782,2207,2843939989,2844480805
2025-06-18 20:10:54,REAL,2843939989,477,2843940466,2844481282
2025-06-18 20:10:56,REAL,2843940466,493,2843940959,2844481775
2025-06-18 20:10:58,REAL,2843940959,483,2843941442,2844482258
2025-06-18 20:11:00,REAL,2843941442,544,2843941986,2844482802
2025-06-18 20:11:02,REAL,2843941986,475,2843942461,2844483277
2025-06-18 20:11:04,REAL,2843942461,487,2843942948,2844483764
2025-06-18 20:11:06,FAKE,2843942948,241,2843943189,2844484240
2025-06-18 20:11:08,FAKE,2843943189,241,2843943430,2844484723
2025-06-18 20:11:10,FAKE,2843943430,244,2843943674,2844485216
2025-06-18 20:11:12,FAKE,2843943674,238,2843943912,2844485694
2025-06-18 20:11:14,REAL,2843943912,484,2843944396,2844486178
2025-06-18 20:11:16,REAL,2843944396,488,2843944884,2844486666
2025-06-18 20:11:18,REAL,2843944884,477,2843945361,2844487143
2025-06-18 20:11:20,REAL,2843945361,487,2843945848,2844487630
2025-06-18 20:11:22,REAL,2843945848,481,2843946329,2844488111
2025-06-18 20:11:24,REAL,2843946329,548,2843946877,2844488659
2025-06-18 20:11:26,REAL,2843946877,480,2843947357,2844489139
2025-06-18 20:11:28,REAL,2843947357,544,2843947901,2844489683
2025-06-18 20:11:30,REAL,2843947901,484,2843948385,2844490167
2025-06-18 20:11:32,REAL,2843948385,478,2843948863,2844490645
2025-06-18 20:11:34,REAL,2843948863,474,2843949337,2844491119
2025-06-18 20:11:36,FAKE,2843949337,243,2843949580,2844491608
2025-06-18 20:11:38,REAL,2843949580,484,2843950064,2844492092
2025-06-18 20:11:40,REAL,2843950064,6707,2843956771,2844498799
2025-06-18 20:11:42,REAL,2843956771,14022,2843970793,2844512821
2025-06-18 20:11:44,FAKE,2843970793,244,2843971037,2844523145
2025-06-18 20:11:46,FAKE,2843971037,241,2843971278,2844533389
2025-06-18 20:11:48,REAL,2843971278,10248,2843981526,2844543637
2025-06-18 20:11:50,REAL,2843981526,10320,2843991846,2844553957
2025-06-18 20:11:52,REAL,2843991846,10257,2844002103,2844564214
2025-06-18 20:11:54,REAL,2844002103,10246,2844012349,2844574460
2025-06-18 20:11:56,REAL,2844012349,939,2844013288,2844575399
2025-06-18 20:11:58,REAL,2844013288,243,2844013531,2844575642
2025-06-18 20:12:00,REAL,2844013531,483,2844014014,2844576125
2025-06-18 20:12:02,REAL,2844014014,485,2844014499,2844576610
2025-06-18 20:12:04,REAL,2844014499,542,2844015041,2844577152
2025-06-18 20:12:06,REAL,2844015041,488,2844015529,2844577640
2025-06-18 20:12:08,FAKE,2844015529,241,2844015770,2844578179
2025-06-18 20:12:10,REAL,2844015770,478,2844016248,2844578657
2025-06-18 20:12:12,REAL,2844016248,6820,2844023068,2844585477
2025-06-18 20:12:14,FAKE,2844023068,244,2844023312,2844596939
2025-06-18 20:12:16,REAL,2844023312,10260,2844033572,2844607199
2025-06-18 20:12:18,REAL,2844033572,10251,2844043823,2844617450
2025-06-18 20:12:20,REAL,2844043823,10315,2844054138,2844627765
2025-06-18 20:12:22,REAL,2844054138,10247,2844064385,2844638012
2025-06-18 20:12:24,FAKE,2844064385,241,2844064626,2844648260
2025-06-18 20:12:26,REAL,2844064626,10121,2844074747,2844658381
2025-06-18 20:12:28,FAKE,2844074747,243,2844074990,2844658855
2025-06-18 20:12:30,FAKE,2844074990,243,2844075233,2844659343
2025-06-18 20:12:32,REAL,2844075233,487,2844075720,2844659830
2025-06-18 20:12:34,REAL,2844075720,482,2844076202,2844660312
2025-06-18 20:12:36,REAL,2844076202,534,2844076736,2844660846
2025-06-18 20:12:38,REAL,2844076736,482,2844077218,2844661328
2025-06-18 20:12:40,REAL,2844077218,480,2844077698,2844661808
2025-06-18 20:12:42,REAL,2844077698,482,2844078180,2844662290
2025-06-18 20:12:44,FAKE,2844078180,243,2844078423,2844663014
2025-06-18 20:12:46,REAL,2844078423,241,2844078664,2844663255
2025-06-18 20:12:48,REAL,2844078664,483,2844079147,2844663738
2025-06-18 20:12:50,REAL,2844079147,480,2844079627,2844664218
2025-06-18 20:12:52,REAL,2844079627,488,2844080115,2844664706
2025-06-18 20:12:54,FAKE,2844080115,241,2844080356,2844665244
2025-06-18 20:12:56,FAKE,2844080356,238,2844080594,2844665733
2025-06-18 20:12:58,REAL,2844080594,535,2844081129,2844666268
2025-06-18 20:13:00,REAL,2844081129,486,2844081615,2844666754
2025-06-18 20:13:02,FAKE,2844081615,241,2844081856,2844667236
2025-06-18 20:13:04,FAKE,2844081856,241,2844082097,2844667722
2025-06-18 20:13:06,REAL,2844082097,483,2844082580,2844668205
2025-06-18 20:13:08,FAKE,2844082580,244,2844082824,2844668683
2025-06-18 20:13:10,REAL,2844082824,485,2844083309,2844669168
2025-06-18 20:13:12,FAKE,2844083309,238,2844083547,2844669653
2025-06-18 20:13:14,REAL,2844083547,489,2844084036,2844670142
2025-06-18 20:13:16,REAL,2844084036,9666,2844093702,2844679808
2025-06-18 20:13:18,REAL,2844093702,12578,2844106280,2844692386
2025-06-18 20:13:20,REAL,2844106280,10325,2844116605,2844702711
2025-06-18 20:13:22,REAL,2844116605,10247,2844126852,2844712958
2025-06-18 20:13:24,REAL,2844126852,10252,2844137104,2844723210
2025-06-18 20:13:26,REAL,2844137104,10316,2844147420,2844733526
2025-06-18 20:13:28,FAKE,2844147420,244,2844147664,2844743777
2025-06-18 20:13:30,REAL,2844147664,8874,2844156538,2844752651
2025-06-18 20:13:32,FAKE,2844156538,238,2844156776,2844753137
2025-06-18 20:13:34,FAKE,2844156776,244,2844157020,2844753615
2025-06-18 20:13:36,FAKE,2844157020,241,2844157261,2844754104
2025-06-18 20:13:38,REAL,2844157261,482,2844157743,2844754586
2025-06-18 20:13:40,FAKE,2844157743,238,2844157981,2844755184
2025-06-18 20:13:42,FAKE,2844157981,238,2844158219,2844755661
2025-06-18 20:13:44,REAL,2844158219,489,2844158708,2844756150
2025-06-18 20:13:46,REAL,2844158708,474,2844159182,2844756624
2025-06-18 20:13:48,REAL,2844159182,486,2844159668,2844757110
2025-06-18 20:13:50,FAKE,2844159668,243,2844159911,2844757594
2025-06-18 20:13:52,REAL,2844159911,475,2844160386,2844758069
2025-06-18 20:13:54,REAL,2844160386,481,2844160867,2844758550
2025-06-18 20:13:56,FAKE,2844160867,244,2844161111,2844759039
2025-06-18 20:13:58,REAL,2844161111,479,2844161590,2844759518
2025-06-18 20:14:00,REAL,2844161590,481,2844162071,2844759999
2025-06-18 20:14:02,FAKE,2844162071,241,2844162312,2844760486
2025-06-18 20:14:04,REAL,2844162312,534,2844162846,2844761020
2025-06-18 20:14:06,FAKE,2844162846,238,2844163084,2844761499
2025-06-18 20:14:08,REAL,2844163084,477,2844163561,2844761976
2025-06-18 20:14:10,REAL,2844163561,486,2844164047,2844762462
2025-06-18 20:14:12,REAL,2844164047,485,2844164532,2844762947
2025-06-18 20:14:14,FAKE,2844164532,244,2844164776,2844763436
2025-06-18 20:14:16,REAL,2844164776,482,2844165258,2844763918
2025-06-18 20:14:18,REAL,2844165258,482,2844165740,2844764400
2025-06-18 20:14:20,REAL,2844165740,9541,2844175281,2844773941
2025-06-18 20:14:22,FAKE,2844175281,243,2844175524,2844784584
2025-06-18 20:14:24,REAL,2844175524,10312,2844185836,2844794896
2025-06-18 20:14:26,REAL,2844185836,10251,2844196087,2844805147
2025-06-18 20:14:28,REAL,2844196087,10314,2844206401,2844815461
2025-06-18 20:14:30,REAL,2844206401,10260,2844216661,2844825721
2025-06-18 20:14:32,REAL,2844216661,10315,2844226976,2844836036
2025-06-18 20:14:34,REAL,2844226976,7617,2844234593,2844843653
2025-06-18 20:14:36,FAKE,2844234593,243,2844234836,2844844134
2025-06-18 20:14:38,FAKE,2844234836,244,2844235080,2844844624
2025-06-18 20:14:40,REAL,2844235080,478,2844235558,2844845102
2025-06-18 20:14:42,REAL,2844235558,547,2844236105,2844845649
2025-06-18 20:14:44,FAKE,2844236105,244,2844236349,2844846130
2025-06-18 20:14:46,FAKE,2844236349,238,2844236587,2844846606
2025-06-18 20:14:48,REAL,2844236587,477,2844237064,2844847083
2025-06-18 20:14:50,REAL,2844237064,480,2844237544,2844847563
2025-06-18 20:14:52,REAL,2844237544,10394,2844247938,2844857957
2025-06-18 20:14:54,REAL,2844247938,10386,2844258324,2844868343
2025-06-18 20:14:56,REAL,2844258324,10259,2844268583,2844878602
2025-06-18 20:14:58,REAL,2844268583,10313,2844278896,2844888915
2025-06-18 20:15:00,REAL,2844278896,10253,2844289149,2844899168
2025-06-18 20:15:02,FAKE,2844289149,243,2844289392,2844909421
2025-06-18 20:15:04,REAL,2844289392,10318,2844299710,2844919739
2025-06-18 20:15:06,REAL,2844299710,6947,2844306657,2844926686
2025-06-18 20:15:08,REAL,2844306657,480,2844307137,2844927166
2025-06-18 20:15:10,REAL,2844307137,491,2844307628,2844927657
2025-06-18 20:15:12,REAL,2844307628,479,2844308107,2844928136
2025-06-18 20:15:14,REAL,2844308107,540,2844308647,2844928676
2025-06-18 20:15:16,FAKE,2844308647,241,2844308888,2844929156
2025-06-18 20:15:18,FAKE,2844308888,238,2844309126,2844929644
2025-06-18 20:15:20,REAL,2844309126,487,2844309613,2844930131
2025-06-18 20:15:22,FAKE,2844309613,241,2844309854,2844930619
2025-06-18 20:15:24,FAKE,2844309854,244,2844310098,2844931102
2025-06-18 20:15:26,FAKE,2844310098,244,2844310342,2844931577
2025-06-18 20:15:28,REAL,2844310342,536,2844310878,2844932113
2025-06-18 20:15:30,REAL,2844310878,486,2844311364,2844932599
2025-06-18 20:15:32,FAKE,2844311364,244,2844311608,2844933078
2025-06-18 20:15:34,FAKE,2844311608,241,2844311849,2844933557
2025-06-18 20:15:36,REAL,2844311849,480,2844312329,2844934037
2025-06-18 20:15:38,REAL,2844312329,483,2844312812,2844934520
2025-06-18 20:15:40,FAKE,2844312812,241,2844313053,2844934996
2025-06-18 20:15:42,REAL,2844313053,493,2844313546,2844935489
2025-06-18 20:15:44,REAL,2844313546,485,2844314031,2844935974
2025-06-18 20:15:46,FAKE,2844314031,238,2844314269,2844936456
2025-06-18 20:15:48,REAL,2844314269,479,2844314748,2844936935
2025-06-18 20:15:50,REAL,2844314748,483,2844315231,2844937418
2025-06-18 20:15:52,FAKE,2844315231,243,2844315474,2844937899
2025-06-18 20:15:54,REAL,2844315474,482,2844315956,2844938381
2025-06-18 20:15:56,FAKE,2844315956,243,2844316199,2844949906
2025-06-18 20:15:58,FAKE,2844316199,243,2844316442,2844960160
2025-06-18 20:16:00,FAKE,2844316442,241,2844316683,2844970476
2025-06-18 20:16:02,REAL,2844316683,10313,2844326996,2844980789
2025-06-18 20:16:04,REAL,2844326996,10322,2844337318,2844991111
2025-06-18 20:16:06,FAKE,2844337318,238,2844337556,2845001364
2025-06-18 20:16:08,FAKE,2844337556,243,2844337799,2845011611
2025-06-18 20:16:10,REAL,2844337799,5755,2844343554,2845017366
2025-06-18 20:16:12,REAL,2844343554,488,2844344042,2845017854
2025-06-18 20:16:14,REAL,2844344042,480,2844344522,2845018334
2025-06-18 20:16:16,REAL,2844344522,478,2844345000,2845018812
2025-06-18 20:16:18,REAL,2844345000,489,2844345489,2845019301
2025-06-18 20:16:20,REAL,2844345489,489,2844345978,2845019790
2025-06-18 20:16:22,REAL,2844345978,475,2844346453,2845020265
2025-06-18 20:16:24,REAL,2844346453,492,2844346945,2845020757
2025-06-18 20:16:26,REAL,2844346945,479,2844347424,2845021236
2025-06-18 20:16:28,REAL,2844347424,12306,2844359730,2845033542
2025-06-18 20:16:30,FAKE,2844359730,241,2844359971,2845043858
2025-06-18 20:16:32,FAKE,2844359971,243,2844360214,2845054103
2025-06-18 20:16:34,REAL,2844360214,10250,2844370464,2845064353
2025-06-18 20:16:36,REAL,2844370464,10252,2844380716,2845074605
2025-06-18 20:16:38,REAL,2844380716,10328,2844391044,2845084933
2025-06-18 20:16:40,REAL,2844391044,10252,2844401296,2845095185
2025-06-18 20:16:42,REAL,2844401296,5102,2844406398,2845100287
2025-06-18 20:16:44,REAL,2844406398,480,2844406878,2845100767
2025-06-18 20:16:46,FAKE,2844406878,243,2844407121,2845101254
2025-06-18 20:16:48,REAL,2844407121,532,2844407653,2845101786
2025-06-18 20:16:50,REAL,2844407653,483,2844408136,2845102269
2025-06-18 20:16:52,REAL,2844408136,488,2844408624,2845102757
2025-06-18 20:16:54,REAL,2844408624,477,2844409101,2845103234
2025-06-18 20:16:56,REAL,2844409101,477,2844409578,2845103711
2025-06-18 20:16:58,FAKE,2844409578,238,2844409816,2845104192
2025-06-18 20:17:00,REAL,2844409816,489,2844410305,2845104681
2025-06-18 20:17:02,REAL,2844410305,493,2844410798,2845105174
2025-06-18 20:17:04,REAL,2844410798,543,2844411341,2845105717
2025-06-18 20:17:06,REAL,2844411341,488,2844411829,2845106205
2025-06-18 20:17:08,REAL,2844411829,479,2844412308,2845106684
2025-06-18 20:17:10,REAL,2844412308,484,2844412792,2845107168
2025-06-18 20:17:12,REAL,2844412792,486,2844413278,2845107654
2025-06-18 20:17:14,FAKE,2844413278,243,2844413521,2845108131
2025-06-18 20:17:16,REAL,2844413521,487,2844414008,2845108618
2025-06-18 20:17:18,REAL,2844414008,489,2844414497,2845109107
2025-06-18 20:17:20,REAL,2844414497,489,2844414986,2845109596
2025-06-18 20:17:22,FAKE,2844414986,241,2844415227,2845110078
2025-06-18 20:17:24,REAL,2844415227,485,2844415712,2845110563
2025-06-18 20:17:26,FAKE,2844415712,244,2844415956,2845111049
2025-06-18 20:17:28,REAL,2844415956,483,2844416439,2845111532
2025-06-18 20:17:30,REAL,2844416439,2201,2844418640,2845113733
2025-06-18 20:17:32,REAL,2844418640,15403,2844434043,2845129136
2025-06-18 20:17:34,FAKE,2844434043,238,2844434281,2845139384
2025-06-18 20:17:36,FAKE,2844434281,244,2844434525,2845149750
2025-06-18 20:17:38,REAL,2844434525,10252,2844444777,2845160002
2025-06-18 20:17:40,FAKE,2844444777,238,2844445015,2845170324
2025-06-18 20:17:42,FAKE,2844445015,244,2844445259,2845180580
2025-06-18 20:17:44,REAL,2844445259,10328,2844455587,2845190908
2025-06-18 20:17:46,REAL,2844455587,3855,2844459442,2845194763
2025-06-18 20:17:48,FAKE,2844459442,238,2844459680,2845195249
2025-06-18 20:17:50,FAKE,2844459680,238,2844459918,2845195732
2025-06-18 20:17:52,REAL,2844459918,10058,2844469976,2845205790
2025-06-18 20:17:54,REAL,2844469976,11832,2844481808,2845217622
2025-06-18 20:17:56,REAL,2844481808,10248,2844492056,2845227870
2025-06-18 20:17:58,FAKE,2844492056,244,2844492300,2845238126
2025-06-18 20:18:00,FAKE,2844492300,243,2844492543,2845248381
2025-06-18 20:18:02,REAL,2844492543,10250,2844502793,2845258631
2025-06-18 20:18:04,REAL,2844502793,10320,2844513113,2845268951
2025-06-18 20:18:06,REAL,2844513113,8347,2844521460,2845277298
2025-06-18 20:18:08,FAKE,2844521460,243,2844521703,2845277783
2025-06-18 20:18:10,REAL,2844521703,489,2844522192,2845278272
2025-06-18 20:18:12,REAL,2844522192,485,2844522677,2845278757
2025-06-18 20:18:14,REAL,2844522677,486,2844523163,2845279243
2025-06-18 20:18:16,REAL,2844523163,480,2844523643,2845279723
2025-06-18 20:18:18,REAL,2844523643,483,2844524126,2845280206
2025-06-18 20:18:20,REAL,2844524126,483,2844524609,2845280689
2025-06-18 20:18:22,FAKE,2844524609,243,2844524852,2845281231
2025-06-18 20:18:24,REAL,2844524852,9003,2844533855,2845290234
2025-06-18 20:18:26,REAL,2844533855,10575,2844544430,2845300809
2025-06-18 20:18:28,REAL,2844544430,10315,2844554745,2845311124
2025-06-18 20:18:30,REAL,2844554745,10247,2844564992,2845321371
2025-06-18 20:18:32,REAL,2844564992,10315,2844575307,2845331686
2025-06-18 20:18:34,REAL,2844575307,10259,2844585566,2845341945
2025-06-18 20:18:36,FAKE,2844585566,238,2844585804,2845352191
2025-06-18 20:18:38,REAL,2844585804,7805,2844593609,2845359996
2025-06-18 20:18:40,FAKE,2844593609,241,2844593850,2845360481
2025-06-18 20:18:42,REAL,2844593850,485,2844594335,2845360966
2025-06-18 20:18:44,REAL,2844594335,492,2844594827,2845361458
2025-06-18 20:18:46,REAL,2844594827,486,2844595313,2845361944
2025-06-18 20:18:48,REAL,2844595313,482,2844595795,2845362426
2025-06-18 20:18:50,REAL,2844595795,484,2844596279,2845362910
2025-06-18 20:18:52,REAL,2844596279,478,2844596757,2845363388
2025-06-18 20:18:54,REAL,2844596757,479,2844597236,2845363867
2025-06-18 20:18:56,FAKE,2844597236,238,2844597474,2845373994
2025-06-18 20:18:58,REAL,2844597474,10453,2844607927,2845384447
2025-06-18 20:19:00,REAL,2844607927,10304,2844618231,2845394751
2025-06-18 20:19:02,REAL,2844618231,10257,2844628488,2845405008
2025-06-18 20:19:04,REAL,2844628488,10321,2844638809,2845415329
2025-06-18 20:19:06,REAL,2844638809,10254,2844649063,2845425583
2025-06-18 20:19:08,REAL,2844649063,10245,2844659308,2845435828
2025-06-18 20:19:10,FAKE,2844659308,238,2844659546,2845443108
2025-06-18 20:19:12,REAL,2844659546,486,2844660032,2845443594
2025-06-18 20:19:14,FAKE,2844660032,243,2844660275,2845444072
2025-06-18 20:19:16,REAL,2844660275,482,2844660757,2845444554
2025-06-18 20:19:18,FAKE,2844660757,243,2844661000,2845445034
2025-06-18 20:19:20,FAKE,2844661000,243,2844661243,2845445523
2025-06-18 20:19:22,REAL,2844661243,481,2844661724,2845446004
2025-06-18 20:19:24,FAKE,2844661724,243,2844661967,2845446489
2025-06-18 20:19:26,FAKE,2844661967,244,2844662211,2845446971
2025-06-18 20:19:28,REAL,2844662211,11116,2844673327,2845458087
2025-06-18 20:19:30,REAL,2844673327,10258,2844683585,2845468345
2025-06-18 20:19:32,REAL,2844683585,10316,2844693901,2845478661
2025-06-18 20:19:34,REAL,2844693901,10246,2844704147,2845488907
2025-06-18 20:19:36,FAKE,2844704147,244,2844704391,2845499227
2025-06-18 20:19:38,FAKE,2844704391,244,2844704635,2845509474
2025-06-18 20:19:40,REAL,2844704635,10254,2844714889,2845519728
2025-06-18 20:19:42,FAKE,2844714889,244,2844715133,2845526282
2025-06-18 20:19:44,REAL,2844715133,486,2844715619,2845526768
2025-06-18 20:19:46,REAL,2844715619,488,2844716107,2845527256
2025-06-18 20:19:48,FAKE,2844716107,243,2844716350,2845527732
2025-06-18 20:19:50,REAL,2844716350,486,2844716836,2845528218
2025-06-18 20:19:52,REAL,2844716836,491,2844717327,2845528709
2025-06-18 20:19:54,FAKE,2844717327,244,2844717571,2845529198
2025-06-18 20:19:56,REAL,2844717571,535,2844718106,2845529733
2025-06-18 20:19:58,FAKE,2844718106,244,2844718350,2845530220
2025-06-18 20:20:00,REAL,2844718350,481,2844718831,2845530701
2025-06-18 20:20:02,REAL,2844718831,494,2844719325,2845531195
2025-06-18 20:20:04,REAL,2844719325,541,2844719866,2845531736
2025-06-18 20:20:06,REAL,2844719866,488,2844720354,2845532224
2025-06-18 20:20:08,FAKE,2844720354,244,2844720598,2845532705
2025-06-18 20:20:10,REAL,2844720598,489,2844721087,2845533194
2025-06-18 20:20:12,FAKE,2844721087,238,2844721325,2845533675
2025-06-18 20:20:14,REAL,2844721325,487,2844721812,2845534162
2025-06-18 20:20:16,REAL,2844721812,479,2844722291,2845534641
2025-06-18 20:20:18,FAKE,2844722291,238,2844722529,2845535130
2025-06-18 20:20:20,FAKE,2844722529,244,2844722773,2845540903
2025-06-18 20:20:22,REAL,2844722773,10916,2844733689,2845551819
2025-06-18 20:20:24,REAL,2844733689,10253,2844743942,2845562072
2025-06-18 20:20:26,REAL,2844743942,10245,2844754187,2845572317
2025-06-18 20:20:28,REAL,2844754187,10323,2844764510,2845582640
2025-06-18 20:20:30,FAKE,2844764510,238,2844764748,2845592894
2025-06-18 20:20:32,REAL,2844764748,10246,2844774994,2845603140
2025-06-18 20:20:34,REAL,2844774994,10252,2844785246,2845613392
2025-06-18 20:20:36,REAL,2844785246,814,2844786060,2845614206
2025-06-18 20:20:38,REAL,2844786060,479,2844786539,2845614685
2025-06-18 20:20:40,FAKE,2844786539,238,2844786777,2845615168
2025-06-18 20:20:42,REAL,2844786777,481,2844787258,2845615649
2025-06-18 20:20:44,FAKE,2844787258,244,2844787502,2845616188
2025-06-18 20:20:46,FAKE,2844787502,238,2844787740,2845616662
2025-06-18 20:20:48,REAL,2844787740,540,2844788280,2845617202
2025-06-18 20:20:50,REAL,2844788280,481,2844788761,2845617683
2025-06-18 20:20:52,REAL,2844788761,491,2844789252,2845618174
2025-06-18 20:20:54,FAKE,2844789252,238,2844789490,2845618661
2025-06-18 20:20:56,REAL,2844789490,481,2844789971,2845619142
2025-06-18 20:20:58,REAL,2844789971,480,2844790451,2845619622
2025-06-18 20:21:00,REAL,2844790451,481,2844790932,2845620103
2025-06-18 20:21:02,REAL,2844790932,480,2844791412,2845620583
2025-06-18 20:21:04,REAL,2844791412,487,2844791899,2845621070
2025-06-18 20:21:06,REAL,2844791899,485,2844792384,2845621555
2025-06-18 20:21:08,FAKE,2844792384,241,2844792625,2845622033
2025-06-18 20:21:10,REAL,2844792625,484,2844793109,2845622517
2025-06-18 20:21:12,REAL,2844793109,488,2844793597,2845623005
2025-06-18 20:21:14,FAKE,2844793597,241,2844793838,2845623496
2025-06-18 20:21:16,REAL,2844793838,534,2844794372,2845624030
2025-06-18 20:21:18,REAL,2844794372,482,2844794854,2845624512
2025-06-18 20:21:20,FAKE,2844794854,243,2844795097,2845624991
2025-06-18 20:21:22,REAL,2844795097,485,2844795582,2845625476
2025-06-18 20:21:24,FAKE,2844795582,243,2844795825,2845632769
2025-06-18 20:21:26,FAKE,2844795825,243,2844796068,2845643551
2025-06-18 20:21:28,FAKE,2844796068,243,2844796311,2845653799
2025-06-18 20:21:30,REAL,2844796311,10373,2844806684,2845664172
2025-06-18 20:21:32,FAKE,2844806684,241,2844806925,2845674428
2025-06-18 20:21:34,FAKE,2844806925,241,2844807166,2845684746
2025-06-18 20:21:36,REAL,2844807166,10249,2844817415,2845694995
2025-06-18 20:21:38,REAL,2844817415,9334,2844826749,2845704329
2025-06-18 20:21:40,REAL,2844826749,487,2844827236,2845704816
2025-06-18 20:21:42,REAL,2844827236,483,2844827719,2845705299
2025-06-18 20:21:44,FAKE,2844827719,244,2844827963,2845705787
2025-06-18 20:21:46,FAKE,2844827963,244,2844828207,2845706272
2025-06-18 20:21:48,REAL,2844828207,485,2844828692,2845706757
2025-06-18 20:21:50,REAL,2844828692,488,2844829180,2845707245
2025-06-18 20:21:52,REAL,2844829180,538,2844829718,2845707783
2025-06-18 20:21:54,FAKE,2844829718,238,2844829956,2845708259
2025-06-18 20:21:56,REAL,2844829956,488,2844830444,2845708747
2025-06-18 20:21:58,FAKE,2844830444,244,2844830688,2845709225
2025-06-18 20:22:00,REAL,2844830688,490,2844831178,2845709715
2025-06-18 20:22:02,FAKE,2844831178,241,2844831419,2845710205
2025-06-18 20:22:04,REAL,2844831419,493,2844831912,2845710698
2025-06-18 20:22:06,REAL,2844831912,483,2844832395,2845711181
2025-06-18 20:22:08,REAL,2844832395,482,2844832877,2845711663
2025-06-18 20:22:10,REAL,2844832877,493,2844833370,2845712156
2025-06-18 20:22:12,FAKE,2844833370,241,2844833611,2845712635
2025-06-18 20:22:14,REAL,2844833611,481,2844834092,2845713116
2025-06-18 20:22:16,REAL,2844834092,2540,2844836632,2845715656
2025-06-18 20:22:18,REAL,2844836632,11764,2844848396,2845727420
2025-06-18 20:22:20,FAKE,2844848396,244,2844848640,2845737662
2025-06-18 20:22:22,REAL,2844848640,10247,2844858887,2845747909
2025-06-18 20:22:24,REAL,2844858887,10320,2844869207,2845758229
2025-06-18 20:22:26,REAL,2844869207,10247,2844879454,2845768476
2025-06-18 20:22:28,FAKE,2844879454,238,2844879692,2845778791
2025-06-18 20:22:30,REAL,2844879692,10251,2844889943,2845789042
2025-06-18 20:22:32,FAKE,2844889943,241,2844890184,2845792692
2025-06-18 20:22:34,FAKE,2844890184,241,2844890425,2845793178
2025-06-18 20:22:36,FAKE,2844890425,238,2844890663,2845793653
2025-06-18 20:22:38,REAL,2844890663,8813,2844899476,2845802466
2025-06-18 20:22:40,REAL,2844899476,10445,2844909921,2845812911
2025-06-18 20:22:42,FAKE,2844909921,238,2844910159,2845823231
2025-06-18 20:22:44,FAKE,2844910159,238,2844910397,2845833485
2025-06-18 20:22:46,REAL,2844910397,10249,2844920646,2845843734
2025-06-18 20:22:48,FAKE,2844920646,241,2844920887,2845854062
2025-06-18 20:22:50,REAL,2844920887,10249,2844931136,2845864311
2025-06-18 20:22:52,FAKE,2844931136,241,2844931377,2845872514
2025-06-18 20:22:54,REAL,2844931377,490,2844931867,2845873004
2025-06-18 20:22:56,FAKE,2844931867,241,2844932108,2845873492
2025-06-18 20:22:58,REAL,2844932108,480,2844932588,2845873972
2025-06-18 20:23:00,REAL,2844932588,480,2844933068,2845874452
2025-06-18 20:23:02,REAL,2844933068,488,2844933556,2845874940
2025-06-18 20:23:04,REAL,2844933556,484,2844934040,2845875424
2025-06-18 20:23:06,FAKE,2844934040,243,2844934283,2845876015
2025-06-18 20:23:08,FAKE,2844934283,241,2844934524,2845876491
2025-06-18 20:23:10,REAL,2844934524,9670,2844944194,2845886161
2025-06-18 20:23:12,FAKE,2844944194,241,2844944435,2845896813
2025-06-18 20:23:14,REAL,2844944435,10255,2844954690,2845907068
2025-06-18 20:23:16,FAKE,2844954690,238,2844954928,2845917315
2025-06-18 20:23:18,FAKE,2844954928,238,2844955166,2845927632
2025-06-18 20:23:20,FAKE,2844955166,244,2844955410,2845937892
2025-06-18 20:23:22,FAKE,2844955410,238,2844955648,2845948140
2025-06-18 20:23:24,REAL,2844955648,7547,2844963195,2845955687
2025-06-18 20:23:26,REAL,2844963195,487,2844963682,2845956174
2025-06-18 20:23:28,FAKE,2844963682,244,2844963926,2845956667
2025-06-18 20:23:30,FAKE,2844963926,238,2844964164,2845957144
2025-06-18 20:23:32,REAL,2844964164,482,2844964646,2845957626
2025-06-18 20:23:34,REAL,2844964646,485,2844965131,2845958111
2025-06-18 20:23:36,REAL,2844965131,536,2844965667,2845958647
2025-06-18 20:23:38,FAKE,2844965667,241,2844965908,2845959127
2025-06-18 20:23:40,REAL,2844965908,491,2844966399,2845959618
2025-06-18 20:23:42,REAL,2844966399,10126,2844976525,2845969744
2025-06-18 20:23:44,REAL,2844976525,10377,2844986902,2845980121
2025-06-18 20:23:46,FAKE,2844986902,241,2844987143,2845990374
2025-06-18 20:23:48,FAKE,2844987143,243,2844987386,2846000694
2025-06-18 20:23:50,FAKE,2844987386,238,2844987624,2846010946
2025-06-18 20:23:52,REAL,2844987624,10246,2844997870,2846021192
2025-06-18 20:23:54,REAL,2844997870,10318,2845008188,2846031510
2025-06-18 20:23:56,REAL,2845008188,6944,2845015132,2846038454
2025-06-18 20:23:58,REAL,2845015132,482,2845015614,2846038936
2025-06-18 20:24:00,REAL,2845015614,479,2845016093,2846039415
2025-06-18 20:24:02,REAL,2845016093,483,2845016576,2846039898
2025-06-18 20:24:04,FAKE,2845016576,244,2845016820,2846040376
2025-06-18 20:24:06,REAL,2845016820,484,2845017304,2846040860
2025-06-18 20:24:08,REAL,2845017304,540,2845017844,2846041400
2025-06-18 20:24:10,REAL,2845017844,476,2845018320,2846041876
2025-06-18 20:24:12,REAL,2845018320,476,2845018796,2846042352
2025-06-18 20:24:14,REAL,2845018796,11125,2845029921,2846053477
2025-06-18 20:24:16,REAL,2845029921,10378,2845040299,2846063855
2025-06-18 20:24:18,FAKE,2845040299,244,2845040543,2846074373
2025-06-18 20:24:20,FAKE,2845040543,241,2845040784,2846084435
2025-06-18 20:24:22,FAKE,2845040784,243,2845041027,2846094686
2025-06-18 20:24:24,REAL,2845041027,10257,2845051284,2846104943
2025-06-18 20:24:26,REAL,2845051284,10309,2845061593,2846115252
2025-06-18 20:24:28,REAL,2845061593,6301,2845067894,2846121553
2025-06-18 20:24:30,FAKE,2845067894,238,2845068132,2846122043
2025-06-18 20:24:32,REAL,2845068132,478,2845068610,2846122521
2025-06-18 20:24:34,REAL,2845068610,489,2845069099,2846123010
2025-06-18 20:24:36,REAL,2845069099,474,2845069573,2846123484
2025-06-18 20:24:38,REAL,2845069573,481,2845070054,2846123965
2025-06-18 20:24:40,REAL,2845070054,542,2845070596,2846124507
2025-06-18 20:24:42,REAL,2845070596,477,2845071073,2846124984
2025-06-18 20:24:44,REAL,2845071073,534,2845071607,2846125518
2025-06-18 20:24:46,REAL,2845071607,11716,2845083323,2846137234
2025-06-18 20:24:48,REAL,2845083323,10250,2845093573,2846147484
2025-06-18 20:24:50,FAKE,2845093573,238,2845093811,2846157740
2025-06-18 20:24:52,REAL,2845093811,10242,2845104053,2846167982
2025-06-18 20:24:54,FAKE,2845104053,238,2845104291,2846178232
2025-06-18 20:24:56,FAKE,2845104291,241,2845104532,2846188487
2025-06-18 20:24:58,REAL,2845104532,10258,2845114790,2846198745
2025-06-18 20:25:00,REAL,2845114790,5632,2845120422,2846204377
2025-06-18 20:25:02,FAKE,2845120422,243,2845120665,2846204854
2025-06-18 20:25:04,REAL,2845120665,483,2845121148,2846205337
2025-06-18 20:25:06,REAL,2845121148,482,2845121630,2846205819
2025-06-18 20:25:08,REAL,2845121630,479,2845122109,2846206298
2025-06-18 20:25:10,REAL,2845122109,475,2845122584,2846206773
2025-06-18 20:25:12,REAL,2845122584,489,2845123073,2846207262
2025-06-18 20:25:14,REAL,2845123073,487,2845123560,2846207749
2025-06-18 20:25:16,REAL,2845123560,484,2845124044,2846208233
2025-06-18 20:25:18,REAL,2845124044,482,2845124526,2846208715
2025-06-18 20:25:20,FAKE,2845124526,243,2845124769,2846209198
2025-06-18 20:25:22,REAL,2845124769,482,2845125251,2846209680
2025-06-18 20:25:24,FAKE,2845125251,244,2845125495,2846210169
2025-06-18 20:25:26,FAKE,2845125495,241,2845125736,2846210652
2025-06-18 20:25:28,REAL,2845125736,491,2845126227,2846211143
2025-06-18 20:25:30,REAL,2845126227,482,2845126709,2846211625
2025-06-18 20:25:32,FAKE,2845126709,241,2845126950,2846212105
2025-06-18 20:25:34,REAL,2845126950,480,2845127430,2846212585
2025-06-18 20:25:36,REAL,2845127430,600,2845128030,2846213185
2025-06-18 20:25:38,FAKE,2845128030,244,2845128274,2846213675
2025-06-18 20:25:40,REAL,2845128274,490,2845128764,2846214165
2025-06-18 20:25:42,FAKE,2845128764,244,2845129008,2846214653
2025-06-18 20:25:44,FAKE,2845129008,238,2845129246,2846215145
2025-06-18 20:25:46,REAL,2845129246,484,2845129730,2846215629
2025-06-18 20:25:48,REAL,2845129730,1613,2845131343,2846217242
2025-06-18 20:25:50,REAL,2845131343,12035,2845143378,2846229277
2025-06-18 20:25:52,REAL,2845143378,10256,2845153634,2846239533
2025-06-18 20:25:54,FAKE,2845153634,238,2845153872,2846249787
2025-06-18 20:25:56,REAL,2845153872,10323,2845164195,2846260110
2025-06-18 20:25:58,FAKE,2845164195,243,2845164438,2846270366
2025-06-18 20:26:00,FAKE,2845164438,238,2845164676,2846280680
2025-06-18 20:26:02,FAKE,2845164676,243,2845164919,2846290941
2025-06-18 20:26:04,FAKE,2845164919,238,2845165157,2846295382
2025-06-18 20:26:06,REAL,2845165157,486,2845165643,2846295868
2025-06-18 20:26:08,REAL,2845165643,485,2845166128,2846296353
2025-06-18 20:26:10,FAKE,2845166128,244,2845166372,2846296833
2025-06-18 20:26:12,FAKE,2845166372,241,2845166613,2846297317
2025-06-18 20:26:14,REAL,2845166613,483,2845167096,2846297800
2025-06-18 20:26:16,REAL,2845167096,476,2845167572,2846298276
2025-06-18 20:26:18,FAKE,2845167572,238,2845167810,2846298751
2025-06-18 20:26:20,FAKE,2845167810,244,2845168054,2846301292
2025-06-18 20:26:22,REAL,2845168054,11828,2845179882,2846313120
2025-06-18 20:26:24,REAL,2845179882,10260,2845190142,2846323380
2025-06-18 20:26:26,REAL,2845190142,10370,2845200512,2846333750
2025-06-18 20:26:28,REAL,2845200512,10254,2845210766,2846344004
2025-06-18 20:26:30,REAL,2845210766,10251,2845221017,2846354255
2025-06-18 20:26:32,FAKE,2845221017,244,2845221261,2846364582
2025-06-18 20:26:34,REAL,2845221261,10253,2845231514,2846374835
2025-06-18 20:26:36,FAKE,2845231514,238,2845231752,2846378620
2025-06-18 20:26:38,REAL,2845231752,482,2845232234,2846379102
2025-06-18 20:26:40,REAL,2845232234,485,2845232719,2846379587
2025-06-18 20:26:42,REAL,2845232719,486,2845233205,2846380073
2025-06-18 20:26:44,REAL,2845233205,476,2845233681,2846380549
2025-06-18 20:26:46,FAKE,2845233681,243,2845233924,2846381031
2025-06-18 20:26:48,FAKE,2845233924,243,2845234167,2846381522
2025-06-18 20:26:50,REAL,2845234167,484,2845234651,2846382006
2025-06-18 20:26:52,REAL,2845234651,2867,2845237518,2846384873
2025-06-18 20:26:54,REAL,2845237518,14081,2845251599,2846398954
2025-06-18 20:26:56,REAL,2845251599,10247,2845261846,2846409201
2025-06-18 20:26:58,REAL,2845261846,10316,2845272162,2846419517
2025-06-18 20:27:00,REAL,2845272162,10252,2845282414,2846429769
2025-06-18 20:27:02,FAKE,2845282414,243,2845282657,2846440026
2025-06-18 20:27:04,FAKE,2845282657,243,2845282900,2846450273
2025-06-18 20:27:06,FAKE,2845282900,244,2845283144,2846460525
2025-06-18 20:27:08,REAL,2845283144,3194,2845286338,2846463719
2025-06-18 20:27:10,FAKE,2845286338,244,2845286582,2846464195
2025-06-18 20:27:12,REAL,2845286582,482,2845287064,2846464677
2025-06-18 20:27:14,FAKE,2845287064,244,2845287308,2846465151
2025-06-18 20:27:16,REAL,2845287308,485,2845287793,2846465636
2025-06-18 20:27:18,REAL,2845287793,545,2845288338,2846466181
2025-06-18 20:27:20,REAL,2845288338,484,2845288822,2846466665
2025-06-18 20:27:22,REAL,2845288822,484,2845289306,2846467149
2025-06-18 20:27:24,REAL,2845289306,481,2845289787,2846467630
2025-06-18 20:27:26,REAL,2845289787,485,2845290272,2846468115
2025-06-18 20:27:28,REAL,2845290272,478,2845290750,2846468593
2025-06-18 20:27:30,REAL,2845290750,474,2845291224,2846469067
2025-06-18 20:27:32,REAL,2845291224,477,2845291701,2846469544
2025-06-18 20:27:34,REAL,2845291701,477,2845292178,2846470021
2025-06-18 20:27:36,FAKE,2845292178,241,2845292419,2846470500
2025-06-18 20:27:38,FAKE,2845292419,238,2845292657,2846470982
2025-06-18 20:27:40,REAL,2845292657,484,2845293141,2846471466
2025-06-18 20:27:42,REAL,2845293141,479,2845293620,2846471945
2025-06-18 20:27:44,REAL,2845293620,533,2845294153,2846472478
2025-06-18 20:27:46,FAKE,2845294153,241,2845294394,2846472957
2025-06-18 20:27:48,REAL,2845294394,481,2845294875,2846473438
2025-06-18 20:27:50,REAL,2845294875,485,2845295360,2846473923
2025-06-18 20:27:52,REAL,2845295360,478,2845295838,2846474401
2025-06-18 20:27:54,FAKE,2845295838,243,2845296081,2846474876
2025-06-18 20:27:56,FAKE,2845296081,241,2845296322,2846479190
2025-06-18 20:27:58,REAL,2845296322,10912,2845307234,2846490102
2025-06-18 20:28:00,REAL,2845307234,10253,2845317487,2846500355
2025-06-18 20:28:02,FAKE,2845317487,241,2845317728,2846510667
2025-06-18 20:28:04,REAL,2845317728,10249,2845327977,2846520916
2025-06-18 20:28:06,REAL,2845327977,10315,2845338292,2846531231
2025-06-18 20:28:08,REAL,2845338292,10316,2845348608,2846541547
2025-06-18 20:28:10,REAL,2845348608,10313,2845358921,2846551860
2025-06-18 20:28:12,FAKE,2845358921,244,2845359165,2846553730
2025-06-18 20:28:14,FAKE,2845359165,241,2845359406,2846554220
2025-06-18 20:28:16,REAL,2845359406,482,2845359888,2846554702
2025-06-18 20:28:18,REAL,2845359888,484,2845360372,2846555186
2025-06-18 20:28:20,FAKE,2845360372,238,2845360610,2846555664
2025-06-18 20:28:22,FAKE,2845360610,244,2845360854,2846556139
2025-06-18 20:28:24,REAL,2845360854,482,2845361336,2846556621
2025-06-18 20:28:26,REAL,2845361336,478,2845361814,2846557099
2025-06-18 20:28:28,FAKE,2845361814,244,2845362058,2846557579
2025-06-18 20:28:30,REAL,2845362058,490,2845362548,2846558069
2025-06-18 20:28:32,FAKE,2845362548,243,2845362791,2846558554
2025-06-18 20:28:34,REAL,2845362791,485,2845363276,2846559039
2025-06-18 20:28:36,REAL,2845363276,545,2845363821,2846559584
2025-06-18 20:28:38,REAL,2845363821,481,2845364302,2846560065
2025-06-18 20:28:40,REAL,2845364302,488,2845364790,2846560553
2025-06-18 20:28:42,REAL,2845364790,482,2845365272,2846561035
2025-06-18 20:28:44,FAKE,2845365272,238,2845365510,2846561526
2025-06-18 20:28:46,REAL,2845365510,244,2845365754,2846561770
2025-06-18 20:28:48,FAKE,2845365754,241,2845365995,2846562308
2025-06-18 20:28:50,REAL,2845365995,486,2845366481,2846562794
2025-06-18 20:28:52,REAL,2845366481,487,2845366968,2846563281
2025-06-18 20:28:54,REAL,2845366968,485,2845367453,2846563766
2025-06-18 20:28:56,REAL,2845367453,486,2845367939,2846564252
2025-06-18 20:28:58,REAL,2845367939,483,2845368422,2846564735
2025-06-18 20:29:00,REAL,2845368422,488,2845368910,2846565223
2025-06-18 20:29:02,REAL,2845368910,548,2845369458,2846565771
2025-06-18 20:29:04,FAKE,2845369458,244,2845369702,2846566254
2025-06-18 20:29:06,REAL,2845369702,477,2845370179,2846566731
2025-06-18 20:29:08,REAL,2845370179,480,2845370659,2846567211
2025-06-18 20:29:10,REAL,2845370659,478,2845371137,2846567689
2025-06-18 20:29:12,REAL,2845371137,481,2845371618,2846568170
2025-06-18 20:29:14,FAKE,2845371618,243,2845371861,2846568652
2025-06-18 20:29:16,FAKE,2845371861,241,2845372102,2846575150
2025-06-18 20:29:18,FAKE,2845372102,241,2845372343,2846586067
2025-06-18 20:29:20,REAL,2845372343,10315,2845382658,2846596382
2025-06-18 20:29:22,REAL,2845382658,10248,2845392906,2846606630
2025-06-18 20:29:24,REAL,2845392906,10310,2845403216,2846616940
2025-06-18 20:29:26,REAL,2845403216,10307,2845413523,2846627247
2025-06-18 20:29:28,FAKE,2845413523,241,2845413764,2846637569
2025-06-18 20:29:30,REAL,2845413764,10115,2845423879,2846647684
2025-06-18 20:29:32,REAL,2845423879,488,2845424367,2846648172
2025-06-18 20:29:34,REAL,2845424367,485,2845424852,2846648657
2025-06-18 20:29:36,REAL,2845424852,484,2845425336,2846649141
2025-06-18 20:29:38,REAL,2845425336,486,2845425822,2846649627
2025-06-18 20:29:40,REAL,2845425822,482,2845426304,2846650109
2025-06-18 20:29:42,FAKE,2845426304,244,2845426548,2846650592
2025-06-18 20:29:44,FAKE,2845426548,238,2845426786,2846651076
2025-06-18 20:29:46,REAL,2845426786,490,2845427276,2846651566
2025-06-18 20:29:48,REAL,2845427276,7483,2845434759,2846659049
2025-06-18 20:29:50,REAL,2845434759,10714,2845445473,2846669763
2025-06-18 20:29:52,FAKE,2845445473,243,2845445716,2846680135
2025-06-18 20:29:54,FAKE,2845445716,244,2845445960,2846690389
2025-06-18 20:29:56,REAL,2845445960,10318,2845456278,2846700707
2025-06-18 20:29:58,REAL,2845456278,10254,2845466532,2846710961
2025-06-18 20:30:00,FAKE,2845466532,244,2845466776,2846721214
2025-06-18 20:30:02,REAL,2845466776,9524,2845476300,2846730738
2025-06-18 20:30:04,REAL,2845476300,486,2845476786,2846731224
2025-06-18 20:30:06,FAKE,2845476786,241,2845477027,2846731702
2025-06-18 20:30:08,FAKE,2845477027,243,2845477270,2846732185
2025-06-18 20:30:10,REAL,2845477270,489,2845477759,2846732674
2025-06-18 20:30:12,REAL,2845477759,486,2845478245,2846733160
2025-06-18 20:30:14,FAKE,2845478245,238,2845478483,2846733702
2025-06-18 20:30:16,REAL,2845478483,481,2845478964,2846734183
2025-06-18 20:30:18,REAL,2845478964,544,2845479508,2846734727
2025-06-18 20:30:20,REAL,2845479508,477,2845479985,2846735204
2025-06-18 20:30:22,REAL,2845479985,493,2845480478,2846735697
2025-06-18 20:30:24,REAL,2845480478,489,2845480967,2846736186
2025-06-18 20:30:26,REAL,2845480967,484,2845481451,2846736670
2025-06-18 20:30:28,REAL,2845481451,494,2845481945,2846737164
2025-06-18 20:30:30,REAL,2845481945,485,2845482430,2846737649
2025-06-18 20:30:32,FAKE,2845482430,238,2845482668,2846738133
2025-06-18 20:30:34,REAL,2845482668,486,2845483154,2846738619
2025-06-18 20:30:36,REAL,2845483154,488,2845483642,2846739107
2025-06-18 20:30:38,REAL,2845483642,489,2845484131,2846739596
2025-06-18 20:30:40,FAKE,2845484131,244,2845484375,2846740087
2025-06-18 20:30:42,FAKE,2845484375,238,2845484613,2846740676
2025-06-18 20:30:44,REAL,2845484613,481,2845485094,2846741157
2025-06-18 20:30:46,REAL,2845485094,479,2845485573,2846741636
2025-06-18 20:30:48,FAKE,2845485573,244,2845485817,2846742123
2025-06-18 20:30:50,FAKE,2845485817,244,2845486061,2846742610
2025-06-18 20:30:52,REAL,2845486061,8811,2845494872,2846751421
2025-06-18 20:30:54,REAL,2845494872,10641,2845505513,2846762062
2025-06-18 20:30:56,FAKE,2845505513,244,2845505757,2846772323
2025-06-18 20:30:58,REAL,2845505757,10246,2845516003,2846782569
2025-06-18 20:31:00,FAKE,2845516003,244,2845516247,2846792826
2025-06-18 20:31:02,REAL,2845516247,10320,2845526567,2846803146
2025-06-18 20:31:04,REAL,2845526567,10245,2845536812,2846813391
2025-06-18 20:31:06,FAKE,2845536812,241,2845537053,2846821655
2025-06-18 20:31:08,REAL,2845537053,475,2845537528,2846822130
2025-06-18 20:31:10,REAL,2845537528,483,2845538011,2846822613
2025-06-18 20:31:12,FAKE,2845538011,241,2845538252,2846823091
2025-06-18 20:31:14,REAL,2845538252,483,2845538735,2846823574
2025-06-18 20:31:16,REAL,2845538735,485,2845539220,2846824059
2025-06-18 20:31:18,REAL,2845539220,549,2845539769,2846824608
2025-06-18 20:31:20,REAL,2845539769,485,2845540254,2846825093
2025-06-18 20:31:22,REAL,2845540254,485,2845540739,2846825578
2025-06-18 20:31:24,REAL,2845540739,475,2845541214,2846826053
2025-06-18 20:31:26,FAKE,2845541214,244,2845541458,2846826536
2025-06-18 20:31:28,FAKE,2845541458,238,2845541696,2846827018
2025-06-18 20:31:30,FAKE,2845541696,244,2845541940,2846827504
2025-06-18 20:31:32,REAL,2845541940,484,2845542424,2846827988
2025-06-18 20:31:34,REAL,2845542424,545,2845542969,2846828533
2025-06-18 20:31:36,REAL,2845542969,484,2845543453,2846829017
2025-06-18 20:31:38,REAL,2845543453,491,2845543944,2846829508
2025-06-18 20:31:40,REAL,2845543944,482,2845544426,2846829990
2025-06-18 20:31:42,REAL,2845544426,488,2845544914,2846830478
2025-06-18 20:31:44,REAL,2845544914,491,2845545405,2846830969
2025-06-18 20:31:46,FAKE,2845545405,238,2845545643,2846831508
2025-06-18 20:31:48,REAL,2845545643,490,2845546133,2846831998
2025-06-18 20:31:50,REAL,2845546133,481,2845546614,2846832479
2025-06-18 20:31:52,REAL,2845546614,478,2845547092,2846832957
2025-06-18 20:31:54,REAL,2845547092,481,2845547573,2846833438
2025-06-18 20:31:56,REAL,2845547573,11838,2845559411,2846845276
2025-06-18 20:31:58,REAL,2845559411,10445,2845569856,2846855721
2025-06-18 20:32:00,FAKE,2845569856,238,2845570094,2846866031
2025-06-18 20:32:02,FAKE,2845570094,244,2845570338,2846876288
2025-06-18 20:32:04,REAL,2845570338,10257,2845580595,2846886545
2025-06-18 20:32:06,REAL,2845580595,10248,2845590843,2846896793
2025-06-18 20:32:08,REAL,2845590843,10257,2845601100,2846907050
2025-06-18 20:32:10,REAL,2845601100,7023,2845608123,2846914073
2025-06-18 20:32:12,REAL,2845608123,488,2845608611,2846914561
2025-06-18 20:32:14,REAL,2845608611,481,2845609092,2846915042
2025-06-18 20:32:16,FAKE,2845609092,243,2845609335,2846915531
2025-06-18 20:32:18,REAL,2845609335,475,2845609810,2846916006
2025-06-18 20:32:20,REAL,2845609810,482,2845610292,2846916488
2025-06-18 20:32:22,REAL,2845610292,535,2845610827,2846917023
2025-06-18 20:32:24,FAKE,2845610827,243,2845611070,2846917569
2025-06-18 20:32:26,REAL,2845611070,479,2845611549,2846918048
2025-06-18 20:32:28,REAL,2845611549,13760,2845625309,2846931808
2025-06-18 20:32:30,REAL,2845625309,10784,2845636093,2846942592
2025-06-18 20:32:32,REAL,2845636093,10243,2845646336,2846952835
2025-06-18 20:32:34,FAKE,2845646336,241,2845646577,2846963093
2025-06-18 20:32:36,REAL,2845646577,10315,2845656892,2846973408
2025-06-18 20:32:38,REAL,2845656892,10250,2845667142,2846983658
2025-06-18 20:32:40,REAL,2845667142,10318,2845677460,2846993976
2025-06-18 20:32:42,FAKE,2845677460,243,2845677703,2847000341
2025-06-18 20:32:44,FAKE,2845677703,241,2845677944,2847000821
2025-06-18 20:32:46,REAL,2845677944,475,2845678419,2847001296
2025-06-18 20:32:48,REAL,2845678419,543,2845678962,2847001839
2025-06-18 20:32:50,FAKE,2845678962,238,2845679200,2847002325
2025-06-18 20:32:52,REAL,2845679200,475,2845679675,2847002800
2025-06-18 20:32:54,FAKE,2845679675,241,2845679916,2847003339
2025-06-18 20:32:56,REAL,2845679916,476,2845680392,2847003815
2025-06-18 20:32:58,FAKE,2845680392,243,2845680635,2847004305
2025-06-18 20:33:00,FAKE,2845680635,241,2845680876,2847015613
2025-06-18 20:33:02,REAL,2845680876,10325,2845691201,2847025938
2025-06-18 20:33:04,FAKE,2845691201,238,2845691439,2847036196
2025-06-18 20:33:06,REAL,2845691439,10252,2845701691,2847046448
2025-06-18 20:33:08,FAKE,2845701691,243,2845701934,2847056771
2025-06-18 20:33:10,FAKE,2845701934,238,2845702172,2847067023
2025-06-18 20:33:12,REAL,2845702172,10318,2845712490,2847077341
2025-06-18 20:33:14,REAL,2845712490,5754,2845718244,2847083095
2025-06-18 20:33:16,REAL,2845718244,481,2845718725,2847083576
2025-06-18 20:33:18,REAL,2845718725,489,2845719214,2847084065
2025-06-18 20:33:20,REAL,2845719214,493,2845719707,2847084558
2025-06-18 20:33:22,FAKE,2845719707,244,2845719951,2847085051
2025-06-18 20:33:24,REAL,2845719951,487,2845720438,2847085538
2025-06-18 20:33:26,REAL,2845720438,547,2845720985,2847086085
2025-06-18 20:33:28,REAL,2845720985,488,2845721473,2847086573
2025-06-18 20:33:30,REAL,2845721473,475,2845721948,2847087048
2025-06-18 20:33:32,REAL,2845721948,476,2845722424,2847087524
2025-06-18 20:33:34,REAL,2845722424,486,2845722910,2847088010
2025-06-18 20:33:36,REAL,2845722910,480,2845723390,2847088490
2025-06-18 20:33:38,REAL,2845723390,536,2845723926,2847089026
2025-06-18 20:33:40,FAKE,2845723926,244,2845724170,2847089516
2025-06-18 20:33:42,REAL,2845724170,478,2845724648,2847089994
2025-06-18 20:33:44,REAL,2845724648,481,2845725129,2847090475
2025-06-18 20:33:46,REAL,2845725129,484,2845725613,2847090959
2025-06-18 20:33:48,FAKE,2845725613,243,2845725856,2847091445
2025-06-18 20:33:50,REAL,2845725856,494,2845726350,2847091939
2025-06-18 20:33:52,FAKE,2845726350,241,2845726591,2847099694
2025-06-18 20:33:54,REAL,2845726591,10784,2845737375,2847110478
2025-06-18 20:33:56,REAL,2845737375,10317,2845747692,2847120795
2025-06-18 20:33:58,FAKE,2845747692,244,2845747936,2847131042
2025-06-18 20:34:00,REAL,2845747936,10316,2845758252,2847141358
2025-06-18 20:34:02,REAL,2845758252,10253,2845768505,2847151611
2025-06-18 20:34:04,REAL,2845768505,10317,2845778822,2847161928
2025-06-18 20:34:06,REAL,2845778822,9587,2845788409,2847171515
2025-06-18 20:34:08,REAL,2845788409,477,2845788886,2847171992
2025-06-18 20:34:10,REAL,2845788886,485,2845789371,2847172477
2025-06-18 20:34:12,REAL,2845789371,490,2845789861,2847172967
2025-06-18 20:34:14,REAL,2845789861,483,2845790344,2847173450
2025-06-18 20:34:16,FAKE,2845790344,244,2845790588,2847173940
2025-06-18 20:34:18,REAL,2845790588,489,2845791077,2847174429
2025-06-18 20:34:20,FAKE,2845791077,243,2845791320,2847174967
2025-06-18 20:34:22,REAL,2845791320,481,2845791801,2847175448
2025-06-18 20:34:24,REAL,2845791801,8935,2845800736,2847184383
2025-06-18 20:34:26,REAL,2845800736,11106,2845811842,2847195489
2025-06-18 20:34:28,REAL,2845811842,10251,2845822093,2847205740
2025-06-18 20:34:30,REAL,2845822093,10314,2845832407,2847216054
2025-06-18 20:34:32,FAKE,2845832407,244,2845832651,2847226306
2025-06-18 20:34:34,REAL,2845832651,10249,2845842900,2847236555
2025-06-18 20:34:36,FAKE,2845842900,238,2845843138,2847246804
2025-06-18 20:34:38,FAKE,2845843138,244,2845843382,2847255799
2025-06-18 20:34:40,FAKE,2845843382,244,2845843626,2847256290
2025-06-18 20:34:42,FAKE,2845843626,244,2845843870,2847256772
2025-06-18 20:34:44,FAKE,2845843870,243,2845844113,2847257262
2025-06-18 20:34:46,REAL,2845844113,481,2845844594,2847257743
2025-06-18 20:34:48,FAKE,2845844594,243,2845844837,2847258286
2025-06-18 20:34:50,FAKE,2845844837,243,2845845080,2847258818
2025-06-18 20:34:52,REAL,2845845080,478,2845845558,2847259296
2025-06-18 20:34:54,FAKE,2845845558,238,2845845796,2847259773
2025-06-18 20:34:56,FAKE,2845845796,243,2845846039,2847260258
2025-06-18 20:34:58,FAKE,2845846039,244,2845846283,2847260743
2025-06-18 20:35:00,FAKE,2845846283,241,2845846524,2847261217
2025-06-18 20:35:02,FAKE,2845846524,238,2845846762,2847261705
2025-06-18 20:35:04,REAL,2845846762,480,2845847242,2847262185
2025-06-18 20:35:06,FAKE,2845847242,238,2845847480,2847262670
2025-06-18 20:35:08,REAL,2845847480,486,2845847966,2847263156
2025-06-18 20:35:10,FAKE,2845847966,244,2845848210,2847263631
2025-06-18 20:35:12,FAKE,2845848210,244,2845848454,2847264171
2025-06-18 20:35:14,REAL,2845848454,489,2845848943,2847264660
2025-06-18 20:35:16,REAL,2845848943,2926,2845851869,2847267586
2025-06-18 20:35:18,REAL,2845851869,13944,2845865813,2847281530
2025-06-18 20:35:20,REAL,2845865813,10323,2845876136,2847291853
2025-06-18 20:35:22,REAL,2845876136,10785,2845886921,2847302638
2025-06-18 20:35:24,REAL,2845886921,9724,2845896645,2847312362
2025-06-18 20:35:26,REAL,2845896645,10253,2845906898,2847322615
2025-06-18 20:35:28,FAKE,2845906898,243,2845907141,2847332869
2025-06-18 20:35:30,REAL,2845907141,10246,2845917387,2847343115
2025-06-18 20:35:32,FAKE,2845917387,244,2845917631,2847346242
2025-06-18 20:35:34,REAL,2845917631,482,2845918113,2847346724
2025-06-18 20:35:36,REAL,2845918113,537,2845918650,2847347261
2025-06-18 20:35:38,REAL,2845918650,489,2845919139,2847347750
2025-06-18 20:35:40,REAL,2845919139,480,2845919619,2847348230
2025-06-18 20:35:42,FAKE,2845919619,241,2845919860,2847348722
2025-06-18 20:35:44,REAL,2845919860,484,2845920344,2847349206
2025-06-18 20:35:46,REAL,2845920344,547,2845920891,2847349753
2025-06-18 20:35:48,REAL,2845920891,490,2845921381,2847350243
2025-06-18 20:35:50,REAL,2845921381,480,2845921861,2847350723
2025-06-18 20:35:52,FAKE,2845921861,238,2845922099,2847351200
2025-06-18 20:35:54,FAKE,2845922099,244,2845922343,2847351679
2025-06-18 20:35:56,FAKE,2845922343,244,2845922587,2847352157
2025-06-18 20:35:58,FAKE,2845922587,241,2845922828,2847352643
2025-06-18 20:36:00,FAKE,2845922828,238,2845923066,2847353131
2025-06-18 20:36:02,REAL,2845923066,541,2845923607,2847353672
2025-06-18 20:36:04,FAKE,2845923607,244,2845923851,2847354147
2025-06-18 20:36:06,REAL,2845923851,485,2845924336,2847354632
2025-06-18 20:36:08,FAKE,2845924336,238,2845924574,2847355114
2025-06-18 20:36:10,REAL,2845924574,481,2845925055,2847355595
2025-06-18 20:36:12,FAKE,2845925055,244,2845925299,2847356078
2025-06-18 20:36:14,REAL,2845925299,491,2845925790,2847356569
2025-06-18 20:36:16,REAL,2845925790,543,2845926333,2847357112
2025-06-18 20:36:18,REAL,2845926333,489,2845926822,2847357601
2025-06-18 20:36:20,REAL,2845926822,486,2845927308,2847358087
2025-06-18 20:36:22,FAKE,2845927308,238,2845927546,2847358572
2025-06-18 20:36:24,REAL,2845927546,481,2845928027,2847359053
2025-06-18 20:36:26,FAKE,2845928027,241,2845928268,2847359593
2025-06-18 20:36:28,REAL,2845928268,481,2845928749,2847360074
2025-06-18 20:36:30,FAKE,2845928749,244,2845928993,2847360563
2025-06-18 20:36:32,REAL,2845928993,486,2845929479,2847361049
2025-06-18 20:36:34,REAL,2845929479,488,2845929967,2847361537
2025-06-18 20:36:36,FAKE,2845929967,238,2845930205,2847366325
2025-06-18 20:36:38,REAL,2845930205,11569,2845941774,2847377894
2025-06-18 20:36:40,FAKE,2845941774,238,2845942012,2847388140
2025-06-18 20:36:42,FAKE,2845942012,243,2845942255,2847398394
2025-06-18 20:36:44,REAL,2845942255,10311,2845952566,2847408705
2025-06-18 20:36:46,REAL,2845952566,10247,2845962813,2847418952
2025-06-18 20:36:48,FAKE,2845962813,243,2845963056,2847429272
2025-06-18 20:36:50,FAKE,2845963056,238,2845963294,2847439575
2025-06-18 20:36:52,FAKE,2845963294,241,2845963535,2847441185
2025-06-18 20:36:54,FAKE,2845963535,243,2845963778,2847441668
2025-06-18 20:36:56,FAKE,2845963778,241,2845964019,2847442150
2025-06-18 20:36:58,REAL,2845964019,474,2845964493,2847442624
2025-06-18 20:37:00,FAKE,2845964493,238,2845964731,2847443113
2025-06-18 20:37:02,REAL,2845964731,481,2845965212,2847443594
2025-06-18 20:37:04,REAL,2845965212,494,2845965706,2847444088
2025-06-18 20:37:06,REAL,2845965706,545,2845966251,2847444633
2025-06-18 20:37:08,FAKE,2845966251,241,2845966492,2847445116
2025-06-18 20:37:10,REAL,2845966492,485,2845966977,2847445601
2025-06-18 20:37:12,FAKE,2845966977,243,2845967220,2847446082
2025-06-18 20:37:14,REAL,2845967220,541,2845967761,2847446623
2025-06-18 20:37:16,FAKE,2845967761,243,2845968004,2847447106
2025-06-18 20:37:18,REAL,2845968004,488,2845968492,2847447594
2025-06-18 20:37:20,FAKE,2845968492,243,2845968735,2847448144
2025-06-18 20:37:22,REAL,2845968735,480,2845969215,2847448624
2025-06-18 20:37:24,REAL,2845969215,475,2845969690,2847449099
2025-06-18 20:37:26,REAL,2845969690,488,2845970178,2847449587
2025-06-18 20:37:28,REAL,2845970178,486,2845970664,2847450073
2025-06-18 20:37:30,REAL,2845970664,487,2845971151,2847450560
2025-06-18 20:37:32,REAL,2845971151,482,2845971633,2847451042
2025-06-18 20:37:34,FAKE,2845971633,238,2845971871,2847451580
2025-06-18 20:37:36,REAL,2845971871,480,2845972351,2847452060
2025-06-18 20:37:38,REAL,2845972351,486,2845972837,2847452546
2025-06-18 20:37:40,REAL,2845972837,6365,2845979202,2847458911
2025-06-18 20:37:42,FAKE,2845979202,244,2845979446,2847469895
2025-06-18 20:37:44,FAKE,2845979446,241,2845979687,2847480210
2025-06-18 20:37:46,REAL,2845979687,10261,2845989948,2847490471
2025-06-18 20:37:48,REAL,2845989948,10253,2846000201,2847500724
2025-06-18 20:37:50,REAL,2846000201,10313,2846010514,2847511037
2025-06-18 20:37:52,REAL,2846010514,10251,2846020765,2847521288
2025-06-18 20:37:54,REAL,2846020765,10172,2846030937,2847531460
2025-06-18 20:37:56,REAL,2846030937,480,2846031417,2847531940
2025-06-18 20:37:58,FAKE,2846031417,243,2846031660,2847532426
2025-06-18 20:38:00,FAKE,2846031660,238,2846031898,2847532910
2025-06-18 20:38:02,REAL,2846031898,492,2846032390,2847533402
2025-06-18 20:38:04,REAL,2846032390,489,2846032879,2847533891
2025-06-18 20:38:06,REAL,2846032879,485,2846033364,2847534376
2025-06-18 20:38:08,REAL,2846033364,542,2846033906,2847534918
2025-06-18 20:38:10,REAL,2846033906,490,2846034396,2847535408
2025-06-18 20:38:12,REAL,2846034396,491,2846034887,2847535899
2025-06-18 20:38:14,FAKE,2846034887,238,2846035125,2847536379
2025-06-18 20:38:16,REAL,2846035125,485,2846035610,2847536864
2025-06-18 20:38:18,FAKE,2846035610,244,2846035854,2847537341
2025-06-18 20:38:20,REAL,2846035854,483,2846036337,2847537824
2025-06-18 20:38:22,FAKE,2846036337,238,2846036575,2847538302
2025-06-18 20:38:24,REAL,2846036575,483,2846037058,2847538785
2025-06-18 20:38:26,FAKE,2846037058,241,2846037299,2847539265
2025-06-18 20:38:28,REAL,2846037299,490,2846037789,2847539755
2025-06-18 20:38:30,REAL,2846037789,482,2846038271,2847540237
2025-06-18 20:38:32,REAL,2846038271,534,2846038805,2847540771
2025-06-18 20:38:34,REAL,2846038805,481,2846039286,2847541252
2025-06-18 20:38:36,FAKE,2846039286,241,2846039527,2847541733
2025-06-18 20:38:38,REAL,2846039527,539,2846040066,2847542272
2025-06-18 20:38:40,REAL,2846040066,486,2846040552,2847542758
2025-06-18 20:38:42,REAL,2846040552,487,2846041039,2847543245
2025-06-18 20:38:44,FAKE,2846041039,244,2846041283,2847543736
2025-06-18 20:38:46,REAL,2846041283,483,2846041766,2847544219
2025-06-18 20:38:48,REAL,2846041766,479,2846042245,2847544698
2025-06-18 20:38:50,REAL,2846042245,479,2846042724,2847545177
2025-06-18 20:38:52,FAKE,2846042724,244,2846042968,2847545662
2025-06-18 20:38:54,REAL,2846042968,482,2846043450,2847546144
2025-06-18 20:38:56,REAL,2846043450,482,2846043932,2847546626
2025-06-18 20:38:58,REAL,2846043932,483,2846044415,2847547109
2025-06-18 20:39:00,REAL,2846044415,484,2846044899,2847547593
2025-06-18 20:39:02,REAL,2846044899,478,2846045377,2847548071
2025-06-18 20:39:04,REAL,2846045377,483,2846045860,2847548554
2025-06-18 20:39:06,REAL,2846045860,483,2846046343,2847549037
2025-06-18 20:39:08,REAL,2846046343,544,2846046887,2847549581
2025-06-18 20:39:10,REAL,2846046887,484,2846047371,2847550065
2025-06-18 20:39:12,REAL,2846047371,538,2846047909,2847550603
2025-06-18 20:39:14,REAL,2846047909,480,2846048389,2847551083
2025-06-18 20:39:16,REAL,2846048389,9064,2846057453,2847560147
2025-06-18 20:39:18,REAL,2846057453,10655,2846068108,2847570802
2025-06-18 20:39:20,REAL,2846068108,10253,2846078361,2847581055
2025-06-18 20:39:22,REAL,2846078361,10311,2846088672,2847591366
2025-06-18 20:39:24,REAL,2846088672,10257,2846098929,2847601623
2025-06-18 20:39:26,FAKE,2846098929,244,2846099173,2847611877
2025-06-18 20:39:28,REAL,2846099173,10317,2846109490,2847622194
2025-06-18 20:39:30,REAL,2846109490,8214,2846117704,2847630408
2025-06-18 20:39:32,FAKE,2846117704,238,2846117942,2847630896
2025-06-18 20:39:34,REAL,2846117942,478,2846118420,2847631374
2025-06-18 20:39:36,FAKE,2846118420,244,2846118664,2847631859
2025-06-18 20:39:38,FAKE,2846118664,241,2846118905,2847632338
2025-06-18 20:39:40,REAL,2846118905,480,2846119385,2847632818
2025-06-18 20:39:42,FAKE,2846119385,238,2846119623,2847633305
2025-06-18 20:39:44,FAKE,2846119623,244,2846119867,2847633849
2025-06-18 20:39:46,REAL,2846119867,482,2846120349,2847634331
2025-06-18 20:39:48,REAL,2846120349,9349,2846129698,2847643680
2025-06-18 20:39:50,FAKE,2846129698,244,2846129942,2847654245
2025-06-18 20:39:52,FAKE,2846129942,241,2846130183,2847664561
2025-06-18 20:39:54,REAL,2846130183,10254,2846140437,2847674815
2025-06-18 20:39:56,FAKE,2846140437,241,2846140678,2847685059
2025-06-18 20:39:58,REAL,2846140678,10257,2846150935,2847695316
2025-06-18 20:40:00,FAKE,2846150935,244,2846151179,2847705567
2025-06-18 20:40:02,FAKE,2846151179,241,2846151420,2847713175
2025-06-18 20:40:04,REAL,2846151420,487,2846151907,2847713662
2025-06-18 20:40:06,REAL,2846151907,478,2846152385,2847714140
2025-06-18 20:40:08,FAKE,2846152385,244,2846152629,2847714620
2025-06-18 20:40:10,REAL,2846152629,491,2846153120,2847715111
2025-06-18 20:40:12,REAL,2846153120,484,2846153604,2847715595
2025-06-18 20:40:14,FAKE,2846153604,244,2846153848,2847716085
2025-06-18 20:40:16,FAKE,2846153848,243,2846154091,2847716574
2025-06-18 20:40:18,FAKE,2846154091,243,2846154334,2847717054
2025-06-18 20:40:20,REAL,2846154334,13362,2846167696,2847730416
2025-06-18 20:40:22,REAL,2846167696,11045,2846178741,2847741461
2025-06-18 20:40:24,FAKE,2846178741,238,2846178979,2847751710
2025-06-18 20:40:26,FAKE,2846178979,243,2846179222,2847761962
2025-06-18 20:40:28,FAKE,2846179222,244,2846179466,2847772284
2025-06-18 20:40:30,REAL,2846179466,10305,2846189771,2847782589
2025-06-18 20:40:32,FAKE,2846189771,238,2846190009,2847792849
2025-06-18 20:40:34,REAL,2846190009,7018,2846197027,2847799867
2025-06-18 20:40:36,FAKE,2846197027,244,2846197271,2847800345
2025-06-18 20:40:38,FAKE,2846197271,238,2846197509,2847800838
2025-06-18 20:40:40,REAL,2846197509,481,2846197990,2847801319
2025-06-18 20:40:42,FAKE,2846197990,243,2846198233,2847801811
2025-06-18 20:40:44,FAKE,2846198233,238,2846198471,2847802296
2025-06-18 20:40:46,REAL,2846198471,487,2846198958,2847802783
2025-06-18 20:40:48,REAL,2846198958,488,2846199446,2847803271
2025-06-18 20:40:50,REAL,2846199446,483,2846199929,2847803754
2025-06-18 20:40:52,FAKE,2846199929,243,2846200172,2847804244
2025-06-18 20:40:54,REAL,2846200172,480,2846200652,2847804724
2025-06-18 20:40:56,REAL,2846200652,5053,2846205705,2847809777
2025-06-18 20:40:58,REAL,2846205705,10909,2846216614,2847820686
2025-06-18 20:41:00,REAL,2846216614,10258,2846226872,2847830944
2025-06-18 20:41:02,REAL,2846226872,10319,2846237191,2847841263
2025-06-18 20:41:04,FAKE,2846237191,238,2846237429,2847851518
2025-06-18 20:41:06,REAL,2846237429,10253,2846247682,2847861771
2025-06-18 20:41:08,REAL,2846247682,10302,2846257984,2847872073
2025-06-18 20:41:10,FAKE,2846257984,238,2846258222,2847882399
2025-06-18 20:41:12,FAKE,2846258222,241,2846258463,2847883948
2025-06-18 20:41:14,REAL,2846258463,488,2846258951,2847884436
2025-06-18 20:41:16,REAL,2846258951,487,2846259438,2847884923
2025-06-18 20:41:18,REAL,2846259438,486,2846259924,2847885409
2025-06-18 20:41:20,REAL,2846259924,480,2846260404,2847885889
2025-06-18 20:41:22,REAL,2846260404,487,2846260891,2847886376
2025-06-18 20:41:24,REAL,2846260891,485,2846261376,2847886861
2025-06-18 20:41:26,REAL,2846261376,484,2846261860,2847887345
2025-06-18 20:41:28,REAL,2846261860,483,2846262343,2847887828
2025-06-18 20:41:30,FAKE,2846262343,238,2846262581,2847888312
2025-06-18 20:41:32,FAKE,2846262581,238,2846262819,2847888794
2025-06-18 20:41:34,FAKE,2846262819,243,2846263062,2847889283
2025-06-18 20:41:36,FAKE,2846263062,243,2846263305,2847889770
2025-06-18 20:41:38,REAL,2846263305,490,2846263795,2847890260
2025-06-18 20:41:40,REAL,2846263795,486,2846264281,2847890746
2025-06-18 20:41:42,REAL,2846264281,491,2846264772,2847891237
2025-06-18 20:41:44,REAL,2846264772,484,2846265256,2847891721
2025-06-18 20:41:46,FAKE,2846265256,243,2846265499,2847892258
2025-06-18 20:41:48,REAL,2846265499,539,2846266038,2847892797
2025-06-18 20:41:50,REAL,2846266038,481,2846266519,2847893278
2025-06-18 20:41:52,REAL,2846266519,482,2846267001,2847893760
2025-06-18 20:41:54,REAL,2846267001,484,2846267485,2847894244
2025-06-18 20:41:56,REAL,2846267485,477,2846267962,2847894721
2025-06-18 20:41:58,REAL,2846267962,493,2846268455,2847895214
2025-06-18 20:42:00,REAL,2846268455,6699,2846275154,2847901913
2025-06-18 20:42:02,REAL,2846275154,11249,2846286403,2847913162
2025-06-18 20:42:04,REAL,2846286403,10323,2846296726,2847923485
2025-06-18 20:42:06,REAL,2846296726,10251,2846306977,2847933736
2025-06-18 20:42:08,REAL,2846306977,10256,2846317233,2847943992
2025-06-18 20:42:10,REAL,2846317233,10245,2846327478,2847954237
2025-06-18 20:42:12,REAL,2846327478,10311,2846337789,2847964548
2025-06-18 20:42:14,REAL,2846337789,10050,2846347839,2847974598
2025-06-18 20:42:16,REAL,2846347839,487,2846348326,2847975085
2025-06-18 20:42:18,FAKE,2846348326,238,2846348564,2847975560
2025-06-18 20:42:20,FAKE,2846348564,243,2846348807,2847976047
2025-06-18 20:42:22,REAL,2846348807,489,2846349296,2847976536
2025-06-18 20:42:24,REAL,2846349296,487,2846349783,2847977023
2025-06-18 20:42:26,REAL,2846349783,478,2846350261,2847977501
2025-06-18 20:42:28,REAL,2846350261,533,2846350794,2847978034
2025-06-18 20:42:30,REAL,2846350794,485,2846351279,2847978519
2025-06-18 20:42:32,FAKE,2846351279,241,2846351520,2847979000
2025-06-18 20:42:34,FAKE,2846351520,244,2846351764,2847979490
2025-06-18 20:42:36,REAL,2846351764,486,2846352250,2847979976
2025-06-18 20:42:38,REAL,2846352250,489,2846352739,2847980465
2025-06-18 20:42:40,FAKE,2846352739,243,2846352982,2847980954
2025-06-18 20:42:42,FAKE,2846352982,244,2846353226,2847981428
2025-06-18 20:42:44,FAKE,2846353226,244,2846353470,2847981904
2025-06-18 20:42:46,REAL,2846353470,488,2846353958,2847982392
2025-06-18 20:42:48,REAL,2846353958,494,2846354452,2847982886
2025-06-18 20:42:50,REAL,2846354452,535,2846354987,2847983421
2025-06-18 20:42:52,FAKE,2846354987,241,2846355228,2847983907
2025-06-18 20:42:54,FAKE,2846355228,243,2846355471,2847984391
2025-06-18 20:42:56,REAL,2846355471,483,2846355954,2847984874
2025-06-18 20:42:58,REAL,2846355954,485,2846356439,2847985359
2025-06-18 20:43:00,REAL,2846356439,490,2846356929,2847985849
2025-06-18 20:43:02,FAKE,2846356929,238,2846357167,2847986329
2025-06-18 20:43:04,REAL,2846357167,485,2846357652,2847986814
2025-06-18 20:43:06,REAL,2846357652,489,2846358141,2847987303
2025-06-18 20:43:08,FAKE,2846358141,241,2846358382,2847987784
2025-06-18 20:43:10,FAKE,2846358382,244,2846358626,2847988270
2025-06-18 20:43:12,REAL,2846358626,488,2846359114,2847988758
2025-06-18 20:43:14,FAKE,2846359114,238,2846359352,2847989236
2025-06-18 20:43:16,REAL,2846359352,536,2846359888,2847989772
2025-06-18 20:43:18,REAL,2846359888,486,2846360374,2847990258
2025-06-18 20:43:20,REAL,2846360374,482,2846360856,2847990740
2025-06-18 20:43:22,FAKE,2846360856,243,2846361099,2847991222
2025-06-18 20:43:24,REAL,2846361099,480,2846361579,2847991702
2025-06-18 20:43:26,REAL,2846361579,490,2846362069,2847992192
2025-06-18 20:43:28,FAKE,2846362069,244,2846362313,2847992667
2025-06-18 20:43:30,REAL,2846362313,483,2846362796,2847993150
2025-06-18 20:43:32,REAL,2846362796,481,2846363277,2847993631
2025-06-18 20:43:34,REAL,2846363277,479,2846363756,2847994110
2025-06-18 20:43:36,REAL,2846363756,492,2846364248,2847994602
2025-06-18 20:43:38,REAL,2846364248,482,2846364730,2847995084
2025-06-18 20:43:40,REAL,2846364730,486,2846365216,2847995570
2025-06-18 20:43:42,REAL,2846365216,539,2846365755,2847996109
2025-06-18 20:43:44,REAL,2846365755,485,2846366240,2847996594
2025-06-18 20:43:46,FAKE,2846366240,238,2846366478,2847997080
2025-06-18 20:43:48,REAL,2846366478,479,2846366957,2847997559
2025-06-18 20:43:50,REAL,2846366957,475,2846367432,2847998034
2025-06-18 20:43:52,REAL,2846367432,479,2846367911,2847998513
2025-06-18 20:43:54,REAL,2846367911,492,2846368403,2847999005
2025-06-18 20:43:56,REAL,2846368403,487,2846368890,2847999492
2025-06-18 20:43:58,REAL,2846368890,490,2846369380,2847999982
2025-06-18 20:44:00,REAL,2846369380,479,2846369859,2848000461
2025-06-18 20:44:02,FAKE,2846369859,241,2846370100,2848000937
2025-06-18 20:44:04,REAL,2846370100,482,2846370582,2848001419
2025-06-18 20:44:06,REAL,2846370582,477,2846371059,2848001896
2025-06-18 20:44:08,REAL,2846371059,532,2846371591,2848002428
2025-06-18 20:44:10,REAL,2846371591,482,2846372073,2848002910
2025-06-18 20:44:12,REAL,2846372073,485,2846372558,2848003395
2025-06-18 20:44:14,REAL,2846372558,492,2846373050,2848003887
2025-06-18 20:44:16,REAL,2846373050,487,2846373537,2848004374
2025-06-18 20:44:18,FAKE,2846373537,241,2846373778,2848004858
2025-06-18 20:44:20,REAL,2846373778,491,2846374269,2848005349
2025-06-18 20:44:22,REAL,2846374269,480,2846374749,2848005829
2025-06-18 20:44:24,REAL,2846374749,493,2846375242,2848006322
2025-06-18 20:44:26,REAL,2846375242,484,2846375726,2848006806
2025-06-18 20:44:28,FAKE,2846375726,241,2846375967,2848007286
2025-06-18 20:44:30,REAL,2846375967,483,2846376450,2848007769
2025-06-18 20:44:32,REAL,2846376450,484,2846376934,2848008253
2025-06-18 20:44:34,FAKE,2846376934,244,2846377178,2848008801
2025-06-18 20:44:36,REAL,2846377178,479,2846377657,2848009280
2025-06-18 20:44:38,REAL,2846377657,483,2846378140,2848009763
2025-06-18 20:44:40,REAL,2846378140,492,2846378632,2848010255
2025-06-18 20:44:42,REAL,2846378632,475,2846379107,2848010730
2025-06-18 20:44:44,FAKE,2846379107,238,2846379345,2848011220
2025-06-18 20:44:46,REAL,2846379345,487,2846379832,2848011707
2025-06-18 20:44:48,REAL,2846379832,488,2846380320,2848012195
2025-06-18 20:44:50,REAL,2846380320,491,2846380811,2848012686
2025-06-18 20:44:52,REAL,2846380811,480,2846381291,2848013166
2025-06-18 20:44:54,FAKE,2846381291,244,2846381535,2848013652
2025-06-18 20:44:56,REAL,2846381535,485,2846382020,2848014137
2025-06-18 20:44:58,REAL,2846382020,543,2846382563,2848014680
2025-06-18 20:45:00,REAL,2846382563,488,2846383051,2848015168
2025-06-18 20:45:02,REAL,2846383051,486,2846383537,2848015654
2025-06-18 20:45:04,REAL,2846383537,485,2846384022,2848016139
2025-06-18 20:45:06,REAL,2846384022,488,2846384510,2848016627
2025-06-18 20:45:08,REAL,2846384510,478,2846384988,2848017105
2025-06-18 20:45:10,REAL,2846384988,483,2846385471,2848017588
2025-06-18 20:45:12,REAL,2846385471,477,2846385948,2848018065
2025-06-18 20:45:14,REAL,2846385948,484,2846386432,2848018549
2025-06-18 20:45:16,REAL,2846386432,5243,2846391675,2848023792
2025-06-18 20:45:18,FAKE,2846391675,244,2846391919,2848035167
2025-06-18 20:45:20,FAKE,2846391919,241,2846392160,2848045420
2025-06-18 20:45:22,FAKE,2846392160,244,2846392404,2848055676
2025-06-18 20:45:24,REAL,2846392404,10244,2846402648,2848065920
2025-06-18 20:45:26,REAL,2846402648,10323,2846412971,2848076243
2025-06-18 20:45:28,REAL,2846412971,10254,2846423225,2848086497
2025-06-18 20:45:30,REAL,2846423225,10323,2846433548,2848096820
2025-06-18 20:45:32,FAKE,2846433548,243,2846433791,2848098228
2025-06-18 20:45:34,FAKE,2846433791,241,2846434032,2848098706
2025-06-18 20:45:36,FAKE,2846434032,244,2846434276,2848099198
2025-06-18 20:45:38,REAL,2846434276,479,2846434755,2848099677
2025-06-18 20:45:40,FAKE,2846434755,238,2846434993,2848100159
2025-06-18 20:45:42,FAKE,2846434993,241,2846435234,2848100398
2025-06-18 20:45:44,REAL,2846435234,482,2846435716,2848100880
2025-06-18 20:45:46,FAKE,2846435716,241,2846435957,2848101366
2025-06-18 20:45:48,REAL,2846435957,5701,2846441658,2848107067
2025-06-18 20:45:50,FAKE,2846441658,241,2846441899,2848118492
2025-06-18 20:45:52,REAL,2846441899,10262,2846452161,2848128754
2025-06-18 20:45:54,REAL,2846452161,10318,2846462479,2848139072
2025-06-18 20:45:56,FAKE,2846462479,241,2846462720,2848149326
2025-06-18 20:45:58,FAKE,2846462720,243,2846462963,2848159646
2025-06-18 20:46:00,REAL,2846462963,10248,2846473211,2848169894
2025-06-18 20:46:02,REAL,2846473211,10318,2846483529,2848180212
2025-06-18 20:46:04,REAL,2846483529,808,2846484337,2848181020
2025-06-18 20:46:06,REAL,2846484337,486,2846484823,2848181506
2025-06-18 20:46:08,REAL,2846484823,478,2846485301,2848181984
2025-06-18 20:46:10,REAL,2846485301,490,2846485791,2848182474
2025-06-18 20:46:12,REAL,2846485791,481,2846486272,2848182955
2025-06-18 20:46:14,FAKE,2846486272,241,2846486513,2848183443
2025-06-18 20:46:16,REAL,2846486513,478,2846486991,2848183921
2025-06-18 20:46:18,FAKE,2846486991,244,2846487235,2848184401
2025-06-18 20:46:20,REAL,2846487235,537,2846487772,2848184938
2025-06-18 20:46:22,REAL,2846487772,481,2846488253,2848185419
2025-06-18 20:46:24,FAKE,2846488253,241,2846488494,2848185909
2025-06-18 20:46:26,REAL,2846488494,722,2846489216,2848186631
2025-06-18 20:46:28,REAL,2846489216,247,2846489463,2848186878
2025-06-18 20:46:30,REAL,2846489463,492,2846489955,2848187370
2025-06-18 20:46:32,REAL,2846489955,483,2846490438,2848187853
2025-06-18 20:46:34,FAKE,2846490438,243,2846490681,2848188343
2025-06-18 20:46:36,REAL,2846490681,482,2846491163,2848188825
2025-06-18 20:46:38,REAL,2846491163,489,2846491652,2848189314
2025-06-18 20:46:40,REAL,2846491652,1075,2846492727,2848190389
2025-06-18 20:46:42,REAL,2846492727,11572,2846504299,2848201961
2025-06-18 20:46:44,REAL,2846504299,10324,2846514623,2848212285
2025-06-18 20:46:46,REAL,2846514623,10253,2846524876,2848222538
2025-06-18 20:46:48,REAL,2846524876,10251,2846535127,2848232789
2025-06-18 20:46:50,FAKE,2846535127,241,2846535368,2848243039
2025-06-18 20:46:52,REAL,2846535368,10317,2846545685,2848253356
2025-06-18 20:46:54,REAL,2846545685,10249,2846555934,2848263605
2025-06-18 20:46:56,FAKE,2846555934,238,2846556172,2848268307
2025-06-18 20:46:58,REAL,2846556172,476,2846556648,2848268783
2025-06-18 20:47:00,FAKE,2846556648,238,2846556886,2848269263
2025-06-18 20:47:02,FAKE,2846556886,241,2846557127,2848269749
2025-06-18 20:47:04,REAL,2846557127,479,2846557606,2848270228
2025-06-18 20:47:06,REAL,2846557606,483,2846558089,2848270711
2025-06-18 20:47:08,REAL,2846558089,486,2846558575,2848271197
2025-06-18 20:47:10,FAKE,2846558575,244,2846558819,2848271677
2025-06-18 20:47:12,FAKE,2846558819,241,2846559060,2848272213
2025-06-18 20:47:14,FAKE,2846559060,244,2846559304,2848272695
2025-06-18 20:47:16,REAL,2846559304,480,2846559784,2848273175
2025-06-18 20:47:18,REAL,2846559784,484,2846560268,2848273659
2025-06-18 20:47:20,FAKE,2846560268,244,2846560512,2848274145
2025-06-18 20:47:22,FAKE,2846560512,238,2846560750,2848274627
2025-06-18 20:47:24,REAL,2846560750,493,2846561243,2848275120
2025-06-18 20:47:26,REAL,2846561243,490,2846561733,2848275610
2025-06-18 20:47:28,REAL,2846561733,485,2846562218,2848276095
2025-06-18 20:47:30,FAKE,2846562218,244,2846562462,2848276585
2025-06-18 20:47:32,REAL,2846562462,547,2846563009,2848277132
2025-06-18 20:47:34,FAKE,2846563009,238,2846563247,2848277610
2025-06-18 20:47:36,REAL,2846563247,484,2846563731,2848278094
2025-06-18 20:47:38,FAKE,2846563731,243,2846563974,2848278570
2025-06-18 20:47:40,FAKE,2846563974,244,2846564218,2848279057
2025-06-18 20:47:42,FAKE,2846564218,238,2846564456,2848279541
2025-06-18 20:47:44,REAL,2846564456,2655,2846567111,2848282196
2025-06-18 20:47:46,REAL,2846567111,11508,2846578619,2848293704
2025-06-18 20:47:48,REAL,2846578619,10252,2846588871,2848303956
2025-06-18 20:47:50,REAL,2846588871,10250,2846599121,2848314206
2025-06-18 20:47:52,REAL,2846599121,10245,2846609366,2848324451
2025-06-18 20:47:54,REAL,2846609366,10252,2846619618,2848334703
2025-06-18 20:47:56,REAL,2846619618,10246,2846629864,2848344949
2025-06-18 20:47:58,FAKE,2846629864,244,2846630108,2848355268
2025-06-18 20:48:00,REAL,2846630108,3451,2846633559,2848358719
2025-06-18 20:48:02,REAL,2846633559,488,2846634047,2848359207
2025-06-18 20:48:04,REAL,2846634047,492,2846634539,2848359699
2025-06-18 20:48:06,FAKE,2846634539,241,2846634780,2848360182
2025-06-18 20:48:08,FAKE,2846634780,243,2846635023,2848360670
2025-06-18 20:48:10,REAL,2846635023,476,2846635499,2848361146
2025-06-18 20:48:12,FAKE,2846635499,243,2846635742,2848361621
2025-06-18 20:48:14,REAL,2846635742,480,2846636222,2848362101
2025-06-18 20:48:16,REAL,2846636222,3383,2846639605,2848365484
2025-06-18 20:48:18,FAKE,2846639605,244,2846639849,2848380211
2025-06-18 20:48:20,REAL,2846639849,10318,2846650167,2848390529
2025-06-18 20:48:22,REAL,2846650167,10259,2846660426,2848400788
2025-06-18 20:48:24,REAL,2846660426,10248,2846670674,2848411036
2025-06-18 20:48:26,FAKE,2846670674,241,2846670915,2848421351
2025-06-18 20:48:28,REAL,2846670915,10251,2846681166,2848431602
2025-06-18 20:48:30,REAL,2846681166,10316,2846691482,2848441918
2025-06-18 20:48:32,REAL,2846691482,2853,2846694335,2848444771
2025-06-18 20:48:34,REAL,2846694335,479,2846694814,2848445250
2025-06-18 20:48:36,REAL,2846694814,482,2846695296,2848445732
2025-06-18 20:48:38,FAKE,2846695296,244,2846695540,2848446217
2025-06-18 20:48:40,FAKE,2846695540,238,2846695778,2848446699
2025-06-18 20:48:42,REAL,2846695778,483,2846696261,2848447182
2025-06-18 20:48:44,REAL,2846696261,487,2846696748,2848447669
2025-06-18 20:48:46,REAL,2846696748,482,2846697230,2848448151
2025-06-18 20:48:48,REAL,2846697230,539,2846697769,2848448690
2025-06-18 20:48:50,FAKE,2846697769,238,2846698007,2848449168
2025-06-18 20:48:52,REAL,2846698007,475,2846698482,2848449643
2025-06-18 20:48:54,REAL,2846698482,490,2846698972,2848450133
2025-06-18 20:48:56,REAL,2846698972,485,2846699457,2848450618
2025-06-18 20:48:58,FAKE,2846699457,244,2846699701,2848451102
2025-06-18 20:49:00,REAL,2846699701,486,2846700187,2848451588
2025-06-18 20:49:02,FAKE,2846700187,243,2846700430,2848452081
2025-06-18 20:49:04,FAKE,2846700430,243,2846700673,2848452566
2025-06-18 20:49:06,REAL,2846700673,542,2846701215,2848453108
2025-06-18 20:49:08,FAKE,2846701215,244,2846701459,2848453584
2025-06-18 20:49:10,FAKE,2846701459,244,2846701703,2848454070
2025-06-18 20:49:12,REAL,2846701703,478,2846702181,2848454548
2025-06-18 20:49:14,REAL,2846702181,474,2846702655,2848455022
2025-06-18 20:49:16,REAL,2846702655,478,2846703133,2848455500
2025-06-18 20:49:18,FAKE,2846703133,243,2846703376,2848455986
2025-06-18 20:49:20,REAL,2846703376,4837,2846708213,2848460823
2025-06-18 20:49:22,REAL,2846708213,11440,2846719653,2848472263
2025-06-18 20:49:24,REAL,2846719653,10254,2846729907,2848482517
2025-06-18 20:49:26,FAKE,2846729907,244,2846730151,2848492834
2025-06-18 20:49:28,REAL,2846730151,10254,2846740405,2848503088
2025-06-18 20:49:30,REAL,2846740405,10249,2846750654,2848513337
2025-06-18 20:49:32,REAL,2846750654,10318,2846760972,2848523655
2025-06-18 20:49:34,FAKE,2846760972,238,2846761210,2848533908
2025-06-18 20:49:36,REAL,2846761210,1533,2846762743,2848535441
2025-06-18 20:49:38,REAL,2846762743,482,2846763225,2848535923
2025-06-18 20:49:40,FAKE,2846763225,243,2846763468,2848536416
2025-06-18 20:49:42,REAL,2846763468,480,2846763948,2848536896
2025-06-18 20:49:44,REAL,2846763948,490,2846764438,2848537386
2025-06-18 20:49:46,FAKE,2846764438,241,2846764679,2848537875
2025-06-18 20:49:48,REAL,2846764679,484,2846765163,2848538359
2025-06-18 20:49:50,REAL,2846765163,541,2846765704,2848538900
2025-06-18 20:49:52,REAL,2846765704,536,2846766240,2848539436
2025-06-18 20:49:54,REAL,2846766240,482,2846766722,2848539918
2025-06-18 20:49:56,REAL,2846766722,477,2846767199,2848540395
2025-06-18 20:49:58,FAKE,2846767199,244,2846767443,2848540875
2025-06-18 20:50:00,REAL,2846767443,486,2846767929,2848541361
2025-06-18 20:50:02,FAKE,2846767929,238,2846768167,2848541849
2025-06-18 20:50:04,REAL,2846768167,485,2846768652,2848542334
2025-06-18 20:50:06,REAL,2846768652,490,2846769142,2848542824
2025-06-18 20:50:08,FAKE,2846769142,244,2846769386,2848543304
2025-06-18 20:50:10,FAKE,2846769386,241,2846769627,2848543789
2025-06-18 20:50:12,FAKE,2846769627,243,2846769870,2848544273
2025-06-18 20:50:14,REAL,2846769870,492,2846770362,2848544765
2025-06-18 20:50:16,REAL,2846770362,484,2846770846,2848545249
2025-06-18 20:50:18,REAL,2846770846,492,2846771338,2848545741
2025-06-18 20:50:20,REAL,2846771338,483,2846771821,2848546224
2025-06-18 20:50:22,REAL,2846771821,487,2846772308,2848546711
2025-06-18 20:50:24,REAL,2846772308,485,2846772793,2848547196
2025-06-18 20:50:26,REAL,2846772793,483,2846773276,2848547679
2025-06-18 20:50:28,REAL,2846773276,538,2846773814,2848548217
2025-06-18 20:50:30,REAL,2846773814,14625,2846788439,2848562842
2025-06-18 20:50:32,REAL,2846788439,10321,2846798760,2848573163
2025-06-18 20:50:34,REAL,2846798760,10257,2846809017,2848583420
2025-06-18 20:50:36,FAKE,2846809017,241,2846809258,2848593670
2025-06-18 20:50:38,REAL,2846809258,10322,2846819580,2848603992
2025-06-18 20:50:40,FAKE,2846819580,241,2846819821,2848614309
2025-06-18 20:50:42,REAL,2846819821,10257,2846830078,2848624566
2025-06-18 20:50:44,REAL,2846830078,5173,2846835251,2848629739
2025-06-18 20:50:46,REAL,2846835251,485,2846835736,2848630224
2025-06-18 20:50:48,REAL,2846835736,484,2846836220,2848630708
2025-06-18 20:50:50,FAKE,2846836220,244,2846836464,2848639185
2025-06-18 20:50:52,FAKE,2846836464,238,2846836702,2848651888
2025-06-18 20:50:54,REAL,2846836702,10242,2846846944,2848662130
2025-06-18 20:50:56,REAL,2846846944,10256,2846857200,2848672386
2025-06-18 20:50:58,REAL,2846857200,10253,2846867453,2848682639
2025-06-18 20:51:00,REAL,2846867453,10250,2846877703,2848692889
2025-06-18 20:51:02,REAL,2846877703,10247,2846887950,2848703136
2025-06-18 20:51:04,REAL,2846887950,9724,2846897674,2848712860
2025-06-18 20:51:06,REAL,2846897674,490,2846898164,2848713350
2025-06-18 20:51:08,REAL,2846898164,492,2846898656,2848713842
2025-06-18 20:51:10,REAL,2846898656,484,2846899140,2848714326
2025-06-18 20:51:12,REAL,2846899140,477,2846899617,2848714803
2025-06-18 20:51:14,REAL,2846899617,480,2846900097,2848715283
2025-06-18 20:51:16,REAL,2846900097,482,2846900579,2848715765
2025-06-18 20:51:18,REAL,2846900579,492,2846901071,2848716257
2025-06-18 20:51:20,FAKE,2846901071,243,2846901314,2848716748
2025-06-18 20:51:22,REAL,2846901314,9265,2846910579,2848726013
2025-06-18 20:51:24,REAL,2846910579,12690,2846923269,2848738703
2025-06-18 20:51:26,REAL,2846923269,10302,2846933571,2848749005
2025-06-18 20:51:28,FAKE,2846933571,243,2846933814,2848760115
2025-06-18 20:51:30,REAL,2846933814,9468,2846943282,2848769583
2025-06-18 20:51:32,FAKE,2846943282,244,2846943526,2848779829
2025-06-18 20:51:34,FAKE,2846943526,241,2846943767,2848790080
2025-06-18 20:51:36,REAL,2846943767,9065,2846952832,2848799145
2025-06-18 20:51:38,REAL,2846952832,486,2846953318,2848799631
2025-06-18 20:51:40,FAKE,2846953318,243,2846953561,2848800110
2025-06-18 20:51:42,REAL,2846953561,481,2846954042,2848800591
2025-06-18 20:51:44,REAL,2846954042,484,2846954526,2848801075
2025-06-18 20:51:46,REAL,2846954526,479,2846955005,2848801554
2025-06-18 20:51:48,FAKE,2846955005,243,2846955248,2848802038
2025-06-18 20:51:50,FAKE,2846955248,244,2846955492,2848802527
2025-06-18 20:51:52,REAL,2846955492,478,2846955970,2848803005
2025-06-18 20:51:54,FAKE,2846955970,238,2846956208,2848811497
2025-06-18 20:51:56,REAL,2846956208,10642,2846966850,2848822139
2025-06-18 20:51:58,REAL,2846966850,10368,2846977218,2848832507
2025-06-18 20:52:00,REAL,2846977218,10257,2846987475,2848842764
2025-06-18 20:52:02,REAL,2846987475,10250,2846997725,2848853014
2025-06-18 20:52:04,REAL,2846997725,10252,2847007977,2848863266
2025-06-18 20:52:06,REAL,2847007977,10252,2847018229,2848873518
2025-06-18 20:52:08,FAKE,2847018229,241,2847018470,2848881990
2025-06-18 20:52:10,REAL,2847018470,481,2847018951,2848882471
2025-06-18 20:52:12,REAL,2847018951,491,2847019442,2848882962
2025-06-18 20:52:14,REAL,2847019442,541,2847019983,2848883503
2025-06-18 20:52:16,REAL,2847019983,485,2847020468,2848883988
2025-06-18 20:52:18,REAL,2847020468,480,2847020948,2848884468
2025-06-18 20:52:20,FAKE,2847020948,244,2847021192,2848884944
2025-06-18 20:52:22,REAL,2847021192,478,2847021670,2848885422
2025-06-18 20:52:24,FAKE,2847021670,241,2847021911,2848885909
2025-06-18 20:52:26,REAL,2847021911,9338,2847031249,2848895247
2025-06-18 20:52:28,FAKE,2847031249,238,2847031487,2848906097
2025-06-18 20:52:30,REAL,2847031487,10248,2847041735,2848916345
2025-06-18 20:52:32,FAKE,2847041735,244,2847041979,2848926660
2025-06-18 20:52:34,REAL,2847041979,10253,2847052232,2848936913
2025-06-18 20:52:36,REAL,2847052232,10325,2847062557,2848947238
2025-06-18 20:52:38,REAL,2847062557,10251,2847072808,2848957489
2025-06-18 20:52:40,REAL,2847072808,7880,2847080688,2848965369
2025-06-18 20:52:42,REAL,2847080688,484,2847081172,2848965853
2025-06-18 20:52:44,REAL,2847081172,484,2847081656,2848966337
2025-06-18 20:52:46,FAKE,2847081656,243,2847081899,2848966815
2025-06-18 20:52:48,FAKE,2847081899,243,2847082142,2848967299
2025-06-18 20:52:50,REAL,2847082142,484,2847082626,2848967783
2025-06-18 20:52:52,REAL,2847082626,477,2847083103,2848968260
2025-06-18 20:52:54,FAKE,2847083103,238,2847083341,2848968738
2025-06-18 20:52:56,REAL,2847083341,485,2847083826,2848969223
2025-06-18 20:52:58,FAKE,2847083826,238,2847084064,2848969710
2025-06-18 20:53:00,FAKE,2847084064,238,2847084302,2848970196
2025-06-18 20:53:02,REAL,2847084302,594,2847084896,2848970790
2025-06-18 20:53:04,FAKE,2847084896,244,2847085140,2848971270
2025-06-18 20:53:06,FAKE,2847085140,244,2847085384,2848971746
2025-06-18 20:53:08,REAL,2847085384,488,2847085872,2848972234
2025-06-18 20:53:10,REAL,2847085872,480,2847086352,2848972714
2025-06-18 20:53:12,REAL,2847086352,485,2847086837,2848973199
2025-06-18 20:53:14,REAL,2847086837,485,2847087322,2848973684
2025-06-18 20:53:16,REAL,2847087322,488,2847087810,2848974172
2025-06-18 20:53:18,REAL,2847087810,476,2847088286,2848974648
2025-06-18 20:53:20,REAL,2847088286,489,2847088775,2848975137
2025-06-18 20:53:22,REAL,2847088775,487,2847089262,2848975624
2025-06-18 20:53:24,REAL,2847089262,478,2847089740,2848976102
2025-06-18 20:53:26,REAL,2847089740,480,2847090220,2848976582
2025-06-18 20:53:28,REAL,2847090220,481,2847090701,2848977063
2025-06-18 20:53:30,FAKE,2847090701,241,2847090942,2848977546
2025-06-18 20:53:32,FAKE,2847090942,243,2847091185,2848978031
2025-06-18 20:53:34,REAL,2847091185,490,2847091675,2848978521
2025-06-18 20:53:36,REAL,2847091675,483,2847092158,2848979004
2025-06-18 20:53:38,FAKE,2847092158,238,2847092396,2848979491
2025-06-18 20:53:40,REAL,2847092396,537,2847092933,2848980028
2025-06-18 20:53:42,REAL,2847092933,492,2847093425,2848980520
2025-06-18 20:53:44,FAKE,2847093425,243,2847093668,2848980998
2025-06-18 20:53:46,FAKE,2847093668,244,2847093912,2848981488
2025-06-18 20:53:48,FAKE,2847093912,243,2847094155,2848981965
2025-06-18 20:53:50,REAL,2847094155,484,2847094639,2848982449
2025-06-18 20:53:52,REAL,2847094639,536,2847095175,2848982985
2025-06-18 20:53:54,FAKE,2847095175,238,2847095413,2848983472
2025-06-18 20:53:56,REAL,2847095413,482,2847095895,2848983954
2025-06-18 20:53:58,REAL,2847095895,482,2847096377,2848984436
2025-06-18 20:54:00,REAL,2847096377,474,2847096851,2848984910
2025-06-18 20:54:02,FAKE,2847096851,241,2847097092,2848985401
2025-06-18 20:54:04,REAL,2847097092,487,2847097579,2848985888
2025-06-18 20:54:06,REAL,2847097579,477,2847098056,2848986365
2025-06-18 20:54:08,REAL,2847098056,493,2847098549,2848986858
2025-06-18 20:54:10,FAKE,2847098549,238,2847098787,2848987339
2025-06-18 20:54:12,REAL,2847098787,480,2847099267,2848987819
2025-06-18 20:54:14,REAL,2847099267,487,2847099754,2848988306
2025-06-18 20:54:16,FAKE,2847099754,241,2847099995,2848988793
2025-06-18 20:54:18,REAL,2847099995,543,2847100538,2848989336
2025-06-18 20:54:20,FAKE,2847100538,238,2847100776,2848989812
2025-06-18 20:54:22,REAL,2847100776,484,2847101260,2848990296
2025-06-18 20:54:24,REAL,2847101260,482,2847101742,2848990778
2025-06-18 20:54:26,FAKE,2847101742,241,2847101983,2848991268
2025-06-18 20:54:28,REAL,2847101983,483,2847102466,2848991751
2025-06-18 20:54:30,FAKE,2847102466,238,2847102704,2848992232
2025-06-18 20:54:32,REAL,2847102704,479,2847103183,2848992711
2025-06-18 20:54:34,REAL,2847103183,480,2847103663,2848993191
2025-06-18 20:54:36,FAKE,2847103663,241,2847103904,2848993682
2025-06-18 20:54:38,FAKE,2847103904,243,2847104147,2848994158
2025-06-18 20:54:40,REAL,2847104147,487,2847104634,2848994645
2025-06-18 20:54:42,FAKE,2847104634,241,2847104875,2848995125
2025-06-18 20:54:44,REAL,2847104875,543,2847105418,2848995668
2025-06-18 20:54:46,REAL,2847105418,484,2847105902,2848996152
2025-06-18 20:54:48,REAL,2847105902,486,2847106388,2848996638
2025-06-18 20:54:50,REAL,2847106388,487,2847106875,2848997125
2025-06-18 20:54:52,FAKE,2847106875,238,2847107113,2848997616
2025-06-18 20:54:54,REAL,2847107113,480,2847107593,2848998096
2025-06-18 20:54:56,FAKE,2847107593,243,2847107836,2848998584
2025-06-18 20:54:58,FAKE,2847107836,241,2847108077,2848999268
2025-06-18 20:55:00,FAKE,2847108077,238,2847108315,2849014868
2025-06-18 20:55:02,REAL,2847108315,10253,2847118568,2849025121
2025-06-18 20:55:04,REAL,2847118568,10246,2847128814,2849035367
2025-06-18 20:55:06,REAL,2847128814,10318,2847139132,2849045685
2025-06-18 20:55:08,REAL,2847139132,10253,2847149385,2849055938
2025-06-18 20:55:10,FAKE,2847149385,244,2847149629,2849066195
2025-06-18 20:55:12,REAL,2847149629,10253,2847159882,2849076448
2025-06-18 20:55:14,REAL,2847159882,4968,2847164850,2849081416
2025-06-18 20:55:16,FAKE,2847164850,243,2847165093,2849081906
2025-06-18 20:55:18,FAKE,2847165093,238,2847165331,2849082396
2025-06-18 20:55:20,FAKE,2847165331,241,2847165572,2849082884
2025-06-18 20:55:22,REAL,2847165572,485,2847166057,2849083369
2025-06-18 20:55:24,REAL,2847166057,494,2847166551,2849083863
2025-06-18 20:55:26,REAL,2847166551,484,2847167035,2849084347
2025-06-18 20:55:28,FAKE,2847167035,243,2847167278,2849084836
2025-06-18 20:55:30,REAL,2847167278,481,2847167759,2849085317
2025-06-18 20:55:32,REAL,2847167759,487,2847168246,2849085804
2025-06-18 20:55:34,REAL,2847168246,541,2847168787,2849086345
2025-06-18 20:55:36,FAKE,2847168787,241,2847169028,2849086886
2025-06-18 20:55:38,REAL,2847169028,485,2847169513,2849087371
2025-06-18 20:55:40,REAL,2847169513,1549,2847171062,2849088920
2025-06-18 20:55:42,REAL,2847171062,11834,2847182896,2849100754
2025-06-18 20:55:44,REAL,2847182896,10256,2847193152,2849111010
2025-06-18 20:55:46,REAL,2847193152,10245,2847203397,2849121255
2025-06-18 20:55:48,REAL,2847203397,10318,2847213715,2849131573
2025-06-18 20:55:50,FAKE,2847213715,243,2847213958,2849141828
2025-06-18 20:55:52,REAL,2847213958,10257,2847224215,2849152085
2025-06-18 20:55:54,REAL,2847224215,10254,2847234469,2849162339
2025-06-18 20:55:56,FAKE,2847234469,243,2847234712,2849166785
2025-06-18 20:55:58,REAL,2847234712,483,2847235195,2849167268
2025-06-18 20:56:00,REAL,2847235195,482,2847235677,2849167750
2025-06-18 20:56:02,REAL,2847235677,532,2847236209,2849168282
2025-06-18 20:56:04,FAKE,2847236209,243,2847236452,2849168763
2025-06-18 20:56:06,REAL,2847236452,478,2847236930,2849169241
2025-06-18 20:56:08,FAKE,2847236930,244,2847237174,2849169723
2025-06-18 20:56:10,REAL,2847237174,487,2847237661,2849170210
2025-06-18 20:56:12,FAKE,2847237661,238,2847237899,2849172413
2025-06-18 20:56:14,REAL,2847237899,14870,2847252769,2849187283
2025-06-18 20:56:16,REAL,2847252769,10321,2847263090,2849197604
2025-06-18 20:56:18,REAL,2847263090,10252,2847273342,2849207856
2025-06-18 20:56:20,REAL,2847273342,10315,2847283657,2849218171
2025-06-18 20:56:22,REAL,2847283657,10245,2847293902,2849228416
2025-06-18 20:56:24,REAL,2847293902,10251,2847304153,2849238667
2025-06-18 20:56:26,REAL,2847304153,10376,2847314529,2849249043
2025-06-18 20:56:28,FAKE,2847314529,238,2847314767,2849252834
2025-06-18 20:56:30,REAL,2847314767,483,2847315250,2849253317
2025-06-18 20:56:32,FAKE,2847315250,243,2847315493,2849253794
2025-06-18 20:56:34,FAKE,2847315493,243,2847315736,2849254326
2025-06-18 20:56:36,REAL,2847315736,478,2847316214,2849254804
2025-06-18 20:56:38,FAKE,2847316214,243,2847316457,2849255283
2025-06-18 20:56:40,FAKE,2847316457,244,2847316701,2849255765
2025-06-18 20:56:42,REAL,2847316701,478,2847317179,2849256243
2025-06-18 20:56:44,REAL,2847317179,2930,2847320109,2849259173
2025-06-18 20:56:46,REAL,2847320109,11042,2847331151,2849270215
2025-06-18 20:56:48,REAL,2847331151,10246,2847341397,2849280461
2025-06-18 20:56:50,FAKE,2847341397,241,2847341638,2849290710
2025-06-18 20:56:52,REAL,2847341638,10250,2847351888,2849300960
2025-06-18 20:56:54,REAL,2847351888,10251,2847362139,2849311211
2025-06-18 20:56:56,FAKE,2847362139,243,2847362382,2849321527
2025-06-18 20:56:58,FAKE,2847362382,238,2847362620,2849331785
2025-06-18 20:57:00,FAKE,2847362620,238,2847362858,2849334917
2025-06-18 20:57:02,REAL,2847362858,482,2847363340,2849335399
2025-06-18 20:57:04,REAL,2847363340,478,2847363818,2849335877
2025-06-18 20:57:06,REAL,2847363818,544,2847364362,2849336421
2025-06-18 20:57:08,REAL,2847364362,484,2847364846,2849336905
2025-06-18 20:57:10,REAL,2847364846,484,2847365330,2849337389
2025-06-18 20:57:12,REAL,2847365330,478,2847365808,2849337867
2025-06-18 20:57:14,REAL,2847365808,482,2847366290,2849338349
2025-06-18 20:57:16,FAKE,2847366290,243,2847366533,2849342527
2025-06-18 20:57:18,REAL,2847366533,11378,2847377911,2849353905
2025-06-18 20:57:20,FAKE,2847377911,241,2847378152,2849364151
2025-06-18 20:57:22,REAL,2847378152,10325,2847388477,2849374476
2025-06-18 20:57:24,REAL,2847388477,10319,2847398796,2849384795
2025-06-18 20:57:26,REAL,2847398796,10250,2847409046,2849395045
2025-06-18 20:57:28,REAL,2847409046,10252,2847419298,2849405297
2025-06-18 20:57:30,REAL,2847419298,10251,2847429549,2849415548
2025-06-18 20:57:32,FAKE,2847429549,241,2847429790,2849418079
2025-06-18 20:57:34,FAKE,2847429790,241,2847430031,2849418561
2025-06-18 20:57:36,REAL,2847430031,490,2847430521,2849419051
2025-06-18 20:57:38,FAKE,2847430521,241,2847430762,2849419583
2025-06-18 20:57:40,REAL,2847430762,486,2847431248,2849420069
2025-06-18 20:57:42,REAL,2847431248,486,2847431734,2849420555
2025-06-18 20:57:44,FAKE,2847431734,243,2847431977,2849421044
2025-06-18 20:57:46,REAL,2847431977,475,2847432452,2849421519
2025-06-18 20:57:48,REAL,2847432452,4584,2847437036,2849426103
2025-06-18 20:57:50,FAKE,2847437036,243,2847437279,2849437477
2025-06-18 20:57:52,REAL,2847437279,10253,2847447532,2849447730
2025-06-18 20:57:54,REAL,2847447532,10248,2847457780,2849457978
2025-06-18 20:57:56,FAKE,2847457780,241,2847458021,2849468295
2025-06-18 20:57:58,REAL,2847458021,10253,2847468274,2849478548
2025-06-18 20:58:00,REAL,2847468274,10256,2847478530,2849488804
2025-06-18 20:58:02,FAKE,2847478530,241,2847478771,2849499128
2025-06-18 20:58:04,FAKE,2847478771,244,2847479015,2849500998
2025-06-18 20:58:06,FAKE,2847479015,241,2847479256,2849501541
2025-06-18 20:58:08,REAL,2847479256,482,2847479738,2849502023
2025-06-18 20:58:10,FAKE,2847479738,243,2847479981,2849502558
2025-06-18 20:58:12,REAL,2847479981,486,2847480467,2849503044
2025-06-18 20:58:14,REAL,2847480467,487,2847480954,2849503531
2025-06-18 20:58:16,REAL,2847480954,482,2847481436,2849504013
2025-06-18 20:58:18,FAKE,2847481436,241,2847481677,2849504497
2025-06-18 20:58:20,REAL,2847481677,478,2847482155,2849504975
2025-06-18 20:58:22,REAL,2847482155,480,2847482635,2849505455
2025-06-18 20:58:24,REAL,2847482635,479,2847483114,2849505934
2025-06-18 20:58:26,REAL,2847483114,475,2847483589,2849506409
2025-06-18 20:58:28,REAL,2847483589,477,2847484066,2849506886
2025-06-18 20:58:30,REAL,2847484066,488,2847484554,2849507374
2025-06-18 20:58:32,REAL,2847484554,479,2847485033,2849507853
2025-06-18 20:58:34,REAL,2847485033,538,2847485571,2849508391
2025-06-18 20:58:36,FAKE,2847485571,243,2847485814,2849508875
2025-06-18 20:58:38,FAKE,2847485814,238,2847486052,2849509357
2025-06-18 20:58:40,FAKE,2847486052,243,2847486295,2849509835
2025-06-18 20:58:42,REAL,2847486295,486,2847486781,2849510321
2025-06-18 20:58:44,FAKE,2847486781,238,2847487019,2849510803
2025-06-18 20:58:46,REAL,2847487019,479,2847487498,2849511282
2025-06-18 20:58:48,REAL,2847487498,483,2847487981,2849511765
2025-06-18 20:58:50,REAL,2847487981,484,2847488465,2849512249
2025-06-18 20:58:52,REAL,2847488465,6420,2847494885,2849518669
2025-06-18 20:58:54,REAL,2847494885,11245,2847506130,2849529914
2025-06-18 20:58:56,FAKE,2847506130,244,2847506374,2849540163
2025-06-18 20:58:58,FAKE,2847506374,243,2847506617,2849550476
2025-06-18 20:59:00,REAL,2847506617,10254,2847516871,2849560730
2025-06-18 20:59:02,REAL,2847516871,10250,2847527121,2849570980
2025-06-18 20:59:04,FAKE,2847527121,241,2847527362,2849581235
2025-06-18 20:59:06,FAKE,2847527362,238,2847527600,2849591489
2025-06-18 20:59:08,FAKE,2847527600,244,2847527844,2849592177
2025-06-18 20:59:10,FAKE,2847527844,243,2847528087,2849592663
2025-06-18 20:59:12,FAKE,2847528087,241,2847528328,2849593146
2025-06-18 20:59:14,REAL,2847528328,548,2847528876,2849593694
2025-06-18 20:59:16,REAL,2847528876,484,2847529360,2849594178
2025-06-18 20:59:18,REAL,2847529360,483,2847529843,2849594661
2025-06-18 20:59:20,FAKE,2847529843,238,2847530081,2849595147
2025-06-18 20:59:22,FAKE,2847530081,243,2847530324,2849595637
2025-06-18 20:59:24,REAL,2847530324,8075,2847538399,2849603712
2025-06-18 20:59:26,REAL,2847538399,10843,2847549242,2849614555
2025-06-18 20:59:28,REAL,2847549242,10251,2847559493,2849624806
2025-06-18 20:59:30,FAKE,2847559493,238,2847559731,2849635064
2025-06-18 20:59:32,REAL,2847559731,10246,2847569977,2849645310
2025-06-18 20:59:34,REAL,2847569977,10309,2847580286,2849655619
2025-06-18 20:59:36,REAL,2847580286,10251,2847590537,2849665870
2025-06-18 20:59:38,REAL,2847590537,9784,2847600321,2849675654
2025-06-18 20:59:40,REAL,2847600321,543,2847600864,2849676197
2025-06-18 20:59:42,FAKE,2847600864,243,2847601107,2849676685
2025-06-18 20:59:44,REAL,2847601107,485,2847601592,2849677170
2025-06-18 20:59:46,REAL,2847601592,537,2847602129,2849677707
2025-06-18 20:59:48,REAL,2847602129,480,2847602609,2849678187
2025-06-18 20:59:50,FAKE,2847602609,241,2847602850,2849678662
2025-06-18 20:59:52,REAL,2847602850,485,2847603335,2849679147
2025-06-18 20:59:54,REAL,2847603335,478,2847603813,2849679625
2025-06-18 20:59:56,FAKE,2847603813,243,2847604056,2849688375
2025-06-18 20:59:58,REAL,2847604056,12562,2847616618,2849700937
2025-06-18 21:00:00,REAL,2847616618,10313,2847626931,2849711250
2025-06-18 21:00:02,FAKE,2847626931,244,2847627175,2849721507
2025-06-18 21:00:04,REAL,2847627175,10257,2847637432,2849731764
2025-06-18 21:00:06,FAKE,2847637432,244,2847637676,2849742078
2025-06-18 21:00:08,REAL,2847637676,10248,2847647924,2849752326
2025-06-18 21:00:10,REAL,2847647924,9197,2847657121,2849761523
2025-06-18 21:00:12,FAKE,2847657121,243,2847657364,2849762003
2025-06-18 21:00:14,REAL,2847657364,487,2847657851,2849762490
2025-06-18 21:00:16,REAL,2847657851,481,2847658332,2849762971
2025-06-18 21:00:18,REAL,2847658332,539,2847658871,2849763510
2025-06-18 21:00:20,REAL,2847658871,481,2847659352,2849763991
2025-06-18 21:00:22,REAL,2847659352,488,2847659840,2849764479
2025-06-18 21:00:24,REAL,2847659840,483,2847660323,2849764962
2025-06-18 21:00:26,REAL,2847660323,480,2847660803,2849765442
2025-06-18 21:00:28,REAL,2847660803,537,2847661340,2849765979
2025-06-18 21:00:30,REAL,2847661340,487,2847661827,2849766466
2025-06-18 21:00:32,REAL,2847661827,483,2847662310,2849766949
2025-06-18 21:00:34,REAL,2847662310,489,2847662799,2849767438
2025-06-18 21:00:36,REAL,2847662799,487,2847663286,2849767925
2025-06-18 21:00:38,REAL,2847663286,479,2847663765,2849768404
2025-06-18 21:00:40,REAL,2847663765,490,2847664255,2849768894
2025-06-18 21:00:42,REAL,2847664255,480,2847664735,2849769374
2025-06-18 21:00:44,REAL,2847664735,490,2847665225,2849769864
2025-06-18 21:00:46,FAKE,2847665225,241,2847665466,2849770346
2025-06-18 21:00:48,REAL,2847665466,483,2847665949,2849770829
2025-06-18 21:00:50,REAL,2847665949,483,2847666432,2849771312
2025-06-18 21:00:52,REAL,2847666432,484,2847666916,2849771796
2025-06-18 21:00:54,REAL,2847666916,478,2847667394,2849772274
2025-06-18 21:00:56,REAL,2847667394,484,2847667878,2849772758
2025-06-18 21:00:58,FAKE,2847667878,241,2847668119,2849773245
2025-06-18 21:01:00,FAKE,2847668119,238,2847668357,2849773720
2025-06-18 21:01:02,REAL,2847668357,492,2847668849,2849774212
2025-06-18 21:01:04,REAL,2847668849,484,2847669333,2849774696
2025-06-18 21:01:06,REAL,2847669333,483,2847669816,2849775179
2025-06-18 21:01:08,REAL,2847669816,483,2847670299,2849775662
2025-06-18 21:01:10,REAL,2847670299,542,2847670841,2849776204
2025-06-18 21:01:12,REAL,2847670841,476,2847671317,2849776680
2025-06-18 21:01:14,REAL,2847671317,489,2847671806,2849777169
2025-06-18 21:01:16,REAL,2847671806,9262,2847681068,2849786431
2025-06-18 21:01:18,REAL,2847681068,10513,2847691581,2849796944
2025-06-18 21:01:20,FAKE,2847691581,238,2847691819,2849807198
2025-06-18 21:01:22,FAKE,2847691819,243,2847692062,2849817507
2025-06-18 21:01:24,FAKE,2847692062,241,2847692303,2849827756
2025-06-18 21:01:26,FAKE,2847692303,238,2847692541,2849838006
2025-06-18 21:01:28,FAKE,2847692541,238,2847692779,2849848260
2025-06-18 21:01:30,REAL,2847692779,7603,2847700382,2849855863
2025-06-18 21:01:32,REAL,2847700382,481,2847700863,2849856344
2025-06-18 21:01:34,REAL,2847700863,488,2847701351,2849856832
2025-06-18 21:01:36,REAL,2847701351,484,2847701835,2849857316
2025-06-18 21:01:38,REAL,2847701835,483,2847702318,2849857799
2025-06-18 21:01:40,FAKE,2847702318,241,2847702559,2849858287
2025-06-18 21:01:42,REAL,2847702559,489,2847703048,2849858776
2025-06-18 21:01:44,FAKE,2847703048,244,2847703292,2849859255
2025-06-18 21:01:46,FAKE,2847703292,241,2847703533,2849859748
2025-06-18 21:01:48,REAL,2847703533,10519,2847714052,2849870267
2025-06-18 21:01:50,REAL,2847714052,10518,2847724570,2849880785
2025-06-18 21:01:52,REAL,2847724570,10255,2847734825,2849891040
2025-06-18 21:01:54,REAL,2847734825,10315,2847745140,2849901355
2025-06-18 21:01:56,REAL,2847745140,10251,2847755391,2849911606
2025-06-18 21:01:58,REAL,2847755391,10245,2847765636,2849921851
2025-06-18 21:02:00,FAKE,2847765636,244,2847765880,2849932097
2025-06-18 21:02:02,REAL,2847765880,7077,2847772957,2849939174
2025-06-18 21:02:04,REAL,2847772957,489,2847773446,2849939663
2025-06-18 21:02:06,REAL,2847773446,484,2847773930,2849940147
2025-06-18 21:02:08,REAL,2847773930,481,2847774411,2849940628
2025-06-18 21:02:10,REAL,2847774411,487,2847774898,2849941115
2025-06-18 21:02:12,REAL,2847774898,474,2847775372,2849941589
2025-06-18 21:02:14,FAKE,2847775372,243,2847775615,2849942069
2025-06-18 21:02:16,REAL,2847775615,481,2847776096,2849942550
2025-06-18 21:02:18,REAL,2847776096,488,2847776584,2849943038
2025-06-18 21:02:20,REAL,2847776584,11645,2847788229,2849954683
2025-06-18 21:02:22,REAL,2847788229,10384,2847798613,2849965067
2025-06-18 21:02:24,REAL,2847798613,10255,2847808868,2849975322
2025-06-18 21:02:26,REAL,2847808868,10005,2847818873,2849985327
2025-06-18 21:02:28,REAL,2847818873,10314,2847829187,2849995641
2025-06-18 21:02:30,REAL,2847829187,10255,2847839442,2850005896
2025-06-18 21:02:32,REAL,2847839442,10252,2847849694,2850016148
2025-06-18 21:02:34,REAL,2847849694,6363,2847856057,2850022511
2025-06-18 21:02:36,REAL,2847856057,482,2847856539,2850022993
2025-06-18 21:02:38,FAKE,2847856539,243,2847856782,2850023475
2025-06-18 21:02:40,FAKE,2847856782,241,2847857023,2850023957
2025-06-18 21:02:42,FAKE,2847857023,238,2847857261,2850024437
2025-06-18 21:02:44,FAKE,2847857261,243,2847857504,2850024915
2025-06-18 21:02:46,FAKE,2847857504,244,2847857748,2850025401
2025-06-18 21:02:48,FAKE,2847857748,238,2847857986,2850025881
2025-06-18 21:02:50,REAL,2847857986,547,2847858533,2850026428
2025-06-18 21:02:52,FAKE,2847858533,244,2847858777,2850040523
2025-06-18 21:02:54,FAKE,2847858777,243,2847859020,2850050844
2025-06-18 21:02:56,REAL,2847859020,10259,2847869279,2850061103
2025-06-18 21:02:58,REAL,2847869279,10247,2847879526,2850071350
2025-06-18 21:03:00,REAL,2847879526,10308,2847889834,2850081658
2025-06-18 21:03:02,REAL,2847889834,10252,2847900086,2850091910
2025-06-18 21:03:04,FAKE,2847900086,241,2847900327,2850102159
2025-06-18 21:03:06,FAKE,2847900327,243,2847900570,2850107917
2025-06-18 21:03:08,FAKE,2847900570,243,2847900813,2850108392
2025-06-18 21:03:10,REAL,2847900813,485,2847901298,2850108877
2025-06-18 21:03:12,REAL,2847901298,486,2847901784,2850109363
2025-06-18 21:03:14,REAL,2847901784,478,2847902262,2850109841
2025-06-18 21:03:16,FAKE,2847902262,244,2847902506,2850110327
2025-06-18 21:03:18,REAL,2847902506,484,2847902990,2850110811
2025-06-18 21:03:20,FAKE,2847902990,241,2847903231,2850111293
2025-06-18 21:03:22,FAKE,2847903231,243,2847903474,2850111769
2025-06-18 21:03:24,REAL,2847903474,15076,2847918550,2850126845
2025-06-18 21:03:26,FAKE,2847918550,241,2847918791,2850137090
2025-06-18 21:03:28,REAL,2847918791,10318,2847929109,2850147408
2025-06-18 21:03:30,REAL,2847929109,10251,2847939360,2850157659
2025-06-18 21:03:32,REAL,2847939360,10313,2847949673,2850167972
2025-06-18 21:03:34,REAL,2847949673,10252,2847959925,2850178224
2025-06-18 21:03:36,REAL,2847959925,10255,2847970180,2850188479
2025-06-18 21:03:38,REAL,2847970180,5099,2847975279,2850193578
2025-06-18 21:03:40,REAL,2847975279,485,2847975764,2850194063
2025-06-18 21:03:42,FAKE,2847975764,238,2847976002,2850194539
2025-06-18 21:03:44,REAL,2847976002,482,2847976484,2850195021
2025-06-18 21:03:46,REAL,2847976484,488,2847976972,2850195509
2025-06-18 21:03:48,FAKE,2847976972,241,2847977213,2850195994
2025-06-18 21:03:50,FAKE,2847977213,241,2847977454,2850196482
2025-06-18 21:03:52,FAKE,2847977454,243,2847977697,2850196967
2025-06-18 21:03:54,REAL,2847977697,1549,2847979246,2850198516
2025-06-18 21:03:56,FAKE,2847979246,238,2847979484,2850212788
2025-06-18 21:03:58,REAL,2847979484,10246,2847989730,2850223034
2025-06-18 21:04:00,FAKE,2847989730,241,2847989971,2850233293
2025-06-18 21:04:02,REAL,2847989971,10314,2848000285,2850243607
2025-06-18 21:04:04,REAL,2848000285,10253,2848010538,2850253860
2025-06-18 21:04:06,REAL,2848010538,10245,2848020783,2850264105
2025-06-18 21:04:08,REAL,2848020783,10244,2848031027,2850274349
2025-06-18 21:04:10,REAL,2848031027,4501,2848035528,2850278850
2025-06-18 21:04:12,REAL,2848035528,485,2848036013,2850279335
2025-06-18 21:04:14,REAL,2848036013,476,2848036489,2850279811
2025-06-18 21:04:16,FAKE,2848036489,238,2848036727,2850280354
2025-06-18 21:04:18,FAKE,2848036727,243,2848036970,2850280840
2025-06-18 21:04:20,REAL,2848036970,483,2848037453,2850281323
2025-06-18 21:04:22,REAL,2848037453,480,2848037933,2850281803
2025-06-18 21:04:24,REAL,2848037933,483,2848038416,2850282286
2025-06-18 21:04:26,FAKE,2848038416,244,2848038660,2850284568
2025-06-18 21:04:28,REAL,2848038660,11324,2848049984,2850295892
2025-06-18 21:04:30,REAL,2848049984,10248,2848060232,2850306140
2025-06-18 21:04:32,FAKE,2848060232,243,2848060475,2850316463
2025-06-18 21:04:34,FAKE,2848060475,241,2848060716,2850326718
2025-06-18 21:04:36,REAL,2848060716,10318,2848071034,2850337036
2025-06-18 21:04:38,REAL,2848071034,10245,2848081279,2850347281
2025-06-18 21:04:40,REAL,2848081279,10254,2848091533,2850357535
2025-06-18 21:04:42,FAKE,2848091533,243,2848091776,2850361446
2025-06-18 21:04:44,REAL,2848091776,484,2848092260,2850361930
2025-06-18 21:04:46,FAKE,2848092260,244,2848092504,2850362424
2025-06-18 21:04:48,FAKE,2848092504,243,2848092747,2850362906
2025-06-18 21:04:50,FAKE,2848092747,241,2848092988,2850363393
2025-06-18 21:04:52,REAL,2848092988,475,2848093463,2850363868
2025-06-18 21:04:54,FAKE,2848093463,244,2848093707,2850364357
2025-06-18 21:04:56,FAKE,2848093707,238,2848093945,2850364840
2025-06-18 21:04:58,REAL,2848093945,2659,2848096604,2850367499
2025-06-18 21:05:00,REAL,2848096604,14481,2848111085,2850381980
2025-06-18 21:05:02,REAL,2848111085,10324,2848121409,2850392304
2025-06-18 21:05:04,REAL,2848121409,10249,2848131658,2850402553
2025-06-18 21:05:06,REAL,2848131658,10315,2848141973,2850412868
2025-06-18 21:05:08,FAKE,2848141973,238,2848142211,2850423184
2025-06-18 21:05:10,REAL,2848142211,10247,2848152458,2850433431
2025-06-18 21:05:12,REAL,2848152458,10311,2848162769,2850443742
2025-06-18 21:05:14,REAL,2848162769,3197,2848165966,2850446939
2025-06-18 21:05:16,FAKE,2848165966,238,2848166204,2850447421
2025-06-18 21:05:18,REAL,2848166204,479,2848166683,2850447900
2025-06-18 21:05:20,REAL,2848166683,482,2848167165,2850448382
2025-06-18 21:05:22,FAKE,2848167165,243,2848167408,2850448870
2025-06-18 21:05:24,FAKE,2848167408,241,2848167649,2850449346
2025-06-18 21:05:26,REAL,2848167649,479,2848168128,2850449825
2025-06-18 21:05:28,FAKE,2848168128,243,2848168371,2850450314
2025-06-18 21:05:30,REAL,2848168371,3526,2848171897,2850453840
2025-06-18 21:05:32,REAL,2848171897,11607,2848183504,2850465447
2025-06-18 21:05:34,REAL,2848183504,10326,2848193830,2850475773
2025-06-18 21:05:36,REAL,2848193830,10250,2848204080,2850486023
2025-06-18 21:05:38,FAKE,2848204080,243,2848204323,2850496274
2025-06-18 21:05:40,REAL,2848204323,10318,2848214641,2850506592
2025-06-18 21:05:42,REAL,2848214641,10308,2848224949,2850516900
2025-06-18 21:05:44,REAL,2848224949,10322,2848235271,2850527222
2025-06-18 21:05:46,REAL,2848235271,2599,2848237870,2850529821
2025-06-18 21:05:48,REAL,2848237870,482,2848238352,2850530303
2025-06-18 21:05:50,REAL,2848238352,482,2848238834,2850530785
2025-06-18 21:05:52,FAKE,2848238834,238,2848239072,2850531268
2025-06-18 21:05:54,REAL,2848239072,478,2848239550,2850531746
2025-06-18 21:05:56,REAL,2848239550,487,2848240037,2850532233
2025-06-18 21:05:58,REAL,2848240037,479,2848240516,2850532712
2025-06-18 21:06:00,FAKE,2848240516,238,2848240754,2850533194
2025-06-18 21:06:02,FAKE,2848240754,244,2848240998,2850538044
2025-06-18 21:06:04,FAKE,2848240998,241,2848241239,2850549081
2025-06-18 21:06:06,FAKE,2848241239,244,2848241483,2850559330
2025-06-18 21:06:08,REAL,2848241483,10243,2848251726,2850569573
2025-06-18 21:06:10,REAL,2848251726,10253,2848261979,2850579826
2025-06-18 21:06:12,REAL,2848261979,10248,2848272227,2850590074
2025-06-18 21:06:14,REAL,2848272227,10318,2848282545,2850600392
2025-06-18 21:06:16,FAKE,2848282545,241,2848282786,2850610643
2025-06-18 21:06:18,REAL,2848282786,1939,2848284725,2850612582
2025-06-18 21:06:20,REAL,2848284725,483,2848285208,2850613065
2025-06-18 21:06:22,REAL,2848285208,489,2848285697,2850613554
2025-06-18 21:06:24,REAL,2848285697,533,2848286230,2850614087
2025-06-18 21:06:26,REAL,2848286230,488,2848286718,2850614575
2025-06-18 21:06:28,REAL,2848286718,482,2848287200,2850615057
2025-06-18 21:06:30,REAL,2848287200,483,2848287683,2850615540
2025-06-18 21:06:32,REAL,2848287683,487,2848288170,2850616027
2025-06-18 21:06:34,REAL,2848288170,488,2848288658,2850616515
2025-06-18 21:06:36,REAL,2848288658,481,2848289139,2850616996
2025-06-18 21:06:38,REAL,2848289139,478,2848289617,2850617474
2025-06-18 21:06:40,REAL,2848289617,488,2848290105,2850617962
2025-06-18 21:06:42,REAL,2848290105,482,2848290587,2850618444
2025-06-18 21:06:44,REAL,2848290587,535,2848291122,2850618979
2025-06-18 21:06:46,REAL,2848291122,484,2848291606,2850619463
2025-06-18 21:06:48,REAL,2848291606,491,2848292097,2850619954
2025-06-18 21:06:50,REAL,2848292097,486,2848292583,2850620440
2025-06-18 21:06:52,FAKE,2848292583,244,2848292827,2850620924
2025-06-18 21:06:54,REAL,2848292827,482,2848293309,2850621406
2025-06-18 21:06:56,FAKE,2848293309,244,2848293553,2850621887
2025-06-18 21:06:58,REAL,2848293553,476,2848294029,2850622363
2025-06-18 21:07:00,REAL,2848294029,477,2848294506,2850622840
2025-06-18 21:07:02,FAKE,2848294506,238,2848294744,2850623331
2025-06-18 21:07:04,REAL,2848294744,483,2848295227,2850623814
2025-06-18 21:07:06,FAKE,2848295227,238,2848295465,2850630714
2025-06-18 21:07:08,FAKE,2848295465,243,2848295708,2850644346
2025-06-18 21:07:10,REAL,2848295708,10251,2848305959,2850654597
2025-06-18 21:07:12,FAKE,2848305959,241,2848306200,2850664854
2025-06-18 21:07:14,FAKE,2848306200,243,2848306443,2850675105
2025-06-18 21:07:16,FAKE,2848306443,238,2848306681,2850685358
2025-06-18 21:07:18,REAL,2848306681,10325,2848317006,2850695683
2025-06-18 21:07:20,FAKE,2848317006,243,2848317249,2850705931
2025-06-18 21:07:22,REAL,2848317249,690,2848317939,2850706621
2025-06-18 21:07:24,REAL,2848317939,478,2848318417,2850707099
2025-06-18 21:07:26,REAL,2848318417,490,2848318907,2850707589
2025-06-18 21:07:28,REAL,2848318907,487,2848319394,2850708076
2025-06-18 21:07:30,REAL,2848319394,490,2848319884,2850708566
2025-06-18 21:07:32,REAL,2848319884,483,2848320367,2850709049
2025-06-18 21:07:34,FAKE,2848320367,241,2848320608,2850709532
2025-06-18 21:07:36,REAL,2848320608,493,2848321101,2850710025
2025-06-18 21:07:38,REAL,2848321101,7551,2848328652,2850717576
2025-06-18 21:07:40,FAKE,2848328652,244,2848328896,2850730541
2025-06-18 21:07:42,REAL,2848328896,10253,2848339149,2850740794
2025-06-18 21:07:44,REAL,2848339149,10321,2848349470,2850751115
2025-06-18 21:07:46,FAKE,2848349470,238,2848349708,2850761370
2025-06-18 21:07:48,REAL,2848349708,10252,2848359960,2850771622
2025-06-18 21:07:50,REAL,2848359960,10302,2848370262,2850781924
2025-06-18 21:07:52,REAL,2848370262,9849,2848380111,2850791773
2025-06-18 21:07:54,REAL,2848380111,485,2848380596,2850792258
2025-06-18 21:07:56,REAL,2848380596,480,2848381076,2850792738
2025-06-18 21:07:58,REAL,2848381076,485,2848381561,2850793223
2025-06-18 21:08:00,FAKE,2848381561,241,2848381802,2850793712
2025-06-18 21:08:02,FAKE,2848381802,238,2848382040,2850794204
2025-06-18 21:08:04,REAL,2848382040,482,2848382522,2850794686
2025-06-18 21:08:06,REAL,2848382522,488,2848383010,2850795174
2025-06-18 21:08:08,FAKE,2848383010,243,2848383253,2850795659
2025-06-18 21:08:10,FAKE,2848383253,241,2848383494,2850802890
2025-06-18 21:08:12,REAL,2848383494,10911,2848394405,2850813801
2025-06-18 21:08:14,REAL,2848394405,10314,2848404719,2850824115
2025-06-18 21:08:16,REAL,2848404719,10249,2848414968,2850834364
2025-06-18 21:08:18,REAL,2848414968,10248,2848425216,2850844612
2025-06-18 21:08:20,REAL,2848425216,10317,2848435533,2850854929
2025-06-18 21:08:22,REAL,2848435533,10243,2848445776,2850865172
2025-06-18 21:08:24,REAL,2848445776,9259,2848455035,2850874431
2025-06-18 21:08:26,REAL,2848455035,493,2848455528,2850874924
2025-06-18 21:08:28,REAL,2848455528,480,2848456008,2850875404
2025-06-18 21:08:30,FAKE,2848456008,238,2848456246,2850875893
2025-06-18 21:08:32,REAL,2848456246,481,2848456727,2850876374
2025-06-18 21:08:34,REAL,2848456727,547,2848457274,2850876921
2025-06-18 21:08:36,REAL,2848457274,481,2848457755,2850877402
2025-06-18 21:08:38,FAKE,2848457755,243,2848457998,2850877881
2025-06-18 21:08:40,FAKE,2848457998,244,2848458242,2850878361
2025-06-18 21:08:42,REAL,2848458242,8279,2848466521,2850886640
2025-06-18 21:08:44,REAL,2848466521,10914,2848477435,2850897554
2025-06-18 21:08:46,REAL,2848477435,10255,2848487690,2850907809
2025-06-18 21:08:48,REAL,2848487690,10322,2848498012,2850918131
2025-06-18 21:08:50,REAL,2848498012,10257,2848508269,2850928388
2025-06-18 21:08:52,REAL,2848508269,10314,2848518583,2850938702
2025-06-18 21:08:54,FAKE,2848518583,238,2848518821,2850948956
2025-06-18 21:08:56,FAKE,2848518821,241,2848519062,2850957623
2025-06-18 21:08:58,REAL,2848519062,476,2848519538,2850958099
2025-06-18 21:09:00,FAKE,2848519538,241,2848519779,2850958584
2025-06-18 21:09:02,FAKE,2848519779,238,2848520017,2850959063
2025-06-18 21:09:04,REAL,2848520017,490,2848520507,2850959553
2025-06-18 21:09:06,REAL,2848520507,484,2848520991,2850960037
2025-06-18 21:09:08,REAL,2848520991,484,2848521475,2850960521
2025-06-18 21:09:10,REAL,2848521475,488,2848521963,2850961009
2025-06-18 21:09:12,REAL,2848521963,487,2848522450,2850961496
2025-06-18 21:09:14,FAKE,2848522450,244,2848522694,2850961982
2025-06-18 21:09:16,FAKE,2848522694,238,2848522932,2850962469
2025-06-18 21:09:18,FAKE,2848522932,244,2848523176,2850963005
2025-06-18 21:09:20,REAL,2848523176,485,2848523661,2850963490
2025-06-18 21:09:22,REAL,2848523661,480,2848524141,2850963970
2025-06-18 21:09:24,REAL,2848524141,541,2848524682,2850964511
2025-06-18 21:09:26,FAKE,2848524682,238,2848524920,2850964996
2025-06-18 21:09:28,REAL,2848524920,486,2848525406,2850965482
2025-06-18 21:09:30,REAL,2848525406,487,2848525893,2850965969
2025-06-18 21:09:32,REAL,2848525893,483,2848526376,2850966452
2025-06-18 21:09:34,REAL,2848526376,486,2848526862,2850966938
2025-06-18 21:09:36,REAL,2848526862,490,2848527352,2850967428
2025-06-18 21:09:38,FAKE,2848527352,244,2848527596,2850967913
2025-06-18 21:09:40,REAL,2848527596,483,2848528079,2850968396
2025-06-18 21:09:42,REAL,2848528079,481,2848528560,2850968877
2025-06-18 21:09:44,FAKE,2848528560,238,2848528798,2850969362
2025-06-18 21:09:46,REAL,2848528798,488,2848529286,2850969850
2025-06-18 21:09:48,FAKE,2848529286,244,2848529530,2850970333
2025-06-18 21:09:50,REAL,2848529530,475,2848530005,2850970808
2025-06-18 21:09:52,FAKE,2848530005,243,2848530248,2850971302
2025-06-18 21:09:54,REAL,2848530248,486,2848530734,2850971788
2025-06-18 21:09:56,REAL,2848530734,477,2848531211,2850972265
2025-06-18 21:09:58,REAL,2848531211,488,2848531699,2850972753
2025-06-18 21:10:00,FAKE,2848531699,243,2848531942,2850973290
2025-06-18 21:10:02,FAKE,2848531942,238,2848532180,2850973773
2025-06-18 21:10:04,REAL,2848532180,476,2848532656,2850974249
2025-06-18 21:10:06,FAKE,2848532656,238,2848532894,2850974788
2025-06-18 21:10:08,REAL,2848532894,490,2848533384,2850975278
2025-06-18 21:10:10,FAKE,2848533384,238,2848533622,2850975755
2025-06-18 21:10:12,REAL,2848533622,488,2848534110,2850976243
2025-06-18 21:10:14,REAL,2848534110,488,2848534598,2850976731
2025-06-18 21:10:16,FAKE,2848534598,238,2848534836,2850977211
2025-06-18 21:10:18,REAL,2848534836,486,2848535322,2850977697
2025-06-18 21:10:20,REAL,2848535322,490,2848535812,2850978187
2025-06-18 21:10:22,REAL,2848535812,487,2848536299,2850978674
2025-06-18 21:10:24,FAKE,2848536299,238,2848536537,2850979165
2025-06-18 21:10:26,REAL,2848536537,484,2848537021,2850979649
2025-06-18 21:10:28,FAKE,2848537021,244,2848537265,2850980132
2025-06-18 21:10:30,FAKE,2848537265,243,2848537508,2850980619
2025-06-18 21:10:32,FAKE,2848537508,244,2848537752,2850981102
2025-06-18 21:10:34,REAL,2848537752,484,2848538236,2850981586
2025-06-18 21:10:36,FAKE,2848538236,238,2848538474,2850982076
2025-06-18 21:10:38,REAL,2848538474,486,2848538960,2850982562
2025-06-18 21:10:40,FAKE,2848538960,244,2848539204,2850983045
2025-06-18 21:10:42,REAL,2848539204,476,2848539680,2850983521
2025-06-18 21:10:44,REAL,2848539680,537,2848540217,2850984058
2025-06-18 21:10:46,REAL,2848540217,483,2848540700,2850984541
2025-06-18 21:10:48,REAL,2848540700,478,2848541178,2850985019
2025-06-18 21:10:50,REAL,2848541178,535,2848541713,2850985554
2025-06-18 21:10:52,REAL,2848541713,490,2848542203,2850986044
2025-06-18 21:10:54,FAKE,2848542203,244,2848542447,2850986533
2025-06-18 21:10:56,REAL,2848542447,492,2848542939,2850987025
2025-06-18 21:10:58,REAL,2848542939,492,2848543431,2850987517
2025-06-18 21:11:00,REAL,2848543431,493,2848543924,2850988010
2025-06-18 21:11:02,FAKE,2848543924,243,2848544167,2850988485
2025-06-18 21:11:04,FAKE,2848544167,244,2848544411,2850988973
2025-06-18 21:11:06,REAL,2848544411,488,2848544899,2850989461
2025-06-18 21:11:08,REAL,2848544899,480,2848545379,2850989941
2025-06-18 21:11:10,REAL,2848545379,487,2848545866,2850990428
2025-06-18 21:11:12,REAL,2848545866,483,2848546349,2850990911
2025-06-18 21:11:14,REAL,2848546349,477,2848546826,2850991388
2025-06-18 21:11:16,REAL,2848546826,478,2848547304,2850991866
2025-06-18 21:11:18,FAKE,2848547304,243,2848547547,2850992346
2025-06-18 21:11:20,FAKE,2848547547,243,2848547790,2850992831
2025-06-18 21:11:22,REAL,2848547790,486,2848548276,2850993317
2025-06-18 21:11:24,REAL,2848548276,489,2848548765,2850993806
2025-06-18 21:11:26,REAL,2848548765,539,2848549304,2850994345
2025-06-18 21:11:28,FAKE,2848549304,238,2848549542,2850994826
2025-06-18 21:11:30,REAL,2848549542,481,2848550023,2850995307
2025-06-18 21:11:32,FAKE,2848550023,243,2848550266,2850995789
2025-06-18 21:11:34,REAL,2848550266,549,2848550815,2850996338
2025-06-18 21:11:36,REAL,2848550815,488,2848551303,2850996826
2025-06-18 21:11:38,REAL,2848551303,482,2848551785,2850997308
2025-06-18 21:11:40,REAL,2848551785,489,2848552274,2850997797
2025-06-18 21:11:42,REAL,2848552274,479,2848552753,2850998276
2025-06-18 21:11:44,FAKE,2848552753,244,2848552997,2850998755
2025-06-18 21:11:46,FAKE,2848552997,243,2848553240,2850999243
2025-06-18 21:11:48,REAL,2848553240,482,2848553722,2850999725
2025-06-18 21:11:50,REAL,2848553722,484,2848554206,2851000209
2025-06-18 21:11:52,REAL,2848554206,488,2848554694,2851000697
2025-06-18 21:11:54,REAL,2848554694,484,2848555178,2851001181
2025-06-18 21:11:56,REAL,2848555178,476,2848555654,2851001657
2025-06-18 21:11:58,REAL,2848555654,6762,2848562416,2851008419
2025-06-18 21:12:00,REAL,2848562416,11044,2848573460,2851019463
2025-06-18 21:12:02,REAL,2848573460,10315,2848583775,2851029778
2025-06-18 21:12:04,REAL,2848583775,10251,2848594026,2851040029
2025-06-18 21:12:06,REAL,2848594026,10315,2848604341,2851050344
2025-06-18 21:12:08,FAKE,2848604341,244,2848604585,2851060604
2025-06-18 21:12:10,REAL,2848604585,10367,2848614952,2851070971
2025-06-18 21:12:12,REAL,2848614952,9788,2848624740,2851080759
2025-06-18 21:12:14,REAL,2848624740,488,2848625228,2851081247
2025-06-18 21:12:16,REAL,2848625228,489,2848625717,2851081736
2025-06-18 21:12:18,REAL,2848625717,482,2848626199,2851082218
2025-06-18 21:12:20,REAL,2848626199,490,2848626689,2851082708
2025-06-18 21:12:22,FAKE,2848626689,244,2848626933,2851083187
2025-06-18 21:12:24,REAL,2848626933,485,2848627418,2851083672
2025-06-18 21:12:26,FAKE,2848627418,241,2848627659,2851084154
2025-06-18 21:12:28,REAL,2848627659,479,2848628138,2851084633
2025-06-18 21:12:30,REAL,2848628138,7623,2848635761,2851092256
2025-06-18 21:12:32,FAKE,2848635761,244,2848636005,2851103176
2025-06-18 21:12:34,FAKE,2848636005,238,2848636243,2851113437
2025-06-18 21:12:36,REAL,2848636243,10256,2848646499,2851123693
2025-06-18 21:12:38,REAL,2848646499,10318,2848656817,2851134011
2025-06-18 21:12:40,REAL,2848656817,10252,2848667069,2851144263
2025-06-18 21:12:42,REAL,2848667069,10250,2848677319,2851154513
2025-06-18 21:12:44,REAL,2848677319,9137,2848686456,2851163650
2025-06-18 21:12:46,REAL,2848686456,480,2848686936,2851164130
2025-06-18 21:12:48,FAKE,2848686936,244,2848687180,2851164617
2025-06-18 21:12:50,REAL,2848687180,488,2848687668,2851165105
2025-06-18 21:12:52,REAL,2848687668,477,2848688145,2851165582
2025-06-18 21:12:54,REAL,2848688145,482,2848688627,2851166064
2025-06-18 21:12:56,REAL,2848688627,484,2848689111,2851166548
2025-06-18 21:12:58,REAL,2848689111,536,2848689647,2851167084
2025-06-18 21:13:00,REAL,2848689647,484,2848690131,2851167568
2025-06-18 21:13:02,REAL,2848690131,489,2848690620,2851168057
2025-06-18 21:13:04,FAKE,2848690620,244,2848690864,2851168540
2025-06-18 21:13:06,REAL,2848690864,477,2848691341,2851169017
2025-06-18 21:13:08,REAL,2848691341,485,2848691826,2851169502
2025-06-18 21:13:10,FAKE,2848691826,238,2848692064,2851169994
2025-06-18 21:13:12,REAL,2848692064,536,2848692600,2851170530
2025-06-18 21:13:14,REAL,2848692600,475,2848693075,2851171005
2025-06-18 21:13:16,REAL,2848693075,485,2848693560,2851171490
2025-06-18 21:13:18,REAL,2848693560,485,2848694045,2851171975
2025-06-18 21:13:20,REAL,2848694045,494,2848694539,2851172469
2025-06-18 21:13:22,REAL,2848694539,485,2848695024,2851172954
2025-06-18 21:13:24,FAKE,2848695024,243,2848695267,2851173440
2025-06-18 21:13:26,REAL,2848695267,491,2848695758,2851173931
2025-06-18 21:13:28,FAKE,2848695758,243,2848696001,2851174422
2025-06-18 21:13:30,REAL,2848696001,485,2848696486,2851174907
2025-06-18 21:13:32,REAL,2848696486,486,2848696972,2851175393
2025-06-18 21:13:34,REAL,2848696972,483,2848697455,2851175876
2025-06-18 21:13:36,REAL,2848697455,483,2848697938,2851176359
2025-06-18 21:13:38,FAKE,2848697938,244,2848698182,2851176840
2025-06-18 21:13:40,FAKE,2848698182,238,2848698420,2851177323
2025-06-18 21:13:42,FAKE,2848698420,244,2848698664,2851177810
2025-06-18 21:13:44,FAKE,2848698664,238,2848698902,2851178299
2025-06-18 21:13:46,REAL,2848698902,537,2848699439,2851178836
2025-06-18 21:13:48,FAKE,2848699439,244,2848699683,2851179319
2025-06-18 21:13:50,REAL,2848699683,483,2848700166,2851179802
2025-06-18 21:13:52,REAL,2848700166,487,2848700653,2851180289
2025-06-18 21:13:54,REAL,2848700653,475,2848701128,2851180764
2025-06-18 21:13:56,FAKE,2848701128,241,2848701369,2851181253
2025-06-18 21:13:58,REAL,2848701369,545,2848701914,2851181798
2025-06-18 21:14:00,REAL,2848701914,477,2848702391,2851182275
2025-06-18 21:14:02,REAL,2848702391,487,2848702878,2851182762
2025-06-18 21:14:04,REAL,2848702878,491,2848703369,2851183253
2025-06-18 21:14:06,FAKE,2848703369,243,2848703612,2851183739
2025-06-18 21:14:08,REAL,2848703612,484,2848704096,2851184223
2025-06-18 21:14:10,REAL,2848704096,479,2848704575,2851184702
2025-06-18 21:14:12,REAL,2848704575,479,2848705054,2851185181
2025-06-18 21:14:14,REAL,2848705054,484,2848705538,2851185665
2025-06-18 21:14:16,FAKE,2848705538,238,2848705776,2851186144
2025-06-18 21:14:18,FAKE,2848705776,243,2848706019,2851186624
2025-06-18 21:14:20,REAL,2848706019,484,2848706503,2851187108
2025-06-18 21:14:22,REAL,2848706503,10209,2848716712,2851197317
2025-06-18 21:14:24,FAKE,2848716712,241,2848716953,2851207833
2025-06-18 21:14:26,REAL,2848716953,10252,2848727205,2851218085
2025-06-18 21:14:28,FAKE,2848727205,241,2848727446,2851228401
2025-06-18 21:14:30,FAKE,2848727446,243,2848727689,2851238652
2025-06-18 21:14:32,REAL,2848727689,10249,2848737938,2851248901
2025-06-18 21:14:34,REAL,2848737938,10319,2848748257,2851259220
2025-06-18 21:14:36,REAL,2848748257,6944,2848755201,2851266164
2025-06-18 21:14:38,REAL,2848755201,478,2848755679,2851266642
2025-06-18 21:14:40,REAL,2848755679,482,2848756161,2851267124
2025-06-18 21:14:42,REAL,2848756161,486,2848756647,2851267610
2025-06-18 21:14:44,FAKE,2848756647,241,2848756888,2851268095
2025-06-18 21:14:46,FAKE,2848756888,241,2848757129,2851268577
2025-06-18 21:14:48,FAKE,2848757129,238,2848757367,2851269071
2025-06-18 21:14:50,FAKE,2848757367,241,2848757608,2851269555
2025-06-18 21:14:52,FAKE,2848757608,238,2848757846,2851270046
2025-06-18 21:14:54,REAL,2848757846,15070,2848772916,2851285116
2025-06-18 21:14:56,REAL,2848772916,10381,2848783297,2851295497
2025-06-18 21:14:58,REAL,2848783297,10261,2848793558,2851305758
2025-06-18 21:15:00,FAKE,2848793558,243,2848793801,2851316011
2025-06-18 21:15:02,REAL,2848793801,10251,2848804052,2851326262
2025-06-18 21:15:04,FAKE,2848804052,238,2848804290,2851336518
2025-06-18 21:15:06,REAL,2848804290,10254,2848814544,2851346772
2025-06-18 21:15:08,REAL,2848814544,6357,2848820901,2851353129
2025-06-18 21:15:10,REAL,2848820901,486,2848821387,2851353615
2025-06-18 21:15:12,FAKE,2848821387,243,2848821630,2851354106
2025-06-18 21:15:14,FAKE,2848821630,241,2848821871,2851354588
2025-06-18 21:15:16,REAL,2848821871,489,2848822360,2851355077
2025-06-18 21:15:18,REAL,2848822360,482,2848822842,2851355559
2025-06-18 21:15:20,REAL,2848822842,478,2848823320,2851356037
2025-06-18 21:15:22,FAKE,2848823320,238,2848823558,2851356524
2025-06-18 21:15:24,REAL,2848823558,537,2848824095,2851357061
2025-06-18 21:15:26,FAKE,2848824095,241,2848824336,2851368840
2025-06-18 21:15:28,REAL,2848824336,10252,2848834588,2851379092
2025-06-18 21:15:30,REAL,2848834588,10309,2848844897,2851389401
2025-06-18 21:15:32,REAL,2848844897,10254,2848855151,2851399655
2025-06-18 21:15:34,REAL,2848855151,10253,2848865404,2851409908
2025-06-18 21:15:36,FAKE,2848865404,241,2848865645,2851420231
2025-06-18 21:15:38,FAKE,2848865645,238,2848865883,2851430486
2025-06-18 21:15:40,FAKE,2848865883,241,2848866124,2851436187
2025-06-18 21:15:42,REAL,2848866124,486,2848866610,2851436673
2025-06-18 21:15:44,FAKE,2848866610,241,2848866851,2851437151
2025-06-18 21:15:46,REAL,2848866851,492,2848867343,2851437643
2025-06-18 21:15:48,FAKE,2848867343,244,2848867587,2851438128
2025-06-18 21:15:50,REAL,2848867587,483,2848868070,2851438611
2025-06-18 21:15:52,REAL,2848868070,477,2848868547,2851439088
2025-06-18 21:15:54,REAL,2848868547,481,2848869028,2851439569
2025-06-18 21:15:56,REAL,2848869028,553,2848869581,2851440122
2025-06-18 21:15:58,REAL,2848869581,15010,2848884591,2851455132
2025-06-18 21:16:00,REAL,2848884591,10313,2848894904,2851465445
2025-06-18 21:16:02,REAL,2848894904,10319,2848905223,2851475764
2025-06-18 21:16:04,REAL,2848905223,10247,2848915470,2851486011
2025-06-18 21:16:06,REAL,2848915470,10252,2848925722,2851496263
2025-06-18 21:16:08,REAL,2848925722,10259,2848935981,2851506522
2025-06-18 21:16:10,REAL,2848935981,10317,2848946298,2851516839
2025-06-18 21:16:12,REAL,2848946298,5040,2848951338,2851521879
2025-06-18 21:16:14,FAKE,2848951338,241,2848951579,2851522428
2025-06-18 21:16:16,REAL,2848951579,488,2848952067,2851522916
2025-06-18 21:16:18,REAL,2848952067,485,2848952552,2851523401
2025-06-18 21:16:20,FAKE,2848952552,244,2848952796,2851523878
2025-06-18 21:16:22,REAL,2848952796,477,2848953273,2851524355
2025-06-18 21:16:24,FAKE,2848953273,238,2848953511,2851524833
2025-06-18 21:16:26,FAKE,2848953511,241,2848953752,2851525327
2025-06-18 21:16:28,FAKE,2848953752,241,2848953993,2851526746
2025-06-18 21:16:30,FAKE,2848953993,243,2848954236,2851541943
2025-06-18 21:16:32,REAL,2848954236,10252,2848964488,2851552195
2025-06-18 21:16:34,FAKE,2848964488,241,2848964729,2851562518
2025-06-18 21:16:36,REAL,2848964729,10247,2848974976,2851572765
2025-06-18 21:16:38,FAKE,2848974976,238,2848975214,2851583079
2025-06-18 21:16:40,FAKE,2848975214,244,2848975458,2851593330
2025-06-18 21:16:42,REAL,2848975458,10252,2848985710,2851603582
2025-06-18 21:16:44,FAKE,2848985710,244,2848985954,2851608027
2025-06-18 21:16:46,REAL,2848985954,483,2848986437,2851608510
2025-06-18 21:16:48,FAKE,2848986437,243,2848986680,2851608994
2025-06-18 21:16:50,REAL,2848986680,485,2848987165,2851609479
2025-06-18 21:16:52,REAL,2848987165,491,2848987656,2851609970
2025-06-18 21:16:54,REAL,2848987656,478,2848988134,2851610448
2025-06-18 21:16:56,REAL,2848988134,482,2848988616,2851610930
2025-06-18 21:16:58,REAL,2848988616,488,2848989104,2851611418
2025-06-18 21:17:00,REAL,2848989104,2473,2848991577,2851613891
2025-06-18 21:17:02,REAL,2848991577,12222,2849003799,2851626113
2025-06-18 21:17:04,REAL,2849003799,10322,2849014121,2851636435
2025-06-18 21:17:06,REAL,2849014121,10253,2849024374,2851646688
2025-06-18 21:17:08,REAL,2849024374,10242,2849034616,2851656930
2025-06-18 21:17:10,REAL,2849034616,10252,2849044868,2851667182
2025-06-18 21:17:12,REAL,2849044868,10245,2849055113,2851677427
2025-06-18 21:17:14,REAL,2849055113,10323,2849065436,2851687750
2025-06-18 21:17:16,REAL,2849065436,3789,2849069225,2851691539
2025-06-18 21:17:18,REAL,2849069225,485,2849069710,2851692024
2025-06-18 21:17:20,REAL,2849069710,494,2849070204,2851692518
2025-06-18 21:17:22,REAL,2849070204,488,2849070692,2851693006
2025-06-18 21:17:24,REAL,2849070692,482,2849071174,2851693488
2025-06-18 21:17:26,REAL,2849071174,490,2849071664,2851693978
2025-06-18 21:17:28,FAKE,2849071664,241,2849071905,2851694462
2025-06-18 21:17:30,REAL,2849071905,480,2849072385,2851694942
2025-06-18 21:17:32,FAKE,2849072385,243,2849072628,2851698078
2025-06-18 21:17:34,REAL,2849072628,11589,2849084217,2851709667
2025-06-18 21:17:36,REAL,2849084217,10253,2849094470,2851719920
2025-06-18 21:17:38,FAKE,2849094470,244,2849094714,2851730166
2025-06-18 21:17:40,REAL,2849094714,10254,2849104968,2851740420
2025-06-18 21:17:42,REAL,2849104968,10250,2849115218,2851750670
2025-06-18 21:17:44,FAKE,2849115218,241,2849115459,2851760923
2025-06-18 21:17:46,FAKE,2849115459,243,2849115702,2851771176
2025-06-18 21:17:48,REAL,2849115702,3122,2849118824,2851774298
2025-06-18 21:17:50,FAKE,2849118824,244,2849119068,2851774786
2025-06-18 21:17:52,REAL,2849119068,544,2849119612,2851775330
2025-06-18 21:17:54,FAKE,2849119612,241,2849119853,2851775817
2025-06-18 21:17:56,REAL,2849119853,480,2849120333,2851776297
2025-06-18 21:17:58,FAKE,2849120333,243,2849120576,2851776781
2025-06-18 21:18:00,REAL,2849120576,487,2849121063,2851777268
2025-06-18 21:18:02,REAL,2849121063,486,2849121549,2851777754
2025-06-18 21:18:04,REAL,2849121549,477,2849122026,2851778231
2025-06-18 21:18:06,REAL,2849122026,480,2849122506,2851778711
2025-06-18 21:18:08,REAL,2849122506,542,2849123048,2851779253
2025-06-18 21:18:10,FAKE,2849123048,238,2849123286,2851779740
2025-06-18 21:18:12,FAKE,2849123286,241,2849123527,2851780221
2025-06-18 21:18:14,REAL,2849123527,483,2849124010,2851780704
2025-06-18 21:18:16,REAL,2849124010,483,2849124493,2851781187
2025-06-18 21:18:18,REAL,2849124493,482,2849124975,2851781669
2025-06-18 21:18:20,REAL,2849124975,488,2849125463,2851782157
2025-06-18 21:18:22,FAKE,2849125463,244,2849125707,2851782635
2025-06-18 21:18:24,REAL,2849125707,493,2849126200,2851783128
2025-06-18 21:18:26,FAKE,2849126200,244,2849126444,2851783620
2025-06-18 21:18:28,REAL,2849126444,481,2849126925,2851784101
2025-06-18 21:18:30,REAL,2849126925,483,2849127408,2851784584
2025-06-18 21:18:32,REAL,2849127408,479,2849127887,2851785063
2025-06-18 21:18:34,REAL,2849127887,546,2849128433,2851785609
2025-06-18 21:18:36,REAL,2849128433,5450,2849133883,2851791059
2025-06-18 21:18:38,FAKE,2849133883,238,2849134121,2851804479
2025-06-18 21:18:40,FAKE,2849134121,244,2849134365,2851814407
2025-06-18 21:18:42,REAL,2849134365,10258,2849144623,2851824665
2025-06-18 21:18:44,REAL,2849144623,10247,2849154870,2851834912
2025-06-18 21:18:46,REAL,2849154870,10251,2849165121,2851845163
2025-06-18 21:18:48,FAKE,2849165121,241,2849165362,2851855416
2025-06-18 21:18:50,REAL,2849165362,10250,2849175612,2851865666
2025-06-18 21:18:52,REAL,2849175612,1942,2849177554,2851867608
2025-06-18 21:18:54,REAL,2849177554,482,2849178036,2851868090
2025-06-18 21:18:56,FAKE,2849178036,244,2849178280,2851868573
2025-06-18 21:18:58,REAL,2849178280,484,2849178764,2851869057
2025-06-18 21:19:00,REAL,2849178764,484,2849179248,2851869541
2025-06-18 21:19:02,REAL,2849179248,477,2849179725,2851870018
2025-06-18 21:19:04,REAL,2849179725,482,2849180207,2851870500
2025-06-18 21:19:06,FAKE,2849180207,244,2849180451,2851870981
2025-06-18 21:19:08,REAL,2849180451,5369,2849185820,2851876350
2025-06-18 21:19:10,REAL,2849185820,11038,2849196858,2851887388
2025-06-18 21:19:12,REAL,2849196858,10249,2849207107,2851897637
2025-06-18 21:19:14,FAKE,2849207107,243,2849207350,2851907940
2025-06-18 21:19:16,REAL,2849207350,10255,2849217605,2851918195
2025-06-18 21:19:18,FAKE,2849217605,238,2849217843,2851928521
2025-06-18 21:19:20,REAL,2849217843,10244,2849228087,2851938765
2025-06-18 21:19:22,FAKE,2849228087,241,2849228328,2851948775
2025-06-18 21:19:24,REAL,2849228328,1285,2849229613,2851950060
2025-06-18 21:19:26,FAKE,2849229613,244,2849229857,2851950543
2025-06-18 21:19:28,REAL,2849229857,485,2849230342,2851951028
2025-06-18 21:19:30,REAL,2849230342,480,2849230822,2851951508
2025-06-18 21:19:32,REAL,2849230822,486,2849231308,2851951994
2025-06-18 21:19:34,FAKE,2849231308,238,2849231546,2851952474
2025-06-18 21:19:36,FAKE,2849231546,238,2849231784,2851952956
2025-06-18 21:19:38,REAL,2849231784,490,2849232274,2851953446
2025-06-18 21:19:40,FAKE,2849232274,241,2849232515,2851959543
2025-06-18 21:19:42,REAL,2849232515,11116,2849243631,2851970659
2025-06-18 21:19:44,REAL,2849243631,10254,2849253885,2851980913
2025-06-18 21:19:46,REAL,2849253885,10253,2849264138,2851991166
2025-06-18 21:19:48,REAL,2849264138,10326,2849274464,2852001492
2025-06-18 21:19:50,REAL,2849274464,10249,2849284713,2852011741
2025-06-18 21:19:52,REAL,2849284713,10250,2849294963,2852021991
2025-06-18 21:19:54,REAL,2849294963,10313,2849305276,2852032304
2025-06-18 21:19:56,REAL,2849305276,678,2849305954,2852032982
2025-06-18 21:19:58,FAKE,2849305954,238,2849306192,2852033467
2025-06-18 21:20:00,REAL,2849306192,488,2849306680,2852033955
2025-06-18 21:20:02,FAKE,2849306680,243,2849306923,2852034432
2025-06-18 21:20:04,FAKE,2849306923,238,2849307161,2852034915
2025-06-18 21:20:06,FAKE,2849307161,243,2849307404,2852035393
2025-06-18 21:20:08,REAL,2849307404,480,2849307884,2852035873
2025-06-18 21:20:10,REAL,2849307884,483,2849308367,2852036356
2025-06-18 21:20:12,REAL,2849308367,6765,2849315132,2852043121
2025-06-18 21:20:14,FAKE,2849315132,244,2849315376,2852054231
2025-06-18 21:20:16,REAL,2849315376,10256,2849325632,2852064487
2025-06-18 21:20:18,REAL,2849325632,10313,2849335945,2852074800
2025-06-18 21:20:20,REAL,2849335945,10327,2849346272,2852085127
2025-06-18 21:20:22,FAKE,2849346272,244,2849346516,2852095371
2025-06-18 21:20:24,REAL,2849346516,10252,2849356768,2852105623
2025-06-18 21:20:26,FAKE,2849356768,243,2849357011,2852115418
2025-06-18 21:20:28,FAKE,2849357011,238,2849357249,2852115901
2025-06-18 21:20:30,REAL,2849357249,487,2849357736,2852116388
2025-06-18 21:20:32,FAKE,2849357736,241,2849357977,2852116875
2025-06-18 21:20:34,FAKE,2849357977,238,2849358215,2852117350
2025-06-18 21:20:36,REAL,2849358215,537,2849358752,2852117887
2025-06-18 21:20:38,REAL,2849358752,486,2849359238,2852118373
2025-06-18 21:20:40,REAL,2849359238,485,2849359723,2852118858
2025-06-18 21:20:42,REAL,2849359723,491,2849360214,2852119349
2025-06-18 21:20:44,REAL,2849360214,478,2849360692,2852119827
2025-06-18 21:20:46,FAKE,2849360692,241,2849360933,2852120309
2025-06-18 21:20:48,REAL,2849360933,490,2849361423,2852120799
2025-06-18 21:20:50,REAL,2849361423,479,2849361902,2852121278
2025-06-18 21:20:52,FAKE,2849361902,238,2849362140,2852121765
2025-06-18 21:20:54,REAL,2849362140,542,2849362682,2852122307
2025-06-18 21:20:56,FAKE,2849362682,243,2849362925,2852122786
2025-06-18 21:20:58,REAL,2849362925,488,2849363413,2852123274
2025-06-18 21:21:00,REAL,2849363413,479,2849363892,2852123753
2025-06-18 21:21:02,REAL,2849363892,482,2849364374,2852124235
2025-06-18 21:21:04,REAL,2849364374,487,2849364861,2852124722
2025-06-18 21:21:06,FAKE,2849364861,241,2849365102,2852125204
2025-06-18 21:21:08,REAL,2849365102,484,2849365586,2852125688
2025-06-18 21:21:10,REAL,2849365586,494,2849366080,2852126182
2025-06-18 21:21:12,REAL,2849366080,486,2849366566,2852126668
2025-06-18 21:21:14,REAL,2849366566,476,2849367042,2852127144
2025-06-18 21:21:16,FAKE,2849367042,244,2849367286,2852127620
2025-06-18 21:21:18,REAL,2849367286,538,2849367824,2852128158
2025-06-18 21:21:20,REAL,2849367824,479,2849368303,2852128637
2025-06-18 21:21:22,REAL,2849368303,477,2849368780,2852129114
2025-06-18 21:21:24,FAKE,2849368780,238,2849369018,2852129599
2025-06-18 21:21:26,REAL,2849369018,494,2849369512,2852130093
2025-06-18 21:21:28,REAL,2849369512,539,2849370051,2852130632
2025-06-18 21:21:30,REAL,2849370051,483,2849370534,2852131115
2025-06-18 21:21:32,REAL,2849370534,485,2849371019,2852131600
2025-06-18 21:21:34,REAL,2849371019,490,2849371509,2852132090
2025-06-18 21:21:36,REAL,2849371509,492,2849372001,2852132582
2025-06-18 21:21:38,REAL,2849372001,485,2849372486,2852133067
2025-06-18 21:21:40,REAL,2849372486,477,2849372963,2852133544
2025-06-18 21:21:42,REAL,2849372963,483,2849373446,2852134027
2025-06-18 21:21:44,FAKE,2849373446,238,2849373684,2852134507
2025-06-18 21:21:46,REAL,2849373684,483,2849374167,2852134990
2025-06-18 21:21:48,FAKE,2849374167,243,2849374410,2852143863
2025-06-18 21:21:50,FAKE,2849374410,241,2849374651,2852154577
2025-06-18 21:21:52,FAKE,2849374651,243,2849374894,2852164828
2025-06-18 21:21:54,FAKE,2849374894,238,2849375132,2852175149
2025-06-18 21:21:56,FAKE,2849375132,241,2849375373,2852185401
2025-06-18 21:21:58,REAL,2849375373,10309,2849385682,2852195710
2025-06-18 21:22:00,REAL,2849385682,10309,2849395991,2852206019
2025-06-18 21:22:02,REAL,2849395991,7939,2849403930,2852213958
2025-06-18 21:22:04,FAKE,2849403930,244,2849404174,2852214444
2025-06-18 21:22:06,FAKE,2849404174,244,2849404418,2852214923
2025-06-18 21:22:08,REAL,2849404418,487,2849404905,2852215410
2025-06-18 21:22:10,REAL,2849404905,486,2849405391,2852215896
2025-06-18 21:22:12,REAL,2849405391,488,2849405879,2852216384
2025-06-18 21:22:14,REAL,2849405879,484,2849406363,2852216868
2025-06-18 21:22:16,REAL,2849406363,489,2849406852,2852217357
2025-06-18 21:22:18,REAL,2849406852,485,2849407337,2852217842
2025-06-18 21:22:20,REAL,2849407337,486,2849407823,2852218328
2025-06-18 21:22:22,FAKE,2849407823,238,2849408061,2852218861
2025-06-18 21:22:24,REAL,2849408061,476,2849408537,2852219337
2025-06-18 21:22:26,FAKE,2849408537,243,2849408780,2852219820
2025-06-18 21:22:28,REAL,2849408780,485,2849409265,2852220305
2025-06-18 21:22:30,FAKE,2849409265,244,2849409509,2852220793
2025-06-18 21:22:32,REAL,2849409509,494,2849410003,2852221287
2025-06-18 21:22:34,REAL,2849410003,487,2849410490,2852221774
2025-06-18 21:22:36,REAL,2849410490,478,2849410968,2852222252
2025-06-18 21:22:38,REAL,2849410968,545,2849411513,2852222797
2025-06-18 21:22:40,REAL,2849411513,483,2849411996,2852223280
2025-06-18 21:22:42,FAKE,2849411996,244,2849412240,2852223761
2025-06-18 21:22:44,REAL,2849412240,481,2849412721,2852224242
2025-06-18 21:22:46,REAL,2849412721,490,2849413211,2852224732
2025-06-18 21:22:48,REAL,2849413211,484,2849413695,2852225216
2025-06-18 21:22:50,REAL,2849413695,482,2849414177,2852225698
2025-06-18 21:22:52,REAL,2849414177,10128,2849424305,2852235826
2025-06-18 21:22:54,FAKE,2849424305,238,2849424543,2852246276
2025-06-18 21:22:56,FAKE,2849424543,238,2849424781,2852256530
2025-06-18 21:22:58,REAL,2849424781,10253,2849435034,2852266783
2025-06-18 21:23:00,FAKE,2849435034,238,2849435272,2852277037
2025-06-18 21:23:02,REAL,2849435272,10249,2849445521,2852287286
2025-06-18 21:23:04,REAL,2849445521,10247,2849455768,2852297533
2025-06-18 21:23:06,FAKE,2849455768,244,2849456012,2852304222
2025-06-18 21:23:08,REAL,2849456012,485,2849456497,2852304707
2025-06-18 21:23:10,REAL,2849456497,491,2849456988,2852305198
2025-06-18 21:23:12,REAL,2849456988,482,2849457470,2852305680
2025-06-18 21:23:14,REAL,2849457470,486,2849457956,2852306166
2025-06-18 21:23:16,REAL,2849457956,477,2849458433,2852306643
2025-06-18 21:23:18,REAL,2849458433,480,2849458913,2852307123
2025-06-18 21:23:20,REAL,2849458913,481,2849459394,2852307604
2025-06-18 21:23:22,REAL,2849459394,484,2849459878,2852308088
2025-06-18 21:23:24,FAKE,2849459878,243,2849460121,2852319338
2025-06-18 21:23:26,FAKE,2849460121,243,2849460364,2852329646
2025-06-18 21:23:28,FAKE,2849460364,238,2849460602,2852339897
2025-06-18 21:23:30,REAL,2849460602,10251,2849470853,2852350148
2025-06-18 21:23:32,REAL,2849470853,10320,2849481173,2852360468
2025-06-18 21:23:34,REAL,2849481173,10252,2849491425,2852370720
2025-06-18 21:23:36,FAKE,2849491425,243,2849491668,2852380973
2025-06-18 21:23:38,FAKE,2849491668,238,2849491906,2852387003
2025-06-18 21:23:40,REAL,2849491906,492,2849492398,2852387495
2025-06-18 21:23:42,REAL,2849492398,480,2849492878,2852387975
2025-06-18 21:23:44,REAL,2849492878,486,2849493364,2852388461
2025-06-18 21:23:46,REAL,2849493364,486,2849493850,2852388947
2025-06-18 21:23:48,FAKE,2849493850,244,2849494094,2852389436
2025-06-18 21:23:50,REAL,2849494094,487,2849494581,2852389923
2025-06-18 21:23:52,REAL,2849494581,486,2849495067,2852390409
2025-06-18 21:23:54,FAKE,2849495067,241,2849495308,2852390895
2025-06-18 21:23:56,REAL,2849495308,482,2849495790,2852391377
2025-06-18 21:23:58,REAL,2849495790,541,2849496331,2852391918
2025-06-18 21:24:00,FAKE,2849496331,244,2849496575,2852392409
2025-06-18 21:24:02,REAL,2849496575,479,2849497054,2852392888
2025-06-18 21:24:04,REAL,2849497054,489,2849497543,2852393377
2025-06-18 21:24:06,REAL,2849497543,478,2849498021,2852393855
2025-06-18 21:24:08,REAL,2849498021,477,2849498498,2852394332
2025-06-18 21:24:10,REAL,2849498498,485,2849498983,2852394817
2025-06-18 21:24:12,FAKE,2849498983,243,2849499226,2852395298
2025-06-18 21:24:14,REAL,2849499226,486,2849499712,2852395784
2025-06-18 21:24:16,REAL,2849499712,539,2849500251,2852396323
2025-06-18 21:24:18,REAL,2849500251,488,2849500739,2852396811
2025-06-18 21:24:20,FAKE,2849500739,243,2849500982,2852397295
2025-06-18 21:24:22,FAKE,2849500982,244,2849501226,2852397769
2025-06-18 21:24:24,FAKE,2849501226,244,2849501470,2852398248
2025-06-18 21:24:26,REAL,2849501470,948,2849502418,2852399196
2025-06-18 21:24:28,REAL,2849502418,11972,2849514390,2852411168
2025-06-18 21:24:30,REAL,2849514390,10250,2849524640,2852421418
2025-06-18 21:24:32,REAL,2849524640,10255,2849534895,2852431673
2025-06-18 21:24:34,FAKE,2849534895,244,2849535139,2852441996
2025-06-18 21:24:36,REAL,2849535139,10253,2849545392,2852452249
2025-06-18 21:24:38,FAKE,2849545392,238,2849545630,2852462507
2025-06-18 21:24:40,FAKE,2849545630,238,2849545868,2852472962
2025-06-18 21:24:42,FAKE,2849545868,244,2849546112,2852477538
2025-06-18 21:24:44,FAKE,2849546112,238,2849546350,2852478021
2025-06-18 21:24:46,REAL,2849546350,486,2849546836,2852478507
2025-06-18 21:24:48,FAKE,2849546836,241,2849547077,2852478993
2025-06-18 21:24:50,REAL,2849547077,485,2849547562,2852479478
2025-06-18 21:24:52,REAL,2849547562,481,2849548043,2852479959
2025-06-18 21:24:54,REAL,2849548043,491,2849548534,2852480450
2025-06-18 21:24:56,FAKE,2849548534,241,2849548775,2852480932
2025-06-18 21:24:58,REAL,2849548775,482,2849549257,2852481414
2025-06-18 21:25:00,REAL,2849549257,475,2849549732,2852481889
2025-06-18 21:25:02,REAL,2849549732,537,2849550269,2852482426
2025-06-18 21:25:04,FAKE,2849550269,238,2849550507,2852482968
2025-06-18 21:25:06,FAKE,2849550507,243,2849550750,2852483443
2025-06-18 21:25:08,REAL,2849550750,483,2849551233,2852483926
2025-06-18 21:25:10,REAL,2849551233,489,2849551722,2852484415
2025-06-18 21:25:12,FAKE,2849551722,243,2849551965,2852484897
2025-06-18 21:25:14,FAKE,2849551965,244,2849552209,2852485377
2025-06-18 21:25:16,REAL,2849552209,477,2849552686,2852485854
2025-06-18 21:25:18,FAKE,2849552686,238,2849552924,2852486345
2025-06-18 21:25:20,FAKE,2849552924,244,2849553168,2852486832
2025-06-18 21:25:22,REAL,2849553168,477,2849553645,2852487309
2025-06-18 21:25:24,REAL,2849553645,487,2849554132,2852487796
2025-06-18 21:25:26,REAL,2849554132,481,2849554613,2852488277
2025-06-18 21:25:28,REAL,2849554613,486,2849555099,2852488763
2025-06-18 21:25:30,FAKE,2849555099,244,2849555343,2852491235
2025-06-18 21:25:32,REAL,2849555343,11855,2849567198,2852503090
2025-06-18 21:25:34,REAL,2849567198,10254,2849577452,2852513344
2025-06-18 21:25:36,FAKE,2849577452,238,2849577690,2852523719
2025-06-18 21:25:38,REAL,2849577690,10250,2849587940,2852533969
2025-06-18 21:25:40,FAKE,2849587940,244,2849588184,2852544221
2025-06-18 21:25:42,FAKE,2849588184,238,2849588422,2852554538
2025-06-18 21:25:44,REAL,2849588422,10249,2849598671,2852564787
2025-06-18 21:25:46,REAL,2849598671,3588,2849602259,2852568375
2025-06-18 21:25:48,REAL,2849602259,482,2849602741,2852568857
2025-06-18 21:25:50,REAL,2849602741,483,2849603224,2852569340
2025-06-18 21:25:52,FAKE,2849603224,243,2849603467,2852569818
2025-06-18 21:25:54,REAL,2849603467,537,2849604004,2852570355
2025-06-18 21:25:56,FAKE,2849604004,243,2849604247,2852570844
2025-06-18 21:25:58,FAKE,2849604247,241,2849604488,2852571331
2025-06-18 21:26:00,REAL,2849604488,491,2849604979,2852571822
2025-06-18 21:26:02,REAL,2849604979,3061,2849608040,2852574883
2025-06-18 21:26:04,REAL,2849608040,14147,2849622187,2852589030
2025-06-18 21:26:06,FAKE,2849622187,243,2849622430,2852599288
2025-06-18 21:26:08,REAL,2849622430,10248,2849632678,2852609536
2025-06-18 21:26:10,FAKE,2849632678,244,2849632922,2852619854
2025-06-18 21:26:12,REAL,2849632922,10255,2849643177,2852630109
2025-06-18 21:26:14,REAL,2849643177,10324,2849653501,2852640433
2025-06-18 21:26:16,FAKE,2849653501,241,2849653742,2852650682
2025-06-18 21:26:18,REAL,2849653742,2918,2849656660,2852653600
2025-06-18 21:26:20,FAKE,2849656660,243,2849656903,2852654088
2025-06-18 21:26:22,REAL,2849656903,484,2849657387,2852654572
2025-06-18 21:26:24,REAL,2849657387,479,2849657866,2852655051
2025-06-18 21:26:26,FAKE,2849657866,243,2849658109,2852655536
2025-06-18 21:26:28,REAL,2849658109,477,2849658586,2852656013
2025-06-18 21:26:30,REAL,2849658586,486,2849659072,2852656499
2025-06-18 21:26:32,FAKE,2849659072,241,2849659313,2852656982
2025-06-18 21:26:34,REAL,2849659313,475,2849659788,2852657457
2025-06-18 21:26:36,REAL,2849659788,487,2849660275,2852657944
2025-06-18 21:26:38,REAL,2849660275,538,2849660813,2852658482
2025-06-18 21:26:40,REAL,2849660813,490,2849661303,2852658972
2025-06-18 21:26:42,FAKE,2849661303,243,2849661546,2852659520
2025-06-18 21:26:44,REAL,2849661546,482,2849662028,2852660002
2025-06-18 21:26:46,FAKE,2849662028,243,2849662271,2852660480
2025-06-18 21:26:48,REAL,2849662271,480,2849662751,2852660960
2025-06-18 21:26:50,REAL,2849662751,489,2849663240,2852661449
2025-06-18 21:26:52,REAL,2849663240,480,2849663720,2852661929
2025-06-18 21:26:54,REAL,2849663720,483,2849664203,2852662412
2025-06-18 21:26:56,REAL,2849664203,489,2849664692,2852662901
2025-06-18 21:26:58,REAL,2849664692,489,2849665181,2852663390
2025-06-18 21:27:00,REAL,2849665181,486,2849665667,2852663876
2025-06-18 21:27:02,REAL,2849665667,484,2849666151,2852664360
2025-06-18 21:27:04,REAL,2849666151,484,2849666635,2852664844
2025-06-18 21:27:06,REAL,2849666635,478,2849667113,2852665322
2025-06-18 21:27:08,FAKE,2849667113,238,2849667351,2852665810
2025-06-18 21:27:10,FAKE,2849667351,238,2849667589,2852666298
2025-06-18 21:27:12,REAL,2849667589,549,2849668138,2852666847
2025-06-18 21:27:14,REAL,2849668138,489,2849668627,2852667336
2025-06-18 21:27:16,REAL,2849668627,484,2849669111,2852667820
2025-06-18 21:27:18,FAKE,2849669111,244,2849669355,2852668308
2025-06-18 21:27:20,REAL,2849669355,484,2849669839,2852668792
2025-06-18 21:27:22,REAL,2849669839,5508,2849675347,2852674300
2025-06-18 21:27:24,FAKE,2849675347,241,2849675588,2852685211
2025-06-18 21:27:26,FAKE,2849675588,241,2849675829,2852695464
2025-06-18 21:27:28,REAL,2849675829,10316,2849686145,2852705780
2025-06-18 21:27:30,FAKE,2849686145,244,2849686389,2852716030
2025-06-18 21:27:32,FAKE,2849686389,238,2849686627,2852726345
2025-06-18 21:27:34,REAL,2849686627,10320,2849696947,2852736665
2025-06-18 21:27:36,REAL,2849696947,10246,2849707193,2852746911
2025-06-18 21:27:38,FAKE,2849707193,243,2849707436,2852748249
2025-06-18 21:27:40,REAL,2849707436,489,2849707925,2852748738
2025-06-18 21:27:42,REAL,2849707925,477,2849708402,2852749215
2025-06-18 21:27:44,FAKE,2849708402,243,2849708645,2852749705
2025-06-18 21:27:46,FAKE,2849708645,238,2849708883,2852750192
2025-06-18 21:27:48,REAL,2849708883,480,2849709363,2852750672
2025-06-18 21:27:50,REAL,2849709363,480,2849709843,2852751152
2025-06-18 21:27:52,REAL,2849709843,481,2849710324,2852751633
2025-06-18 21:27:54,REAL,2849710324,5836,2849716160,2852757469
2025-06-18 21:27:56,FAKE,2849716160,244,2849716404,2852768514
2025-06-18 21:27:58,REAL,2849716404,10319,2849726723,2852778833
2025-06-18 21:28:00,REAL,2849726723,10254,2849736977,2852789087
2025-06-18 21:28:02,REAL,2849736977,10248,2849747225,2852799335
2025-06-18 21:28:04,REAL,2849747225,10252,2849757477,2852809587
2025-06-18 21:28:06,REAL,2849757477,10255,2849767732,2852819842
2025-06-18 21:28:08,FAKE,2849767732,241,2849767973,2852830093
2025-06-18 21:28:10,FAKE,2849767973,238,2849768211,2852830841
2025-06-18 21:28:12,REAL,2849768211,488,2849768699,2852831329
2025-06-18 21:28:14,REAL,2849768699,488,2849769187,2852831817
2025-06-18 21:28:16,FAKE,2849769187,238,2849769425,2852832307
2025-06-18 21:28:18,REAL,2849769425,487,2849769912,2852832794
2025-06-18 21:28:20,REAL,2849769912,541,2849770453,2852833335
2025-06-18 21:28:22,FAKE,2849770453,243,2849770696,2852833812
2025-06-18 21:28:24,REAL,2849770696,487,2849771183,2852834299
2025-06-18 21:28:26,FAKE,2849771183,243,2849771426,2852840806
2025-06-18 21:28:28,REAL,2849771426,11176,2849782602,2852851982
2025-06-18 21:28:30,REAL,2849782602,10257,2849792859,2852862239
2025-06-18 21:28:32,REAL,2849792859,10321,2849803180,2852872560
2025-06-18 21:28:34,REAL,2849803180,10253,2849813433,2852882813
2025-06-18 21:28:36,REAL,2849813433,10245,2849823678,2852893058
2025-06-18 21:28:38,FAKE,2849823678,244,2849823922,2852903376
2025-06-18 21:28:40,REAL,2849823922,9859,2849833781,2852913235
2025-06-18 21:28:42,REAL,2849833781,534,2849834315,2852913769
2025-06-18 21:28:44,FAKE,2849834315,243,2849834558,2852914253
2025-06-18 21:28:46,FAKE,2849834558,238,2849834796,2852914737
2025-06-18 21:28:48,REAL,2849834796,486,2849835282,2852915223
2025-06-18 21:28:50,REAL,2849835282,481,2849835763,2852915704
2025-06-18 21:28:52,REAL,2849835763,484,2849836247,2852916188
2025-06-18 21:28:54,REAL,2849836247,479,2849836726,2852916667
2025-06-18 21:28:56,FAKE,2849836726,243,2849836969,2852917155
2025-06-18 21:28:58,FAKE,2849836969,238,2849837207,2852926156
2025-06-18 21:29:00,REAL,2849837207,12890,2849850097,2852939046
2025-06-18 21:29:02,REAL,2849850097,10323,2849860420,2852949369
2025-06-18 21:29:04,REAL,2849860420,10310,2849870730,2852959679
2025-06-18 21:29:06,FAKE,2849870730,244,2849870974,2852969988
2025-06-18 21:29:08,FAKE,2849870974,244,2849871218,2852980246
2025-06-18 21:29:10,FAKE,2849871218,241,2849871459,2852990492
2025-06-18 21:29:12,REAL,2849871459,9254,2849880713,2852999746
2025-06-18 21:29:14,FAKE,2849880713,244,2849880957,2853000237
2025-06-18 21:29:16,FAKE,2849880957,241,2849881198,2853000719
2025-06-18 21:29:18,REAL,2849881198,491,2849881689,2853001210
2025-06-18 21:29:20,FAKE,2849881689,241,2849881930,2853001702
2025-06-18 21:29:22,REAL,2849881930,485,2849882415,2853002187
2025-06-18 21:29:24,FAKE,2849882415,241,2849882656,2853002676
2025-06-18 21:29:26,REAL,2849882656,536,2849883192,2853003212
2025-06-18 21:29:28,FAKE,2849883192,238,2849883430,2853003695
2025-06-18 21:29:30,REAL,2849883430,487,2849883917,2853004182
2025-06-18 21:29:32,REAL,2849883917,489,2849884406,2853004671
2025-06-18 21:29:34,REAL,2849884406,538,2849884944,2853005209
2025-06-18 21:29:36,REAL,2849884944,491,2849885435,2853005700
2025-06-18 21:29:38,REAL,2849885435,486,2849885921,2853006186
2025-06-18 21:29:40,REAL,2849885921,483,2849886404,2853006669
2025-06-18 21:29:42,REAL,2849886404,485,2849886889,2853007154
2025-06-18 21:29:44,REAL,2849886889,488,2849887377,2853007642
2025-06-18 21:29:46,FAKE,2849887377,244,2849887621,2853008132
2025-06-18 21:29:48,REAL,2849887621,540,2849888161,2853008672
2025-06-18 21:29:50,FAKE,2849888161,243,2849888404,2853011615
2025-06-18 21:29:52,REAL,2849888404,11635,2849900039,2853023250
2025-06-18 21:29:54,FAKE,2849900039,244,2849900283,2853033503
2025-06-18 21:29:56,FAKE,2849900283,244,2849900527,2853043750
2025-06-18 21:29:58,REAL,2849900527,10256,2849910783,2853054006
2025-06-18 21:30:00,REAL,2849910783,10259,2849921042,2853064265
2025-06-18 21:30:02,REAL,2849921042,10253,2849931295,2853074518
2025-06-18 21:30:04,REAL,2849931295,10251,2849941546,2853084769
2025-06-18 21:30:06,REAL,2849941546,3388,2849944934,2853088157
2025-06-18 21:30:08,REAL,2849944934,480,2849945414,2853088637
2025-06-18 21:30:10,REAL,2849945414,541,2849945955,2853089178
2025-06-18 21:30:12,REAL,2849945955,492,2849946447,2853089670
2025-06-18 21:30:14,REAL,2849946447,476,2849946923,2853090146
2025-06-18 21:30:16,FAKE,2849946923,241,2849947164,2853090633
2025-06-18 21:30:18,REAL,2849947164,487,2849947651,2853091120
2025-06-18 21:30:20,FAKE,2849947651,238,2849947889,2853091602
2025-06-18 21:30:22,REAL,2849947889,478,2849948367,2853092080
2025-06-18 21:30:24,REAL,2849948367,550,2849948917,2853092630
2025-06-18 21:30:26,REAL,2849948917,483,2849949400,2853093113
2025-06-18 21:30:28,REAL,2849949400,492,2849949892,2853093605
2025-06-18 21:30:30,FAKE,2849949892,241,2849950133,2853094083
2025-06-18 21:30:32,REAL,2849950133,537,2849950670,2853094620
2025-06-18 21:30:34,REAL,2849950670,484,2849951154,2853095104
2025-06-18 21:30:36,REAL,2849951154,484,2849951638,2853095588
2025-06-18 21:30:38,REAL,2849951638,481,2849952119,2853096069
2025-06-18 21:30:40,FAKE,2849952119,243,2849952362,2853096561
2025-06-18 21:30:42,FAKE,2849952362,243,2849952605,2853097048
2025-06-18 21:30:44,REAL,2849952605,489,2849953094,2853097537
2025-06-18 21:30:46,REAL,2849953094,484,2849953578,2853098021
2025-06-18 21:30:48,REAL,2849953578,485,2849954063,2853098506
2025-06-18 21:30:50,REAL,2849954063,482,2849954545,2853098988
2025-06-18 21:30:52,REAL,2849954545,485,2849955030,2853099473
2025-06-18 21:30:54,FAKE,2849955030,243,2849955273,2853100019
2025-06-18 21:30:56,REAL,2849955273,482,2849955755,2853100501
2025-06-18 21:30:58,REAL,2849955755,479,2849956234,2853100980
2025-06-18 21:31:00,FAKE,2849956234,238,2849956472,2853101525
2025-06-18 21:31:02,REAL,2849956472,487,2849956959,2853102012
2025-06-18 21:31:04,REAL,2849956959,4387,2849961346,2853106399
2025-06-18 21:31:06,REAL,2849961346,12112,2849973458,2853118511
2025-06-18 21:31:08,REAL,2849973458,10253,2849983711,2853128764
2025-06-18 21:31:10,FAKE,2849983711,238,2849983949,2853139018
2025-06-18 21:31:12,REAL,2849983949,10318,2849994267,2853149336
2025-06-18 21:31:14,REAL,2849994267,10252,2850004519,2853159588
2025-06-18 21:31:16,FAKE,2850004519,238,2850004757,2853169899
2025-06-18 21:31:18,FAKE,2850004757,244,2850005001,2853180209
2025-06-18 21:31:20,REAL,2850005001,2130,2850007131,2853182339
2025-06-18 21:31:22,REAL,2850007131,491,2850007622,2853182830
2025-06-18 21:31:24,REAL,2850007622,481,2850008103,2853183311
2025-06-18 21:31:26,FAKE,2850008103,241,2850008344,2853183792
2025-06-18 21:31:28,FAKE,2850008344,241,2850008585,2853184275
2025-06-18 21:31:30,REAL,2850008585,482,2850009067,2853184757
2025-06-18 21:31:32,FAKE,2850009067,241,2850009308,2853185246
2025-06-18 21:31:34,FAKE,2850009308,241,2850009549,2853185726
2025-06-18 21:31:36,REAL,2850009549,4590,2850014139,2853190316
2025-06-18 21:31:38,REAL,2850014139,11362,2850025501,2853201678
2025-06-18 21:31:40,REAL,2850025501,10253,2850035754,2853211931
2025-06-18 21:31:42,REAL,2850035754,10317,2850046071,2853222248
2025-06-18 21:31:44,REAL,2850046071,10251,2850056322,2853232499
2025-06-18 21:31:46,FAKE,2850056322,244,2850056566,2853242753
2025-06-18 21:31:48,REAL,2850056566,10323,2850066889,2853253076
2025-06-18 21:31:50,REAL,2850066889,10262,2850077151,2853263338
2025-06-18 21:31:52,REAL,2850077151,1545,2850078696,2853264883
2025-06-18 21:31:54,FAKE,2850078696,243,2850078939,2853265360
2025-06-18 21:31:56,REAL,2850078939,482,2850079421,2853265842
2025-06-18 21:31:58,REAL,2850079421,484,2850079905,2853266326
2025-06-18 21:32:00,REAL,2850079905,542,2850080447,2853266868
2025-06-18 21:32:02,FAKE,2850080447,238,2850080685,2853267351
2025-06-18 21:32:04,REAL,2850080685,484,2850081169,2853267835
2025-06-18 21:32:06,FAKE,2850081169,238,2850081407,2853268318
2025-06-18 21:32:08,REAL,2850081407,6027,2850087434,2853274345
2025-06-18 21:32:10,REAL,2850087434,10850,2850098284,2853285195
2025-06-18 21:32:12,REAL,2850098284,10192,2850108476,2853295387
2025-06-18 21:32:14,REAL,2850108476,10255,2850118731,2853305642
2025-06-18 21:32:16,REAL,2850118731,10258,2850128989,2853315900
2025-06-18 21:32:18,REAL,2850128989,10325,2850139314,2853326225
2025-06-18 21:32:20,REAL,2850139314,10252,2850149566,2853336477
2025-06-18 21:32:22,REAL,2850149566,10301,2850159867,2853346778
2025-06-18 21:32:24,FAKE,2850159867,243,2850160110,2853347721
2025-06-18 21:32:26,REAL,2850160110,491,2850160601,2853348212
2025-06-18 21:32:28,REAL,2850160601,483,2850161084,2853348695
2025-06-18 21:32:30,REAL,2850161084,491,2850161575,2853349186
2025-06-18 21:32:32,REAL,2850161575,487,2850162062,2853349673
2025-06-18 21:32:34,REAL,2850162062,478,2850162540,2853350151
2025-06-18 21:32:36,REAL,2850162540,492,2850163032,2853350643
2025-06-18 21:32:38,REAL,2850163032,480,2850163512,2853351123
2025-06-18 21:32:40,FAKE,2850163512,243,2850163755,2853351608
2025-06-18 21:32:42,REAL,2850163755,535,2850164290,2853352143
2025-06-18 21:32:44,FAKE,2850164290,244,2850164534,2853352682
2025-06-18 21:32:46,REAL,2850164534,485,2850165019,2853353167
2025-06-18 21:32:48,FAKE,2850165019,241,2850165260,2853353653
2025-06-18 21:32:50,REAL,2850165260,490,2850165750,2853354143
2025-06-18 21:32:52,FAKE,2850165750,244,2850165994,2853354626
2025-06-18 21:32:54,REAL,2850165994,491,2850166485,2853355117
2025-06-18 21:32:56,REAL,2850166485,486,2850166971,2853355603
2025-06-18 21:32:58,REAL,2850166971,487,2850167458,2853356090
2025-06-18 21:33:00,REAL,2850167458,487,2850167945,2853356577
2025-06-18 21:33:02,REAL,2850167945,478,2850168423,2853357055
2025-06-18 21:33:04,FAKE,2850168423,244,2850168667,2853357545
2025-06-18 21:33:06,REAL,2850168667,490,2850169157,2853358035
2025-06-18 21:33:08,REAL,2850169157,493,2850169650,2853358528
2025-06-18 21:33:10,REAL,2850169650,480,2850170130,2853359008
2025-06-18 21:33:12,REAL,2850170130,480,2850170610,2853359488
2025-06-18 21:33:14,FAKE,2850170610,243,2850170853,2853359973
2025-06-18 21:33:16,FAKE,2850170853,241,2850171094,2853360521
2025-06-18 21:33:18,REAL,2850171094,536,2850171630,2853361057
2025-06-18 21:33:20,REAL,2850171630,478,2850172108,2853361535
2025-06-18 21:33:22,REAL,2850172108,480,2850172588,2853362015
2025-06-18 21:33:24,REAL,2850172588,477,2850173065,2853362492
2025-06-18 21:33:26,REAL,2850173065,492,2850173557,2853362984
2025-06-18 21:33:28,FAKE,2850173557,244,2850173801,2853370937
2025-06-18 21:33:30,FAKE,2850173801,243,2850174044,2853381522
2025-06-18 21:33:32,REAL,2850174044,10315,2850184359,2853391837
2025-06-18 21:33:34,REAL,2850184359,10251,2850194610,2853402088
2025-06-18 21:33:36,FAKE,2850194610,243,2850194853,2853412341
2025-06-18 21:33:38,REAL,2850194853,10259,2850205112,2853422600
2025-06-18 21:33:40,REAL,2850205112,10248,2850215360,2853432848
2025-06-18 21:33:42,REAL,2850215360,9200,2850224560,2853442048
2025-06-18 21:33:44,FAKE,2850224560,244,2850224804,2853442538
2025-06-18 21:33:46,REAL,2850224804,483,2850225287,2853443021
2025-06-18 21:33:48,REAL,2850225287,477,2850225764,2853443498
2025-06-18 21:33:50,FAKE,2850225764,243,2850226007,2853443976
2025-06-18 21:33:52,REAL,2850226007,486,2850226493,2853444462
2025-06-18 21:33:54,REAL,2850226493,548,2850227041,2853445010
2025-06-18 21:33:56,FAKE,2850227041,238,2850227279,2853445492
2025-06-18 21:33:58,FAKE,2850227279,243,2850227522,2853445979
2025-06-18 21:34:00,REAL,2850227522,8417,2850235939,2853454396
2025-06-18 21:34:02,REAL,2850235939,10708,2850246647,2853465104
2025-06-18 21:34:04,REAL,2850246647,10257,2850256904,2853475361
2025-06-18 21:34:06,REAL,2850256904,10257,2850267161,2853485618
2025-06-18 21:34:08,REAL,2850267161,10318,2850277479,2853495936
2025-06-18 21:34:10,REAL,2850277479,10256,2850287735,2853506192
2025-06-18 21:34:12,REAL,2850287735,10250,2850297985,2853516442
2025-06-18 21:34:14,REAL,2850297985,8477,2850306462,2853524919
2025-06-18 21:34:16,REAL,2850306462,485,2850306947,2853525404
2025-06-18 21:34:18,REAL,2850306947,484,2850307431,2853525888
2025-06-18 21:34:20,REAL,2850307431,489,2850307920,2853526377
2025-06-18 21:34:22,REAL,2850307920,486,2850308406,2853526863
2025-06-18 21:34:24,FAKE,2850308406,243,2850308649,2853527340
2025-06-18 21:34:26,REAL,2850308649,483,2850309132,2853527823
2025-06-18 21:34:28,FAKE,2850309132,241,2850309373,2853528361
2025-06-18 21:34:30,REAL,2850309373,483,2850309856,2853528844
2025-06-18 21:34:32,REAL,2850309856,9339,2850319195,2853538183
2025-06-18 21:34:34,REAL,2850319195,10649,2850329844,2853548832
2025-06-18 21:34:36,FAKE,2850329844,244,2850330088,2853559078
2025-06-18 21:34:38,REAL,2850330088,10250,2850340338,2853569328
2025-06-18 21:34:40,REAL,2850340338,10316,2850350654,2853579644
2025-06-18 21:34:42,REAL,2850350654,10252,2850360906,2853589896
2025-06-18 21:34:44,FAKE,2850360906,243,2850361149,2853600476
2025-06-18 21:34:46,REAL,2850361149,7546,2850368695,2853608022
2025-06-18 21:34:48,FAKE,2850368695,241,2850368936,2853608513
2025-06-18 21:34:50,REAL,2850368936,483,2850369419,2853608996
2025-06-18 21:34:52,REAL,2850369419,480,2850369899,2853609476
2025-06-18 21:34:54,FAKE,2850369899,244,2850370143,2853609962
2025-06-18 21:34:56,FAKE,2850370143,241,2850370384,2853610450
2025-06-18 21:34:58,REAL,2850370384,482,2850370866,2853610932
2025-06-18 21:35:00,REAL,2850370866,486,2850371352,2853611418
2025-06-18 21:35:02,REAL,2850371352,543,2850371895,2853611961
2025-06-18 21:35:04,REAL,2850371895,491,2850372386,2853612452
2025-06-18 21:35:06,REAL,2850372386,540,2850372926,2853612992
2025-06-18 21:35:08,REAL,2850372926,493,2850373419,2853613485
2025-06-18 21:35:10,REAL,2850373419,478,2850373897,2853613963
2025-06-18 21:35:12,REAL,2850373897,488,2850374385,2853614451
2025-06-18 21:35:14,FAKE,2850374385,243,2850374628,2853614928
2025-06-18 21:35:16,REAL,2850374628,480,2850375108,2853615408
2025-06-18 21:35:18,FAKE,2850375108,243,2850375351,2853615896
2025-06-18 21:35:20,FAKE,2850375351,238,2850375589,2853616382
2025-06-18 21:35:22,FAKE,2850375589,241,2850375830,2853616866
2025-06-18 21:35:24,REAL,2850375830,484,2850376314,2853617350
2025-06-18 21:35:26,REAL,2850376314,490,2850376804,2853617840
2025-06-18 21:35:28,REAL,2850376804,486,2850377290,2853618326
2025-06-18 21:35:30,REAL,2850377290,486,2850377776,2853618812
2025-06-18 21:35:32,REAL,2850377776,481,2850378257,2853619293
2025-06-18 21:35:34,REAL,2850378257,479,2850378736,2853619772
2025-06-18 21:35:36,REAL,2850378736,11180,2850389916,2853630952
2025-06-18 21:35:38,FAKE,2850389916,241,2850390157,2853641397
2025-06-18 21:35:40,REAL,2850390157,10254,2850400411,2853651651
2025-06-18 21:35:42,REAL,2850400411,10256,2850410667,2853661907
2025-06-18 21:35:44,REAL,2850410667,10245,2850420912,2853672152
2025-06-18 21:35:46,REAL,2850420912,10245,2850431157,2853682397
2025-06-18 21:35:48,FAKE,2850431157,241,2850431398,2853692648
2025-06-18 21:35:50,FAKE,2850431398,244,2850431642,2853699341
2025-06-18 21:35:52,FAKE,2850431642,238,2850431880,2853699824
2025-06-18 21:35:54,FAKE,2850431880,241,2850432121,2853700304
2025-06-18 21:35:56,REAL,2850432121,480,2850432601,2853700784
2025-06-18 21:35:58,REAL,2850432601,484,2850433085,2853701268
2025-06-18 21:36:00,REAL,2850433085,480,2850433565,2853701748
2025-06-18 21:36:02,FAKE,2850433565,244,2850433809,2853702235
2025-06-18 21:36:04,REAL,2850433809,494,2850434303,2853702729
2025-06-18 21:36:06,FAKE,2850434303,238,2850434541,2853703208
2025-06-18 21:36:08,REAL,2850434541,479,2850435020,2853703687
2025-06-18 21:36:10,FAKE,2850435020,244,2850435264,2853704230
2025-06-18 21:36:12,REAL,2850435264,540,2850435804,2853704770
2025-06-18 21:36:14,REAL,2850435804,239,2850436043,2853705009
2025-06-18 21:36:16,REAL,2850436043,478,2850436521,2853705487
2025-06-18 21:36:18,FAKE,2850436521,241,2850436762,2853705973
2025-06-18 21:36:20,FAKE,2850436762,238,2850437000,2853706454
2025-06-18 21:36:22,REAL,2850437000,488,2850437488,2853706942
2025-06-18 21:36:24,REAL,2850437488,491,2850437979,2853707433
2025-06-18 21:36:26,REAL,2850437979,481,2850438460,2853707914
2025-06-18 21:36:28,FAKE,2850438460,243,2850438703,2853708405
2025-06-18 21:36:30,REAL,2850438703,477,2850439180,2853708882
2025-06-18 21:36:32,FAKE,2850439180,244,2850439424,2853709369
2025-06-18 21:36:34,FAKE,2850439424,244,2850439668,2853709855
2025-06-18 21:36:36,REAL,2850439668,484,2850440152,2853710339
2025-06-18 21:36:38,REAL,2850440152,476,2850440628,2853710815
2025-06-18 21:36:40,FAKE,2850440628,244,2850440872,2853711296
2025-06-18 21:36:42,REAL,2850440872,487,2850441359,2853711783
2025-06-18 21:36:44,FAKE,2850441359,238,2850441597,2853712271
2025-06-18 21:36:46,REAL,2850441597,542,2850442139,2853712813
2025-06-18 21:36:48,REAL,2850442139,489,2850442628,2853713302
2025-06-18 21:36:50,REAL,2850442628,543,2850443171,2853713845
2025-06-18 21:36:52,FAKE,2850443171,243,2850443414,2853714321
2025-06-18 21:36:54,REAL,2850443414,480,2850443894,2853714801
2025-06-18 21:36:56,FAKE,2850443894,244,2850444138,2853726907
2025-06-18 21:36:58,REAL,2850444138,10255,2850454393,2853737162
2025-06-18 21:37:00,REAL,2850454393,10252,2850464645,2853747414
2025-06-18 21:37:02,REAL,2850464645,10253,2850474898,2853757667
2025-06-18 21:37:04,REAL,2850474898,10253,2850485151,2853767920
2025-06-18 21:37:06,FAKE,2850485151,238,2850485389,2853778241
2025-06-18 21:37:08,FAKE,2850485389,241,2850485630,2853788490
2025-06-18 21:37:10,REAL,2850485630,5097,2850490727,2853793587
2025-06-18 21:37:12,REAL,2850490727,482,2850491209,2853794069
2025-06-18 21:37:14,REAL,2850491209,481,2850491690,2853794550
2025-06-18 21:37:16,REAL,2850491690,486,2850492176,2853795036
2025-06-18 21:37:18,REAL,2850492176,487,2850492663,2853795523
2025-06-18 21:37:20,REAL,2850492663,532,2850493195,2853796055
2025-06-18 21:37:22,FAKE,2850493195,243,2850493438,2853796538
2025-06-18 21:37:24,REAL,2850493438,490,2850493928,2853797028
2025-06-18 21:37:26,REAL,2850493928,1489,2850495417,2853798517
2025-06-18 21:37:28,FAKE,2850495417,241,2850495658,2853810547
2025-06-18 21:37:30,FAKE,2850495658,238,2850495896,2853820803
2025-06-18 21:37:32,REAL,2850495896,10321,2850506217,2853831124
2025-06-18 21:37:34,REAL,2850506217,10252,2850516469,2853841376
2025-06-18 21:37:36,FAKE,2850516469,243,2850516712,2853851623
2025-06-18 21:37:38,FAKE,2850516712,244,2850516956,2853861933
2025-06-18 21:37:40,FAKE,2850516956,243,2850517199,2853872183
2025-06-18 21:37:42,FAKE,2850517199,238,2850517437,2853876690
2025-06-18 21:37:44,REAL,2850517437,475,2850517912,2853877165
2025-06-18 21:37:46,FAKE,2850517912,244,2850518156,2853877644
2025-06-18 21:37:48,REAL,2850518156,491,2850518647,2853878135
2025-06-18 21:37:50,REAL,2850518647,479,2850519126,2853878614
2025-06-18 21:37:52,REAL,2850519126,483,2850519609,2853879097
2025-06-18 21:37:54,REAL,2850519609,536,2850520145,2853879633
2025-06-18 21:37:56,FAKE,2850520145,238,2850520383,2853880117
2025-06-18 21:37:58,REAL,2850520383,477,2850520860,2853880594
2025-06-18 21:38:00,REAL,2850520860,485,2850521345,2853881079
2025-06-18 21:38:02,FAKE,2850521345,238,2850521583,2853881566
2025-06-18 21:38:04,REAL,2850521583,481,2850522064,2853882047
2025-06-18 21:38:06,REAL,2850522064,483,2850522547,2853882530
2025-06-18 21:38:08,REAL,2850522547,531,2850523078,2853883061
2025-06-18 21:38:10,REAL,2850523078,475,2850523553,2853883536
2025-06-18 21:38:12,REAL,2850523553,478,2850524031,2853884014
2025-06-18 21:38:14,REAL,2850524031,491,2850524522,2853884505
2025-06-18 21:38:16,REAL,2850524522,474,2850524996,2853884979
2025-06-18 21:38:18,REAL,2850524996,486,2850525482,2853885465
2025-06-18 21:38:20,REAL,2850525482,477,2850525959,2853885942
2025-06-18 21:38:22,REAL,2850525959,483,2850526442,2853886425
2025-06-18 21:38:24,REAL,2850526442,488,2850526930,2853886913
2025-06-18 21:38:26,REAL,2850526930,482,2850527412,2853887395
2025-06-18 21:38:28,REAL,2850527412,477,2850527889,2853887872
2025-06-18 21:38:30,REAL,2850527889,3069,2850530958,2853890941
2025-06-18 21:38:32,REAL,2850530958,11505,2850542463,2853902446
2025-06-18 21:38:34,REAL,2850542463,10255,2850552718,2853912701
2025-06-18 21:38:36,REAL,2850552718,10258,2850562976,2853922959
2025-06-18 21:38:38,FAKE,2850562976,243,2850563219,2853933210
2025-06-18 21:38:40,REAL,2850563219,10374,2850573593,2853943584
2025-06-18 21:38:42,REAL,2850573593,10256,2850583849,2853953840
2025-06-18 21:38:44,REAL,2850583849,10319,2850594168,2853964159
2025-06-18 21:38:46,REAL,2850594168,3182,2850597350,2853967341
2025-06-18 21:38:48,FAKE,2850597350,241,2850597591,2853967819
2025-06-18 21:38:50,REAL,2850597591,487,2850598078,2853968306
2025-06-18 21:38:52,REAL,2850598078,484,2850598562,2853968790
2025-06-18 21:38:54,FAKE,2850598562,243,2850598805,2853969275
2025-06-18 21:38:56,FAKE,2850598805,238,2850599043,2853969755
2025-06-18 21:38:58,REAL,2850599043,486,2850599529,2853970241
2025-06-18 21:39:00,REAL,2850599529,482,2850600011,2853970723
2025-06-18 21:39:02,REAL,2850600011,3918,2850603929,2853974641
2025-06-18 21:39:04,REAL,2850603929,11371,2850615300,2853986012
2025-06-18 21:39:06,FAKE,2850615300,243,2850615543,2853996340
2025-06-18 21:39:08,FAKE,2850615543,244,2850615787,2854006590
2025-06-18 21:39:10,REAL,2850615787,10245,2850626032,2854016835
2025-06-18 21:39:12,REAL,2850626032,10318,2850636350,2854027153
2025-06-18 21:39:14,FAKE,2850636350,243,2850636593,2854037399
2025-06-18 21:39:16,REAL,2850636593,10253,2850646846,2854047652
2025-06-18 21:39:18,FAKE,2850646846,243,2850647089,2854050248
2025-06-18 21:39:20,FAKE,2850647089,244,2850647333,2854050729
2025-06-18 21:39:22,REAL,2850647333,477,2850647810,2854051206
2025-06-18 21:39:24,REAL,2850647810,546,2850648356,2854051752
2025-06-18 21:39:26,REAL,2850648356,490,2850648846,2854052242
2025-06-18 21:39:28,REAL,2850648846,487,2850649333,2854052729
2025-06-18 21:39:30,REAL,2850649333,478,2850649811,2854053207
2025-06-18 21:39:32,FAKE,2850649811,238,2850650049,2854053685
2025-06-18 21:39:34,REAL,2850650049,4780,2850654829,2854058465
2025-06-18 21:39:36,REAL,2850654829,13824,2850668653,2854072289
2025-06-18 21:39:38,FAKE,2850668653,241,2850668894,2854082545
2025-06-18 21:39:40,REAL,2850668894,10309,2850679203,2854092854
2025-06-18 21:39:42,REAL,2850679203,10247,2850689450,2854103101
2025-06-18 21:39:44,FAKE,2850689450,244,2850689694,2854113419
2025-06-18 21:39:46,FAKE,2850689694,244,2850689938,2854123671
2025-06-18 21:39:48,REAL,2850689938,10246,2850700184,2854133917
2025-06-18 21:39:50,FAKE,2850700184,238,2850700422,2854135918
2025-06-18 21:39:52,FAKE,2850700422,241,2850700663,2854136402
2025-06-18 21:39:54,FAKE,2850700663,241,2850700904,2854136882
2025-06-18 21:39:56,REAL,2850700904,488,2850701392,2854137370
2025-06-18 21:39:58,FAKE,2850701392,243,2850701635,2854137851
2025-06-18 21:40:00,REAL,2850701635,485,2850702120,2854138336
2025-06-18 21:40:02,FAKE,2850702120,243,2850702363,2854138814
2025-06-18 21:40:04,REAL,2850702363,490,2850702853,2854139304
2025-06-18 21:40:06,FAKE,2850702853,241,2850703094,2854144478
2025-06-18 21:40:08,REAL,2850703094,11566,2850714660,2854156044
2025-06-18 21:40:10,FAKE,2850714660,241,2850714901,2854166349
2025-06-18 21:40:12,REAL,2850714901,10311,2850725212,2854176660
2025-06-18 21:40:14,REAL,2850725212,10248,2850735460,2854186908
2025-06-18 21:40:16,FAKE,2850735460,241,2850735701,2854197818
2025-06-18 21:40:18,FAKE,2850735701,244,2850735945,2854207471
2025-06-18 21:40:20,REAL,2850735945,10249,2850746194,2854217720
2025-06-18 21:40:22,FAKE,2850746194,238,2850746432,2854219060
2025-06-18 21:40:24,REAL,2850746432,492,2850746924,2854219552
2025-06-18 21:40:26,REAL,2850746924,485,2850747409,2854220037
2025-06-18 21:40:28,REAL,2850747409,483,2850747892,2854220520
2025-06-18 21:40:30,REAL,2850747892,489,2850748381,2854221009
2025-06-18 21:40:32,FAKE,2850748381,241,2850748622,2854221495
2025-06-18 21:40:34,FAKE,2850748622,241,2850748863,2854221979
2025-06-18 21:40:36,REAL,2850748863,486,2850749349,2854222465
2025-06-18 21:40:38,REAL,2850749349,5979,2850755328,2854228444
2025-06-18 21:40:40,REAL,2850755328,11376,2850766704,2854239820
2025-06-18 21:40:42,FAKE,2850766704,243,2850766947,2854250066
2025-06-18 21:40:44,FAKE,2850766947,238,2850767185,2854260379
2025-06-18 21:40:46,FAKE,2850767185,243,2850767428,2854270627
2025-06-18 21:40:48,REAL,2850767428,10319,2850777747,2854280946
2025-06-18 21:40:50,REAL,2850777747,10244,2850787991,2854291190
2025-06-18 21:40:52,REAL,2850787991,10318,2850798309,2854301508
2025-06-18 21:40:54,REAL,2850798309,735,2850799044,2854302243
2025-06-18 21:40:56,REAL,2850799044,484,2850799528,2854302727
2025-06-18 21:40:58,FAKE,2850799528,241,2850799769,2854303206
2025-06-18 21:41:00,REAL,2850799769,484,2850800253,2854303690
2025-06-18 21:41:02,FAKE,2850800253,238,2850800491,2854304172
2025-06-18 21:41:04,FAKE,2850800491,244,2850800735,2854304656
2025-06-18 21:41:06,REAL,2850800735,484,2850801219,2854305140
2025-06-18 21:41:08,FAKE,2850801219,244,2850801463,2854305630
2025-06-18 21:41:10,FAKE,2850801463,241,2850801704,2854306121
2025-06-18 21:41:12,REAL,2850801704,477,2850802181,2854306598
2025-06-18 21:41:14,REAL,2850802181,620,2850802801,2854307218
2025-06-18 21:41:16,FAKE,2850802801,241,2850803042,2854319468
2025-06-18 21:41:18,REAL,2850803042,10258,2850813300,2854329726
2025-06-18 21:41:20,REAL,2850813300,10246,2850823546,2854339972
2025-06-18 21:41:22,REAL,2850823546,10256,2850833802,2854350228
2025-06-18 21:41:24,FAKE,2850833802,238,2850834040,2854360472
2025-06-18 21:41:26,REAL,2850834040,10321,2850844361,2854370793
2025-06-18 21:41:28,REAL,2850844361,10256,2850854617,2854381049
2025-06-18 21:41:30,REAL,2850854617,4976,2850859593,2854386025
2025-06-18 21:41:32,REAL,2850859593,492,2850860085,2854386517
2025-06-18 21:41:34,FAKE,2850860085,241,2850860326,2854387006
2025-06-18 21:41:36,FAKE,2850860326,241,2850860567,2854387488
2025-06-18 21:41:38,FAKE,2850860567,243,2850860810,2854387971
2025-06-18 21:41:40,REAL,2850860810,549,2850861359,2854388520
2025-06-18 21:41:42,REAL,2850861359,484,2850861843,2854389004
2025-06-18 21:41:44,REAL,2850861843,490,2850862333,2854389494
2025-06-18 21:41:46,FAKE,2850862333,243,2850862576,2854390031
2025-06-18 21:41:48,REAL,2850862576,484,2850863060,2854390515
2025-06-18 21:41:50,FAKE,2850863060,243,2850863303,2854390994
2025-06-18 21:41:52,REAL,2850863303,476,2850863779,2854391470
2025-06-18 21:41:54,REAL,2850863779,490,2850864269,2854391960
2025-06-18 21:41:56,FAKE,2850864269,238,2850864507,2854392448
2025-06-18 21:41:58,REAL,2850864507,478,2850864985,2854392926
2025-06-18 21:42:00,REAL,2850864985,492,2850865477,2854393418
2025-06-18 21:42:02,FAKE,2850865477,243,2850865720,2854393907
2025-06-18 21:42:04,FAKE,2850865720,241,2850865961,2854394399
2025-06-18 21:42:06,REAL,2850865961,487,2850866448,2854394886
2025-06-18 21:42:08,REAL,2850866448,492,2850866940,2854395378
2025-06-18 21:42:10,FAKE,2850866940,238,2850867178,2854395859
2025-06-18 21:42:12,REAL,2850867178,485,2850867663,2854396344
2025-06-18 21:42:14,FAKE,2850867663,241,2850867904,2854396825
2025-06-18 21:42:16,FAKE,2850867904,243,2850868147,2854397359
2025-06-18 21:42:18,REAL,2850868147,2471,2850870618,2854399830
2025-06-18 21:42:20,REAL,2850870618,11438,2850882056,2854411268
2025-06-18 21:42:22,REAL,2850882056,10317,2850892373,2854421585
2025-06-18 21:42:24,REAL,2850892373,10314,2850902687,2854431899
2025-06-18 21:42:26,FAKE,2850902687,238,2850902925,2854442156
2025-06-18 21:42:28,FAKE,2850902925,244,2850903169,2854452404
2025-06-18 21:42:30,REAL,2850903169,10314,2850913483,2854462718
2025-06-18 21:42:32,REAL,2850913483,10245,2850923728,2854472963
2025-06-18 21:42:34,REAL,2850923728,3651,2850927379,2854476614
2025-06-18 21:42:36,REAL,2850927379,493,2850927872,2854477107
2025-06-18 21:42:38,REAL,2850927872,480,2850928352,2854477587
2025-06-18 21:42:40,FAKE,2850928352,238,2850928590,2854478062
2025-06-18 21:42:42,REAL,2850928590,481,2850929071,2854478543
2025-06-18 21:42:44,FAKE,2850929071,238,2850929309,2854479024
2025-06-18 21:42:46,REAL,2850929309,476,2850929785,2854479500
2025-06-18 21:42:48,FAKE,2850929785,238,2850930023,2854480040
2025-06-18 21:42:50,REAL,2850930023,3133,2850933156,2854483173
2025-06-18 21:42:52,REAL,2850933156,11712,2850944868,2854494885
2025-06-18 21:42:54,FAKE,2850944868,238,2850945106,2854505212
2025-06-18 21:42:56,REAL,2850945106,10257,2850955363,2854515469
2025-06-18 21:42:58,REAL,2850955363,10318,2850965681,2854525787
2025-06-18 21:43:00,REAL,2850965681,10255,2850975936,2854536042
2025-06-18 21:43:02,REAL,2850975936,10255,2850986191,2854546297
2025-06-18 21:43:04,REAL,2850986191,10250,2850996441,2854556547
2025-06-18 21:43:06,FAKE,2850996441,241,2850996682,2854559602
2025-06-18 21:43:08,REAL,2850996682,479,2850997161,2854560081
2025-06-18 21:43:10,REAL,2850997161,532,2850997693,2854560613
2025-06-18 21:43:12,REAL,2850997693,481,2850998174,2854561094
2025-06-18 21:43:14,FAKE,2850998174,243,2850998417,2854561580
2025-06-18 21:43:16,FAKE,2850998417,244,2850998661,2854562071
2025-06-18 21:43:18,REAL,2850998661,483,2850999144,2854562554
2025-06-18 21:43:20,REAL,2850999144,537,2850999681,2854563091
2025-06-18 21:43:22,REAL,2850999681,3991,2851003672,2854567082
2025-06-18 21:43:24,FAKE,2851003672,243,2851003915,2854580430
2025-06-18 21:43:26,REAL,2851003915,10253,2851014168,2854590683
2025-06-18 21:43:28,REAL,2851014168,10258,2851024426,2854600941
2025-06-18 21:43:30,FAKE,2851024426,241,2851024667,2854611198
2025-06-18 21:43:32,REAL,2851024667,10254,2851034921,2854621452
2025-06-18 21:43:34,REAL,2851034921,10249,2851045170,2854631701
2025-06-18 21:43:36,REAL,2851045170,10255,2851055425,2854641956
2025-06-18 21:43:38,REAL,2851055425,2459,2851057884,2854644415
2025-06-18 21:43:40,REAL,2851057884,490,2851058374,2854644905
2025-06-18 21:43:42,REAL,2851058374,476,2851058850,2854645381
2025-06-18 21:43:44,FAKE,2851058850,244,2851059094,2854645868
2025-06-18 21:43:46,REAL,2851059094,487,2851059581,2854646355
2025-06-18 21:43:48,REAL,2851059581,492,2851060073,2854646847
2025-06-18 21:43:50,REAL,2851060073,489,2851060562,2854647336
2025-06-18 21:43:52,REAL,2851060562,599,2851061161,2854647935
2025-06-18 21:43:54,REAL,2851061161,4709,2851065870,2854652644
2025-06-18 21:43:56,REAL,2851065870,11107,2851076977,2854663751
2025-06-18 21:43:58,FAKE,2851076977,238,2851077215,2854673996
2025-06-18 21:44:00,FAKE,2851077215,238,2851077453,2854684319
2025-06-18 21:44:02,REAL,2851077453,10253,2851087706,2854694572
2025-06-18 21:44:04,FAKE,2851087706,244,2851087950,2854704880
2025-06-18 21:44:06,FAKE,2851087950,243,2851088193,2854715136
2025-06-18 21:44:08,REAL,2851088193,10252,2851098445,2854725388
2025-06-18 21:44:10,REAL,2851098445,1806,2851100251,2854727194
2025-06-18 21:44:12,REAL,2851100251,476,2851100727,2854727670
2025-06-18 21:44:14,REAL,2851100727,487,2851101214,2854728157
2025-06-18 21:44:16,FAKE,2851101214,244,2851101458,2854728643
2025-06-18 21:44:18,FAKE,2851101458,238,2851101696,2854729128
2025-06-18 21:44:20,REAL,2851101696,477,2851102173,2854729605
2025-06-18 21:44:22,FAKE,2851102173,244,2851102417,2854730084
2025-06-18 21:44:24,REAL,2851102417,543,2851102960,2854730627
2025-06-18 21:44:26,REAL,2851102960,4979,2851107939,2854735606
2025-06-18 21:44:28,REAL,2851107939,11113,2851119052,2854746719
2025-06-18 21:44:30,REAL,2851119052,10258,2851129310,2854756977
2025-06-18 21:44:32,REAL,2851129310,10315,2851139625,2854767292
2025-06-18 21:44:34,REAL,2851139625,10250,2851149875,2854777542
2025-06-18 21:44:36,FAKE,2851149875,243,2851150118,2854787916
2025-06-18 21:44:38,REAL,2851150118,10242,2851160360,2854798158
2025-06-18 21:44:40,REAL,2851160360,10247,2851170607,2854808405
2025-06-18 21:44:42,REAL,2851170607,1210,2851171817,2854809615
2025-06-18 21:44:44,FAKE,2851171817,241,2851172058,2854810093
2025-06-18 21:44:46,REAL,2851172058,494,2851172552,2854810587
2025-06-18 21:44:48,REAL,2851172552,484,2851173036,2854811071
2025-06-18 21:44:50,REAL,2851173036,488,2851173524,2854811559
2025-06-18 21:44:52,REAL,2851173524,478,2851174002,2854812037
2025-06-18 21:44:54,REAL,2851174002,479,2851174481,2854812516
2025-06-18 21:44:56,REAL,2851174481,549,2851175030,2854813065
2025-06-18 21:44:58,REAL,2851175030,6897,2851181927,2854819962
2025-06-18 21:45:00,FAKE,2851181927,238,2851182165,2854830940
2025-06-18 21:45:02,REAL,2851182165,10255,2851192420,2854841195
2025-06-18 21:45:04,REAL,2851192420,10259,2851202679,2854851454
2025-06-18 21:45:06,REAL,2851202679,10245,2851212924,2854861699
2025-06-18 21:45:08,REAL,2851212924,10260,2851223184,2854871959
2025-06-18 21:45:10,REAL,2851223184,10315,2851233499,2854882274
2025-06-18 21:45:12,FAKE,2851233499,238,2851233737,2854892592
2025-06-18 21:45:14,REAL,2851233737,475,2851234212,2854893067
2025-06-18 21:45:16,REAL,2851234212,483,2851234695,2854893550
2025-06-18 21:45:18,REAL,2851234695,542,2851235237,2854894092
2025-06-18 21:45:20,REAL,2851235237,486,2851235723,2854894578
2025-06-18 21:45:22,REAL,2851235723,485,2851236208,2854895063
2025-06-18 21:45:24,REAL,2851236208,486,2851236694,2854895549
2025-06-18 21:45:26,REAL,2851236694,534,2851237228,2854896083
2025-06-18 21:45:28,FAKE,2851237228,238,2851237466,2854896569
2025-06-18 21:45:30,REAL,2851237466,483,2851237949,2854897052
2025-06-18 21:45:32,REAL,2851237949,481,2851238430,2854897533
2025-06-18 21:45:34,REAL,2851238430,483,2851238913,2854898016
2025-06-18 21:45:36,REAL,2851238913,484,2851239397,2854898500
2025-06-18 21:45:38,FAKE,2851239397,241,2851239638,2854898987
2025-06-18 21:45:40,REAL,2851239638,480,2851240118,2854899467
2025-06-18 21:45:42,REAL,2851240118,483,2851240601,2854899950
2025-06-18 21:45:44,FAKE,2851240601,243,2851240844,2854900440
2025-06-18 21:45:46,FAKE,2851240844,244,2851241088,2854900927
2025-06-18 21:45:48,REAL,2851241088,478,2851241566,2854901405
2025-06-18 21:45:50,FAKE,2851241566,244,2851241810,2854902491
2025-06-18 21:45:52,FAKE,2851241810,241,2851242051,2854914064
2025-06-18 21:45:54,FAKE,2851242051,243,2851242294,2854924381
2025-06-18 21:45:56,REAL,2851242294,10257,2851252551,2854934638
2025-06-18 21:45:58,REAL,2851252551,10252,2851262803,2854944890
2025-06-18 21:46:00,REAL,2851262803,10252,2851273055,2854955142
2025-06-18 21:46:02,FAKE,2851273055,238,2851273293,2854965512
2025-06-18 21:46:04,REAL,2851273293,10257,2851283550,2854975769
2025-06-18 21:46:06,FAKE,2851283550,238,2851283788,2854981676
2025-06-18 21:46:08,REAL,2851283788,14485,2851298273,2854996161
2025-06-18 21:46:10,REAL,2851298273,10320,2851308593,2855006481
2025-06-18 21:46:12,FAKE,2851308593,241,2851308834,2855016739
2025-06-18 21:46:14,REAL,2851308834,10251,2851319085,2855026990
2025-06-18 21:46:16,REAL,2851319085,10253,2851329338,2855037243
2025-06-18 21:46:18,REAL,2851329338,10313,2851339651,2855047556
2025-06-18 21:46:20,REAL,2851339651,10258,2851349909,2855057814
2025-06-18 21:46:22,REAL,2851349909,4379,2851354288,2855062193
2025-06-18 21:46:24,REAL,2851354288,482,2851354770,2855062675
2025-06-18 21:46:26,FAKE,2851354770,238,2851355008,2855063160
2025-06-18 21:46:28,FAKE,2851355008,241,2851355249,2855063649
2025-06-18 21:46:30,FAKE,2851355249,238,2851355487,2855064128
2025-06-18 21:46:32,REAL,2851355487,488,2851355975,2855064616
2025-06-18 21:46:34,FAKE,2851355975,243,2851356218,2855065099
2025-06-18 21:46:36,REAL,2851356218,481,2851356699,2855065580
2025-06-18 21:46:38,FAKE,2851356699,243,2851356942,2855067910
2025-06-18 21:46:40,REAL,2851356942,14881,2851371823,2855082791
2025-06-18 21:46:42,FAKE,2851371823,238,2851372061,2855093045
2025-06-18 21:46:44,REAL,2851372061,10373,2851382434,2855103418
2025-06-18 21:46:46,REAL,2851382434,10248,2851392682,2855113666
2025-06-18 21:46:48,REAL,2851392682,10254,2851402936,2855123920
2025-06-18 21:46:50,REAL,2851402936,10326,2851413262,2855134246
2025-06-18 21:46:52,REAL,2851413262,10255,2851423517,2855144501
2025-06-18 21:46:54,REAL,2851423517,3710,2851427227,2855148211
2025-06-18 21:46:56,FAKE,2851427227,238,2851427465,2855148691
2025-06-18 21:46:58,REAL,2851427465,484,2851427949,2855149175
2025-06-18 21:47:00,REAL,2851427949,483,2851428432,2855149658
2025-06-18 21:47:02,REAL,2851428432,476,2851428908,2855150134
2025-06-18 21:47:04,FAKE,2851428908,244,2851429152,2855150620
2025-06-18 21:47:06,REAL,2851429152,486,2851429638,2855151106
2025-06-18 21:47:08,FAKE,2851429638,243,2851429881,2855151589
2025-06-18 21:47:10,REAL,2851429881,3137,2851433018,2855154726
2025-06-18 21:47:12,REAL,2851433018,14278,2851447296,2855169004
2025-06-18 21:47:14,REAL,2851447296,10322,2851457618,2855179326
2025-06-18 21:47:16,FAKE,2851457618,241,2851457859,2855189646
2025-06-18 21:47:18,REAL,2851457859,10251,2851468110,2855199897
2025-06-18 21:47:20,FAKE,2851468110,243,2851468353,2855210152
2025-06-18 21:47:22,FAKE,2851468353,241,2851468594,2855220472
2025-06-18 21:47:24,REAL,2851468594,10316,2851478910,2855230788
2025-06-18 21:47:26,REAL,2851478910,3057,2851481967,2855233845
2025-06-18 21:47:28,REAL,2851481967,542,2851482509,2855234387
2025-06-18 21:47:30,REAL,2851482509,484,2851482993,2855234871
2025-06-18 21:47:32,REAL,2851482993,492,2851483485,2855235363
2025-06-18 21:47:34,REAL,2851483485,483,2851483968,2855235846
2025-06-18 21:47:36,FAKE,2851483968,244,2851484212,2855236326
2025-06-18 21:47:38,FAKE,2851484212,244,2851484456,2855236814
2025-06-18 21:47:40,REAL,2851484456,483,2851484939,2855237297
2025-06-18 21:47:42,REAL,2851484939,4329,2851489268,2855241626
2025-06-18 21:47:44,REAL,2851489268,14149,2851503417,2855255775
2025-06-18 21:47:46,FAKE,2851503417,243,2851503660,2855266030
2025-06-18 21:47:48,REAL,2851503660,10259,2851513919,2855276289
2025-06-18 21:47:50,REAL,2851513919,10256,2851524175,2855286545
2025-06-18 21:47:52,REAL,2851524175,10316,2851534491,2855296861
2025-06-18 21:47:54,FAKE,2851534491,244,2851534735,2855307112
2025-06-18 21:47:56,REAL,2851534735,10251,2851544986,2855317363
2025-06-18 21:47:58,REAL,2851544986,2466,2851547452,2855319829
2025-06-18 21:48:00,FAKE,2851547452,241,2851547693,2855320317
2025-06-18 21:48:02,REAL,2851547693,479,2851548172,2855320796
2025-06-18 21:48:04,REAL,2851548172,487,2851548659,2855321283
2025-06-18 21:48:06,REAL,2851548659,485,2851549144,2855321768
2025-06-18 21:48:08,REAL,2851549144,493,2851549637,2855322261
2025-06-18 21:48:10,FAKE,2851549637,238,2851549875,2855322805
2025-06-18 21:48:12,REAL,2851549875,479,2851550354,2855323284
2025-06-18 21:48:14,REAL,2851550354,4993,2851555347,2855328277
2025-06-18 21:48:16,REAL,2851555347,10916,2851566263,2855339193
2025-06-18 21:48:18,REAL,2851566263,10248,2851576511,2855349441
2025-06-18 21:48:20,REAL,2851576511,10257,2851586768,2855359698
2025-06-18 21:48:22,REAL,2851586768,10249,2851597017,2855369947
2025-06-18 21:48:24,REAL,2851597017,10246,2851607263,2855380193
2025-06-18 21:48:26,FAKE,2851607263,243,2851607506,2855390443
2025-06-18 21:48:28,FAKE,2851607506,238,2851607744,2855400695
2025-06-18 21:48:30,FAKE,2851607744,238,2851607982,2855402568
2025-06-18 21:48:32,FAKE,2851607982,244,2851608226,2855403056
2025-06-18 21:48:34,REAL,2851608226,483,2851608709,2855403539
2025-06-18 21:48:36,REAL,2851608709,482,2851609191,2855404021
2025-06-18 21:48:38,REAL,2851609191,477,2851609668,2855404498
2025-06-18 21:48:40,FAKE,2851609668,243,2851609911,2855404980
2025-06-18 21:48:42,FAKE,2851609911,241,2851610152,2855405470
2025-06-18 21:48:44,FAKE,2851610152,243,2851610395,2855405952
2025-06-18 21:48:46,FAKE,2851610395,243,2851610638,2855411392
2025-06-18 21:48:48,REAL,2851610638,11316,2851621954,2855422708
2025-06-18 21:48:50,REAL,2851621954,10253,2851632207,2855432961
2025-06-18 21:48:52,REAL,2851632207,10323,2851642530,2855443284
2025-06-18 21:48:54,FAKE,2851642530,244,2851642774,2855453545
2025-06-18 21:48:56,REAL,2851642774,10318,2851653092,2855463863
2025-06-18 21:48:58,REAL,2851653092,10254,2851663346,2855474117
2025-06-18 21:49:00,REAL,2851663346,10318,2851673664,2855484435
2025-06-18 21:49:02,FAKE,2851673664,238,2851673902,2855485577
2025-06-18 21:49:04,REAL,2851673902,487,2851674389,2855486064
2025-06-18 21:49:06,FAKE,2851674389,241,2851674630,2855486547
2025-06-18 21:49:08,REAL,2851674630,474,2851675104,2855487021
2025-06-18 21:49:10,FAKE,2851675104,238,2851675342,2855487512
2025-06-18 21:49:12,REAL,2851675342,482,2851675824,2855487994
2025-06-18 21:49:14,FAKE,2851675824,243,2851676067,2855488477
2025-06-18 21:49:16,REAL,2851676067,488,2851676555,2855488965
2025-06-18 21:49:18,REAL,2851676555,7214,2851683769,2855496179
2025-06-18 21:49:20,REAL,2851683769,13415,2851697184,2855509594
2025-06-18 21:49:22,FAKE,2851697184,243,2851697427,2855519897
2025-06-18 21:49:24,FAKE,2851697427,244,2851697671,2855530151
2025-06-18 21:49:26,REAL,2851697671,10249,2851707920,2855540400
2025-06-18 21:49:28,REAL,2851707920,10312,2851718232,2855550712
2025-06-18 21:49:30,FAKE,2851718232,244,2851718476,2855560962
2025-06-18 21:49:32,FAKE,2851718476,244,2851718720,2855571211
2025-06-18 21:49:34,FAKE,2851718720,241,2851718961,2855571759
2025-06-18 21:49:36,REAL,2851718961,477,2851719438,2855572236
2025-06-18 21:49:38,FAKE,2851719438,244,2851719682,2855572713
2025-06-18 21:49:40,REAL,2851719682,481,2851720163,2855573194
2025-06-18 21:49:42,REAL,2851720163,481,2851720644,2855573675
2025-06-18 21:49:44,REAL,2851720644,485,2851721129,2855574160
2025-06-18 21:49:46,REAL,2851721129,483,2851721612,2855574643
2025-06-18 21:49:48,FAKE,2851721612,244,2851721856,2855575121
2025-06-18 21:49:50,REAL,2851721856,6760,2851728616,2855581881
2025-06-18 21:49:52,REAL,2851728616,11766,2851740382,2855593647
2025-06-18 21:49:54,REAL,2851740382,10251,2851750633,2855603898
2025-06-18 21:49:56,REAL,2851750633,10305,2851760938,2855614203
2025-06-18 21:49:58,REAL,2851760938,10257,2851771195,2855624460
2025-06-18 21:50:00,FAKE,2851771195,243,2851771438,2855634778
2025-06-18 21:50:02,FAKE,2851771438,241,2851771679,2855645025
2025-06-18 21:50:04,FAKE,2851771679,244,2851771923,2855654754
2025-06-18 21:50:06,REAL,2851771923,480,2851772403,2855655234
2025-06-18 21:50:08,REAL,2851772403,491,2851772894,2855655725
2025-06-18 21:50:10,REAL,2851772894,479,2851773373,2855656204
2025-06-18 21:50:12,REAL,2851773373,484,2851773857,2855656688
2025-06-18 21:50:14,REAL,2851773857,479,2851774336,2855657167
2025-06-18 21:50:16,REAL,2851774336,475,2851774811,2855657642
2025-06-18 21:50:18,REAL,2851774811,483,2851775294,2855658125
2025-06-18 21:50:20,FAKE,2851775294,238,2851775532,2855658607
2025-06-18 21:50:22,REAL,2851775532,489,2851776021,2855659096
2025-06-18 21:50:24,FAKE,2851776021,244,2851776265,2855659583
2025-06-18 21:50:26,REAL,2851776265,481,2851776746,2855660064
2025-06-18 21:50:28,REAL,2851776746,486,2851777232,2855660550
2025-06-18 21:50:30,REAL,2851777232,483,2851777715,2855661033
2025-06-18 21:50:32,REAL,2851777715,598,2851778313,2855661631
2025-06-18 21:50:34,REAL,2851778313,492,2851778805,2855662123
2025-06-18 21:50:36,REAL,2851778805,477,2851779282,2855662600
2025-06-18 21:50:38,REAL,2851779282,486,2851779768,2855663086
2025-06-18 21:50:40,FAKE,2851779768,244,2851780012,2855663569
2025-06-18 21:50:42,REAL,2851780012,486,2851780498,2855664055
2025-06-18 21:50:44,REAL,2851780498,489,2851780987,2855664544
2025-06-18 21:50:46,REAL,2851780987,481,2851781468,2855665025
2025-06-18 21:50:48,REAL,2851781468,485,2851781953,2855665510
2025-06-18 21:50:50,REAL,2851781953,485,2851782438,2855665995
2025-06-18 21:50:52,REAL,2851782438,485,2851782923,2855666480
2025-06-18 21:50:54,REAL,2851782923,489,2851783412,2855666969
2025-06-18 21:50:56,REAL,2851783412,481,2851783893,2855667450
2025-06-18 21:50:58,REAL,2851783893,481,2851784374,2855667931
2025-06-18 21:51:00,FAKE,2851784374,238,2851784612,2855668416
2025-06-18 21:51:02,REAL,2851784612,483,2851785095,2855668899
2025-06-18 21:51:04,FAKE,2851785095,238,2851785333,2855669376
2025-06-18 21:51:06,FAKE,2851785333,244,2851785577,2855669865
2025-06-18 21:51:08,FAKE,2851785577,244,2851785821,2855670407
2025-06-18 21:51:10,REAL,2851785821,8683,2851794504,2855679090
2025-06-18 21:51:12,REAL,2851794504,10509,2851805013,2855689599
2025-06-18 21:51:14,REAL,2851805013,10256,2851815269,2855699855
2025-06-18 21:51:16,FAKE,2851815269,243,2851815512,2855710181
2025-06-18 21:51:18,REAL,2851815512,10252,2851825764,2855720433
2025-06-18 21:51:20,FAKE,2851825764,241,2851826005,2855730691
2025-06-18 21:51:22,REAL,2851826005,10313,2851836318,2855741004
2025-06-18 21:51:24,REAL,2851836318,8137,2851844455,2855749141
2025-06-18 21:51:26,FAKE,2851844455,238,2851844693,2855749621
2025-06-18 21:51:28,REAL,2851844693,488,2851845181,2855750109
2025-06-18 21:51:30,REAL,2851845181,479,2851845660,2855750588
2025-06-18 21:51:32,REAL,2851845660,480,2851846140,2855751068
2025-06-18 21:51:34,REAL,2851846140,479,2851846619,2855751547
2025-06-18 21:51:36,REAL,2851846619,492,2851847111,2855752039
2025-06-18 21:51:38,FAKE,2851847111,238,2851847349,2855752525
2025-06-18 21:51:40,REAL,2851847349,484,2851847833,2855753009
2025-06-18 21:51:42,FAKE,2851847833,244,2851848077,2855762140
2025-06-18 21:51:44,REAL,2851848077,10647,2851858724,2855772787
2025-06-18 21:51:46,REAL,2851858724,10252,2851868976,2855783039
2025-06-18 21:51:48,REAL,2851868976,10256,2851879232,2855793295
2025-06-18 21:51:50,REAL,2851879232,10318,2851889550,2855803613
2025-06-18 21:51:52,REAL,2851889550,10248,2851899798,2855813861
2025-06-18 21:51:54,FAKE,2851899798,238,2851900036,2855824114
2025-06-18 21:51:56,FAKE,2851900036,244,2851900280,2855831658
2025-06-18 21:51:58,FAKE,2851900280,241,2851900521,2855832148
2025-06-18 21:52:00,REAL,2851900521,474,2851900995,2855832622
2025-06-18 21:52:02,REAL,2851900995,4057,2851905052,2855836679
2025-06-18 21:52:04,REAL,2851905052,14346,2851919398,2855851025
2025-06-18 21:52:06,FAKE,2851919398,243,2851919641,2855861344
2025-06-18 21:52:08,REAL,2851919641,10320,2851929961,2855871664
2025-06-18 21:52:10,REAL,2851929961,10256,2851940217,2855881920
2025-06-18 21:52:12,REAL,2851940217,10321,2851950538,2855892241
2025-06-18 21:52:14,REAL,2851950538,10251,2851960789,2855902492
2025-06-18 21:52:16,REAL,2851960789,10252,2851971041,2855912744
2025-06-18 21:52:18,REAL,2851971041,2395,2851973436,2855915139
2025-06-18 21:52:20,FAKE,2851973436,238,2851973674,2855915617
2025-06-18 21:52:22,REAL,2851973674,484,2851974158,2855916101
2025-06-18 21:52:24,REAL,2851974158,491,2851974649,2855916592
2025-06-18 21:52:26,FAKE,2851974649,244,2851974893,2855917075
2025-06-18 21:52:28,REAL,2851974893,480,2851975373,2855917555
2025-06-18 21:52:30,REAL,2851975373,475,2851975848,2855918030
2025-06-18 21:52:32,FAKE,2851975848,244,2851976092,2855918507
2025-06-18 21:52:34,FAKE,2851976092,238,2851976330,2855923362
2025-06-18 21:52:36,FAKE,2851976330,238,2851976568,2855934620
2025-06-18 21:52:38,REAL,2851976568,10251,2851986819,2855944871
2025-06-18 21:52:40,REAL,2851986819,10324,2851997143,2855955195
2025-06-18 21:52:42,FAKE,2851997143,244,2851997387,2855965440
2025-06-18 21:52:44,REAL,2851997387,10257,2852007644,2855975697
2025-06-18 21:52:46,REAL,2852007644,10247,2852017891,2855985944
2025-06-18 21:52:48,REAL,2852017891,10315,2852028206,2855996259
2025-06-18 21:52:50,REAL,2852028206,1607,2852029813,2855997866
2025-06-18 21:52:52,REAL,2852029813,489,2852030302,2855998355
2025-06-18 21:52:54,FAKE,2852030302,238,2852030540,2855998895
2025-06-18 21:52:56,REAL,2852030540,486,2852031026,2855999381
2025-06-18 21:52:58,FAKE,2852031026,243,2852031269,2855999868
2025-06-18 21:53:00,REAL,2852031269,480,2852031749,2856000348
2025-06-18 21:53:02,REAL,2852031749,478,2852032227,2856000826
2025-06-18 21:53:04,REAL,2852032227,488,2852032715,2856001314
2025-06-18 21:53:06,REAL,2852032715,6185,2852038900,2856007499
2025-06-18 21:53:08,REAL,2852038900,13882,2852052782,2856021381
2025-06-18 21:53:10,REAL,2852052782,10316,2852063098,2856031697
2025-06-18 21:53:12,REAL,2852063098,10244,2852073342,2856041941
2025-06-18 21:53:14,REAL,2852073342,10257,2852083599,2856052198
2025-06-18 21:53:16,FAKE,2852083599,244,2852083843,2856062521
2025-06-18 21:53:18,FAKE,2852083843,244,2852084087,2856072773
2025-06-18 21:53:20,REAL,2852084087,10258,2852094345,2856083031
2025-06-18 21:53:22,REAL,2852094345,1013,2852095358,2856084044
2025-06-18 21:53:24,FAKE,2852095358,238,2852095596,2856084531
2025-06-18 21:53:26,FAKE,2852095596,243,2852095839,2856085014
2025-06-18 21:53:28,FAKE,2852095839,238,2852096077,2856085556
2025-06-18 21:53:30,REAL,2852096077,491,2852096568,2856086047
2025-06-18 21:53:32,REAL,2852096568,477,2852097045,2856086524
2025-06-18 21:53:34,REAL,2852097045,481,2852097526,2856087005
2025-06-18 21:53:36,FAKE,2852097526,241,2852097767,2856087484
2025-06-18 21:53:38,REAL,2852097767,482,2852098249,2856087966
2025-06-18 21:53:40,REAL,2852098249,479,2852098728,2856088445
2025-06-18 21:53:42,REAL,2852098728,480,2852099208,2856088925
2025-06-18 21:53:44,REAL,2852099208,489,2852099697,2856089414
2025-06-18 21:53:46,REAL,2852099697,487,2852100184,2856089901
2025-06-18 21:53:48,REAL,2852100184,533,2852100717,2856090434
2025-06-18 21:53:50,FAKE,2852100717,238,2852100955,2856090918
2025-06-18 21:53:52,REAL,2852100955,478,2852101433,2856091396
2025-06-18 21:53:54,REAL,2852101433,479,2852101912,2856091875
2025-06-18 21:53:56,FAKE,2852101912,238,2852102150,2856092357
2025-06-18 21:53:58,REAL,2852102150,484,2852102634,2856092841
2025-06-18 21:54:00,REAL,2852102634,482,2852103116,2856093323
2025-06-18 21:54:02,FAKE,2852103116,238,2852103354,2856093806
2025-06-18 21:54:04,FAKE,2852103354,241,2852103595,2856094348
2025-06-18 21:54:06,REAL,2852103595,486,2852104081,2856094834
2025-06-18 21:54:08,FAKE,2852104081,243,2852104324,2856095322
2025-06-18 21:54:10,REAL,2852104324,8083,2852112407,2856103405
2025-06-18 21:54:12,FAKE,2852112407,244,2852112651,2856116432
2025-06-18 21:54:14,REAL,2852112651,10315,2852122966,2856126747
2025-06-18 21:54:16,FAKE,2852122966,244,2852123210,2856136996
2025-06-18 21:54:18,REAL,2852123210,10256,2852133466,2856147252
2025-06-18 21:54:20,FAKE,2852133466,238,2852133704,2856157510
2025-06-18 21:54:22,FAKE,2852133704,238,2852133942,2856167829
2025-06-18 21:54:24,FAKE,2852133942,244,2852134186,2856177352
2025-06-18 21:54:26,FAKE,2852134186,238,2852134424,2856177838
2025-06-18 21:54:28,REAL,2852134424,492,2852134916,2856178330
2025-06-18 21:54:30,REAL,2852134916,480,2852135396,2856178810
2025-06-18 21:54:32,REAL,2852135396,481,2852135877,2856179291
2025-06-18 21:54:34,REAL,2852135877,491,2852136368,2856179782
2025-06-18 21:54:36,FAKE,2852136368,243,2852136611,2856180264
2025-06-18 21:54:38,REAL,2852136611,539,2852137150,2856180803
2025-06-18 21:54:40,REAL,2852137150,485,2852137635,2856181288
2025-06-18 21:54:42,REAL,2852137635,477,2852138112,2856181765
2025-06-18 21:54:44,REAL,2852138112,488,2852138600,2856182253
2025-06-18 21:54:46,REAL,2852138600,484,2852139084,2856182737
2025-06-18 21:54:48,FAKE,2852139084,238,2852139322,2856183212
2025-06-18 21:54:50,FAKE,2852139322,241,2852139563,2856183691
2025-06-18 21:54:52,REAL,2852139563,475,2852140038,2856184166
2025-06-18 21:54:54,FAKE,2852140038,243,2852140281,2856184709
2025-06-18 21:54:56,FAKE,2852140281,243,2852140524,2856185193
2025-06-18 21:54:58,REAL,2852140524,490,2852141014,2856185683
2025-06-18 21:55:00,FAKE,2852141014,243,2852141257,2856186160
2025-06-18 21:55:02,FAKE,2852141257,238,2852141495,2856186644
2025-06-18 21:55:04,REAL,2852141495,487,2852141982,2856187131
2025-06-18 21:55:06,REAL,2852141982,479,2852142461,2856187610
2025-06-18 21:55:08,REAL,2852142461,489,2852142950,2856188099
2025-06-18 21:55:10,REAL,2852142950,483,2852143433,2856188582
2025-06-18 21:55:12,FAKE,2852143433,243,2852143676,2856189129
2025-06-18 21:55:14,REAL,2852143676,478,2852144154,2856189607
2025-06-18 21:55:16,REAL,2852144154,480,2852144634,2856190087
2025-06-18 21:55:18,REAL,2852144634,489,2852145123,2856190576
2025-06-18 21:55:20,FAKE,2852145123,244,2852145367,2856191053
2025-06-18 21:55:22,REAL,2852145367,488,2852145855,2856191541
2025-06-18 21:55:24,REAL,2852145855,483,2852146338,2856192024
2025-06-18 21:55:26,REAL,2852146338,479,2852146817,2856192503
2025-06-18 21:55:28,REAL,2852146817,480,2852147297,2856192983
2025-06-18 21:55:30,REAL,2852147297,8943,2852156240,2856201926
2025-06-18 21:55:32,REAL,2852156240,10511,2852166751,2856212437
2025-06-18 21:55:34,REAL,2852166751,10327,2852177078,2856222764
2025-06-18 21:55:36,REAL,2852177078,10253,2852187331,2856233017
2025-06-18 21:55:38,FAKE,2852187331,243,2852187574,2856243267
2025-06-18 21:55:40,REAL,2852187574,10322,2852197896,2856253589
2025-06-18 21:55:42,FAKE,2852197896,241,2852198137,2856263842
2025-06-18 21:55:44,REAL,2852198137,7939,2852206076,2856271781
2025-06-18 21:55:46,REAL,2852206076,537,2852206613,2856272318
2025-06-18 21:55:48,REAL,2852206613,477,2852207090,2856272795
2025-06-18 21:55:50,REAL,2852207090,484,2852207574,2856273279
2025-06-18 21:55:52,REAL,2852207574,486,2852208060,2856273765
2025-06-18 21:55:54,REAL,2852208060,481,2852208541,2856274246
2025-06-18 21:55:56,REAL,2852208541,484,2852209025,2856274730
2025-06-18 21:55:58,REAL,2852209025,493,2852209518,2856275223
2025-06-18 21:56:00,REAL,2852209518,485,2852210003,2856275708
2025-06-18 21:56:02,REAL,2852210003,480,2852210483,2856276188
2025-06-18 21:56:04,FAKE,2852210483,238,2852210721,2856276673
2025-06-18 21:56:06,REAL,2852210721,490,2852211211,2856277163
2025-06-18 21:56:08,FAKE,2852211211,244,2852211455,2856277648
2025-06-18 21:56:10,REAL,2852211455,475,2852211930,2856278123
2025-06-18 21:56:12,REAL,2852211930,490,2852212420,2856278613
2025-06-18 21:56:14,REAL,2852212420,540,2852212960,2856279153
2025-06-18 21:56:16,REAL,2852212960,484,2852213444,2856279637
2025-06-18 21:56:18,FAKE,2852213444,243,2852213687,2856280124
2025-06-18 21:56:20,FAKE,2852213687,244,2852213931,2856280656
2025-06-18 21:56:22,REAL,2852213931,4978,2852218909,2856285634
2025-06-18 21:56:24,REAL,2852218909,13893,2852232802,2856299527
2025-06-18 21:56:26,REAL,2852232802,10311,2852243113,2856309838
2025-06-18 21:56:28,REAL,2852243113,10244,2852253357,2856320082
2025-06-18 21:56:30,REAL,2852253357,10251,2852263608,2856330333
2025-06-18 21:56:32,FAKE,2852263608,243,2852263851,2856340583
2025-06-18 21:56:34,REAL,2852263851,10253,2852274104,2856350836
2025-06-18 21:56:36,REAL,2852274104,10257,2852284361,2856361093
2025-06-18 21:56:38,REAL,2852284361,2068,2852286429,2856363161
2025-06-18 21:56:40,REAL,2852286429,491,2852286920,2856363652
2025-06-18 21:56:42,REAL,2852286920,490,2852287410,2856364142
2025-06-18 21:56:44,REAL,2852287410,10720,2852298130,2856374862
2025-06-18 21:56:46,REAL,2852298130,10448,2852308578,2856385310
2025-06-18 21:56:48,REAL,2852308578,10320,2852318898,2856395630
2025-06-18 21:56:50,FAKE,2852318898,243,2852319141,2856405878
2025-06-18 21:56:52,REAL,2852319141,10248,2852329389,2856416126
2025-06-18 21:56:54,REAL,2852329389,10242,2852339631,2856426368
2025-06-18 21:56:56,FAKE,2852339631,244,2852339875,2856436679
2025-06-18 21:56:58,FAKE,2852339875,238,2852340113,2856443366
2025-06-18 21:57:00,FAKE,2852340113,241,2852340354,2856443856
2025-06-18 21:57:02,REAL,2852340354,488,2852340842,2856444344
2025-06-18 21:57:04,REAL,2852340842,493,2852341335,2856444837
2025-06-18 21:57:06,FAKE,2852341335,244,2852341579,2856445320
2025-06-18 21:57:08,REAL,2852341579,485,2852342064,2856445805
2025-06-18 21:57:10,FAKE,2852342064,238,2852342302,2856446289
2025-06-18 21:57:12,REAL,2852342302,490,2852342792,2856446779
2025-06-18 21:57:14,REAL,2852342792,479,2852343271,2856447258
2025-06-18 21:57:16,REAL,2852343271,483,2852343754,2856447741
2025-06-18 21:57:18,FAKE,2852343754,238,2852343992,2856448225
2025-06-18 21:57:20,REAL,2852343992,483,2852344475,2856448708
2025-06-18 21:57:22,FAKE,2852344475,238,2852344713,2856449201
2025-06-18 21:57:24,REAL,2852344713,482,2852345195,2856449683
2025-06-18 21:57:26,REAL,2852345195,494,2852345689,2856450177
2025-06-18 21:57:28,REAL,2852345689,485,2852346174,2856450662
2025-06-18 21:57:30,REAL,2852346174,540,2852346714,2856451202
2025-06-18 21:57:32,FAKE,2852346714,241,2852346955,2856451736
2025-06-18 21:57:34,REAL,2852346955,475,2852347430,2856452211
2025-06-18 21:57:36,FAKE,2852347430,241,2852347671,2856452696
2025-06-18 21:57:38,REAL,2852347671,489,2852348160,2856453185
2025-06-18 21:57:40,FAKE,2852348160,244,2852348404,2856453666
2025-06-18 21:57:42,REAL,2852348404,483,2852348887,2856454149
2025-06-18 21:57:44,REAL,2852348887,482,2852349369,2856454631
2025-06-18 21:57:46,REAL,2852349369,483,2852349852,2856455114
2025-06-18 21:57:48,REAL,2852349852,483,2852350335,2856455597
2025-06-18 21:57:50,REAL,2852350335,485,2852350820,2856456082
2025-06-18 21:57:52,FAKE,2852350820,244,2852351064,2856456565
2025-06-18 21:57:54,REAL,2852351064,486,2852351550,2856457051
2025-06-18 21:57:56,REAL,2852351550,475,2852352025,2856457526
2025-06-18 21:57:58,REAL,2852352025,483,2852352508,2856458009
2025-06-18 21:58:00,REAL,2852352508,481,2852352989,2856458490
2025-06-18 21:58:02,REAL,2852352989,533,2852353522,2856459023
2025-06-18 21:58:04,REAL,2852353522,15733,2852369255,2856474756
2025-06-18 21:58:06,FAKE,2852369255,243,2852369498,2856485079
2025-06-18 21:58:08,FAKE,2852369498,244,2852369742,2856495322
2025-06-18 21:58:10,REAL,2852369742,10243,2852379985,2856505565
2025-06-18 21:58:12,REAL,2852379985,10244,2852390229,2856515809
2025-06-18 21:58:14,REAL,2852390229,10256,2852400485,2856526065
2025-06-18 21:58:16,REAL,2852400485,10325,2852410810,2856536390
2025-06-18 21:58:18,REAL,2852410810,5102,2852415912,2856541492
2025-06-18 21:58:20,FAKE,2852415912,243,2852416155,2856541978
2025-06-18 21:58:22,REAL,2852416155,481,2852416636,2856542459
2025-06-18 21:58:24,FAKE,2852416636,244,2852416880,2856542938
2025-06-18 21:58:26,REAL,2852416880,484,2852417364,2856543422
2025-06-18 21:58:28,REAL,2852417364,481,2852417845,2856543903
2025-06-18 21:58:30,REAL,2852417845,488,2852418333,2856544391
2025-06-18 21:58:32,REAL,2852418333,482,2852418815,2856544873
2025-06-18 21:58:34,FAKE,2852418815,244,2852419059,2856545362
2025-06-18 21:58:36,FAKE,2852419059,243,2852419302,2856545853
2025-06-18 21:58:38,FAKE,2852419302,244,2852419546,2856546397
2025-06-18 21:58:40,REAL,2852419546,494,2852420040,2856546891
2025-06-18 21:58:42,REAL,2852420040,482,2852420522,2856547373
2025-06-18 21:58:44,REAL,2852420522,483,2852421005,2856547856
2025-06-18 21:58:46,REAL,2852421005,476,2852421481,2856548332
2025-06-18 21:58:48,REAL,2852421481,484,2852421965,2856548816
2025-06-18 21:58:50,REAL,2852421965,481,2852422446,2856549297
2025-06-18 21:58:52,FAKE,2852422446,238,2852422684,2856549847
2025-06-18 21:58:54,REAL,2852422684,483,2852423167,2856550330
2025-06-18 21:58:56,FAKE,2852423167,243,2852423410,2856550816
2025-06-18 21:58:58,FAKE,2852423410,238,2852423648,2856551306
2025-06-18 21:59:00,FAKE,2852423648,243,2852423891,2856551789
2025-06-18 21:59:02,REAL,2852423891,480,2852424371,2856552269
2025-06-18 21:59:04,REAL,2852424371,484,2852424855,2856552753
2025-06-18 21:59:06,REAL,2852424855,485,2852425340,2856553238
2025-06-18 21:59:08,REAL,2852425340,542,2852425882,2856553780
2025-06-18 21:59:10,REAL,2852425882,475,2852426357,2856554255
2025-06-18 21:59:12,FAKE,2852426357,244,2852426601,2856554741
2025-06-18 21:59:14,FAKE,2852426601,244,2852426845,2856555231
2025-06-18 21:59:16,REAL,2852426845,481,2852427326,2856555712
2025-06-18 21:59:18,REAL,2852427326,480,2852427806,2856556192
2025-06-18 21:59:20,FAKE,2852427806,243,2852428049,2856556679
2025-06-18 21:59:22,FAKE,2852428049,238,2852428287,2856559080
2025-06-18 21:59:24,FAKE,2852428287,241,2852428528,2856574024
2025-06-18 21:59:26,REAL,2852428528,10317,2852438845,2856584341
2025-06-18 21:59:28,FAKE,2852438845,238,2852439083,2856594593
2025-06-18 21:59:30,FAKE,2852439083,243,2852439326,2856604840
2025-06-18 21:59:32,REAL,2852439326,10327,2852449653,2856615167
2025-06-18 21:59:34,FAKE,2852449653,243,2852449896,2856625425
2025-06-18 21:59:36,REAL,2852449896,10242,2852460138,2856635667
2025-06-18 21:59:38,REAL,2852460138,3644,2852463782,2856639311
2025-06-18 21:59:40,REAL,2852463782,479,2852464261,2856639790
2025-06-18 21:59:42,REAL,2852464261,481,2852464742,2856640271
2025-06-18 21:59:44,FAKE,2852464742,244,2852464986,2856640749
2025-06-18 21:59:46,FAKE,2852464986,243,2852465229,2856641231
2025-06-18 21:59:48,FAKE,2852465229,241,2852465470,2856641714
2025-06-18 21:59:50,REAL,2852465470,484,2852465954,2856642198
2025-06-18 21:59:52,FAKE,2852465954,241,2852466195,2856642685
2025-06-18 21:59:54,REAL,2852466195,484,2852466679,2856643169
2025-06-18 21:59:56,FAKE,2852466679,238,2852466917,2856643653
2025-06-18 21:59:58,REAL,2852466917,478,2852467395,2856644131
2025-06-18 22:00:00,REAL,2852467395,488,2852467883,2856644619
2025-06-18 22:00:02,FAKE,2852467883,243,2852468126,2856645112
2025-06-18 22:00:04,REAL,2852468126,490,2852468616,2856645602
2025-06-18 22:00:06,FAKE,2852468616,238,2852468854,2856646079
2025-06-18 22:00:08,REAL,2852468854,477,2852469331,2856646556
2025-06-18 22:00:10,REAL,2852469331,598,2852469929,2856647154
2025-06-18 22:00:12,FAKE,2852469929,244,2852470173,2856647642
2025-06-18 22:00:14,REAL,2852470173,481,2852470654,2856648123
2025-06-18 22:00:16,REAL,2852470654,489,2852471143,2856648612
2025-06-18 22:00:18,REAL,2852471143,492,2852471635,2856649104
2025-06-18 22:00:20,FAKE,2852471635,238,2852471873,2856649590
2025-06-18 22:00:22,REAL,2852471873,475,2852472348,2856650065
2025-06-18 22:00:24,FAKE,2852472348,243,2852472591,2856650553
2025-06-18 22:00:26,REAL,2852472591,4195,2852476786,2856654748
2025-06-18 22:00:28,FAKE,2852476786,244,2852477030,2856666069
2025-06-18 22:00:30,REAL,2852477030,10253,2852487283,2856676322
2025-06-18 22:00:32,REAL,2852487283,10243,2852497526,2856686565
2025-06-18 22:00:34,FAKE,2852497526,241,2852497767,2856696887
2025-06-18 22:00:36,REAL,2852497767,10252,2852508019,2856707139
2025-06-18 22:00:38,FAKE,2852508019,244,2852508263,2856717393
2025-06-18 22:00:40,REAL,2852508263,10305,2852518568,2856727698
2025-06-18 22:00:42,FAKE,2852518568,243,2852518811,2856729966
2025-06-18 22:00:44,REAL,2852518811,490,2852519301,2856730456
2025-06-18 22:00:46,FAKE,2852519301,238,2852519539,2856730941
2025-06-18 22:00:48,REAL,2852519539,479,2852520018,2856731420
2025-06-18 22:00:50,REAL,2852520018,485,2852520503,2856731905
2025-06-18 22:00:52,REAL,2852520503,480,2852520983,2856732385
2025-06-18 22:00:54,FAKE,2852520983,244,2852521227,2856732869
2025-06-18 22:00:56,REAL,2852521227,485,2852521712,2856733354
2025-06-18 22:00:58,REAL,2852521712,4974,2852526686,2856738328
2025-06-18 22:01:00,FAKE,2852526686,238,2852526924,2856749574
2025-06-18 22:01:02,REAL,2852526924,10256,2852537180,2856759830
2025-06-18 22:01:04,FAKE,2852537180,241,2852537421,2856770080
2025-06-18 22:01:06,REAL,2852537421,10321,2852547742,2856780401
2025-06-18 22:01:08,REAL,2852547742,10260,2852558002,2856790661
2025-06-18 22:01:10,REAL,2852558002,10303,2852568305,2856800964
2025-06-18 22:01:12,REAL,2852568305,10259,2852578564,2856811223
2025-06-18 22:01:14,REAL,2852578564,1668,2852580232,2856812891
2025-06-18 22:01:16,FAKE,2852580232,244,2852580476,2856813381
2025-06-18 22:01:18,FAKE,2852580476,241,2852580717,2856813870
2025-06-18 22:01:20,REAL,2852580717,476,2852581193,2856814346
2025-06-18 22:01:22,REAL,2852581193,484,2852581677,2856814830
2025-06-18 22:01:24,REAL,2852581677,476,2852582153,2856815306
2025-06-18 22:01:26,REAL,2852582153,486,2852582639,2856815792
2025-06-18 22:01:28,REAL,2852582639,479,2852583118,2856816271
2025-06-18 22:01:30,FAKE,2852583118,241,2852583359,2856816750
2025-06-18 22:01:32,FAKE,2852583359,243,2852583602,2856817233
2025-06-18 22:01:34,FAKE,2852583602,244,2852583846,2856817721
2025-06-18 22:01:36,FAKE,2852583846,244,2852584090,2856818206
2025-06-18 22:01:38,REAL,2852584090,485,2852584575,2856818691
2025-06-18 22:01:40,REAL,2852584575,487,2852585062,2856819178
2025-06-18 22:01:42,REAL,2852585062,543,2852585605,2856819721
2025-06-18 22:01:44,FAKE,2852585605,244,2852585849,2856820199
2025-06-18 22:01:46,REAL,2852585849,484,2852586333,2856820683
2025-06-18 22:01:48,FAKE,2852586333,238,2852586571,2856821218
2025-06-18 22:01:50,REAL,2852586571,481,2852587052,2856821699
2025-06-18 22:01:52,REAL,2852587052,491,2852587543,2856822190
2025-06-18 22:01:54,REAL,2852587543,478,2852588021,2856822668
2025-06-18 22:01:56,REAL,2852588021,481,2852588502,2856823149
2025-06-18 22:01:58,REAL,2852588502,483,2852588985,2856823632
2025-06-18 22:02:00,REAL,2852588985,475,2852589460,2856824107
2025-06-18 22:02:02,FAKE,2852589460,241,2852589701,2856830531
2025-06-18 22:02:04,FAKE,2852589701,244,2852589945,2856841575
2025-06-18 22:02:06,FAKE,2852589945,241,2852590186,2856851833
2025-06-18 22:02:08,REAL,2852590186,10248,2852600434,2856862081
2025-06-18 22:02:10,REAL,2852600434,10250,2852610684,2856872331
2025-06-18 22:02:12,REAL,2852610684,10310,2852620994,2856882641
2025-06-18 22:02:14,FAKE,2852620994,241,2852621235,2856892891
2025-06-18 22:02:16,REAL,2852621235,10190,2852631425,2856903081
2025-06-18 22:02:18,REAL,2852631425,492,2852631917,2856903573
2025-06-18 22:02:20,REAL,2852631917,484,2852632401,2856904057
2025-06-18 22:02:22,REAL,2852632401,485,2852632886,2856904542
2025-06-18 22:02:24,REAL,2852632886,487,2852633373,2856905029
2025-06-18 22:02:26,REAL,2852633373,474,2852633847,2856905503
2025-06-18 22:02:28,FAKE,2852633847,241,2852634088,2856905984
2025-06-18 22:02:30,REAL,2852634088,487,2852634575,2856906471
2025-06-18 22:02:32,REAL,2852634575,485,2852635060,2856906956
2025-06-18 22:02:34,FAKE,2852635060,241,2852635301,2856907437
2025-06-18 22:02:36,FAKE,2852635301,243,2852635544,2856907912
2025-06-18 22:02:38,REAL,2852635544,478,2852636022,2856908390
2025-06-18 22:02:40,REAL,2852636022,488,2852636510,2856908878
2025-06-18 22:02:42,REAL,2852636510,598,2852637108,2856909476
2025-06-18 22:02:44,REAL,2852637108,485,2852637593,2856909961
2025-06-18 22:02:46,REAL,2852637593,493,2852638086,2856910454
2025-06-18 22:02:48,REAL,2852638086,484,2852638570,2856910938
2025-06-18 22:02:50,REAL,2852638570,485,2852639055,2856911423
2025-06-18 22:02:52,REAL,2852639055,484,2852639539,2856911907
2025-06-18 22:02:54,REAL,2852639539,485,2852640024,2856912392
2025-06-18 22:02:56,FAKE,2852640024,241,2852640265,2856912879
2025-06-18 22:02:58,REAL,2852640265,488,2852640753,2856913367
2025-06-18 22:03:00,REAL,2852640753,475,2852641228,2856913842
2025-06-18 22:03:02,REAL,2852641228,485,2852641713,2856914327
2025-06-18 22:03:04,FAKE,2852641713,238,2852641951,2856914817
2025-06-18 22:03:06,FAKE,2852641951,241,2852642192,2856915299
2025-06-18 22:03:08,REAL,2852642192,479,2852642671,2856915778
2025-06-18 22:03:10,REAL,2852642671,2072,2852644743,2856917850
2025-06-18 22:03:12,FAKE,2852644743,244,2852644987,2856928964
2025-06-18 22:03:14,REAL,2852644987,10307,2852655294,2856939271
2025-06-18 22:03:16,REAL,2852655294,10322,2852665616,2856949593
2025-06-18 22:03:18,REAL,2852665616,10254,2852675870,2856959847
2025-06-18 22:03:20,REAL,2852675870,10242,2852686112,2856970089
2025-06-18 22:03:22,FAKE,2852686112,238,2852686350,2856980413
2025-06-18 22:03:24,REAL,2852686350,10252,2852696602,2856990665
2025-06-18 22:03:26,REAL,2852696602,3978,2852700580,2856994643
2025-06-18 22:03:28,REAL,2852700580,486,2852701066,2856995129
2025-06-18 22:03:30,REAL,2852701066,486,2852701552,2856995615
2025-06-18 22:03:32,REAL,2852701552,489,2852702041,2856996104
2025-06-18 22:03:34,REAL,2852702041,482,2852702523,2856996586
2025-06-18 22:03:36,FAKE,2852702523,243,2852702766,2856997071
2025-06-18 22:03:38,REAL,2852702766,485,2852703251,2856997556
2025-06-18 22:03:40,FAKE,2852703251,238,2852703489,2856998041
2025-06-18 22:03:42,FAKE,2852703489,241,2852703730,2857001115
2025-06-18 22:03:44,REAL,2852703730,11571,2852715301,2857012686
2025-06-18 22:03:46,REAL,2852715301,10324,2852725625,2857023010
2025-06-18 22:03:48,REAL,2852725625,10308,2852735933,2857033318
2025-06-18 22:03:50,REAL,2852735933,10252,2852746185,2857043570
2025-06-18 22:03:52,REAL,2852746185,10319,2852756504,2857053889
2025-06-18 22:03:54,REAL,2852756504,10251,2852766755,2857064140
2025-06-18 22:03:56,REAL,2852766755,10255,2852777010,2857074395
2025-06-18 22:03:58,REAL,2852777010,3392,2852780402,2857077787
2025-06-18 22:04:00,REAL,2852780402,486,2852780888,2857078273
2025-06-18 22:04:02,REAL,2852780888,479,2852781367,2857078752
2025-06-18 22:04:04,REAL,2852781367,490,2852781857,2857079242
2025-06-18 22:04:06,REAL,2852781857,477,2852782334,2857079719
2025-06-18 22:04:08,REAL,2852782334,482,2852782816,2857080201
2025-06-18 22:04:10,REAL,2852782816,488,2852783304,2857080689
2025-06-18 22:04:12,FAKE,2852783304,244,2852783548,2857081175
2025-06-18 22:04:14,FAKE,2852783548,244,2852783792,2857081658
2025-06-18 22:04:16,REAL,2852783792,489,2852784281,2857082147
2025-06-18 22:04:18,REAL,2852784281,477,2852784758,2857082624
2025-06-18 22:04:20,REAL,2852784758,481,2852785239,2857083105
2025-06-18 22:04:22,REAL,2852785239,492,2852785731,2857083597
2025-06-18 22:04:24,REAL,2852785731,598,2852786329,2857084195
2025-06-18 22:04:26,REAL,2852786329,485,2852786814,2857084680
2025-06-18 22:04:28,REAL,2852786814,479,2852787293,2857085159
2025-06-18 22:04:30,REAL,2852787293,485,2852787778,2857085644
2025-06-18 22:04:32,REAL,2852787778,493,2852788271,2857086137
2025-06-18 22:04:34,REAL,2852788271,493,2852788764,2857086630
2025-06-18 22:04:36,FAKE,2852788764,238,2852789002,2857087113
2025-06-18 22:04:38,FAKE,2852789002,243,2852789245,2857087598
2025-06-18 22:04:40,REAL,2852789245,488,2852789733,2857088086
2025-06-18 22:04:42,REAL,2852789733,487,2852790220,2857088573
2025-06-18 22:04:44,REAL,2852790220,484,2852790704,2857089057
2025-06-18 22:04:46,FAKE,2852790704,244,2852790948,2857089534
2025-06-18 22:04:48,REAL,2852790948,492,2852791440,2857090026
2025-06-18 22:04:50,REAL,2852791440,480,2852791920,2857090506
2025-06-18 22:04:52,FAKE,2852791920,241,2852792161,2857090994
2025-06-18 22:04:54,REAL,2852792161,482,2852792643,2857091476
2025-06-18 22:04:56,REAL,2852792643,487,2852793130,2857091963
2025-06-18 22:04:58,REAL,2852793130,484,2852793614,2857092447
2025-06-18 22:05:00,REAL,2852793614,545,2852794159,2857092992
2025-06-18 22:05:02,FAKE,2852794159,241,2852794400,2857093474
2025-06-18 22:05:04,REAL,2852794400,476,2852794876,2857093950
2025-06-18 22:05:06,REAL,2852794876,540,2852795416,2857094490
2025-06-18 22:05:08,REAL,2852795416,478,2852795894,2857094968
2025-06-18 22:05:10,REAL,2852795894,478,2852796372,2857095446
2025-06-18 22:05:12,REAL,2852796372,480,2852796852,2857095926
2025-06-18 22:05:14,FAKE,2852796852,238,2852797090,2857096402
2025-06-18 22:05:16,FAKE,2852797090,241,2852797331,2857096887
2025-06-18 22:05:18,FAKE,2852797331,244,2852797575,2857097371
2025-06-18 22:05:20,FAKE,2852797575,238,2852797813,2857097850
2025-06-18 22:05:22,FAKE,2852797813,238,2852798051,2857098335
2025-06-18 22:05:24,FAKE,2852798051,244,2852798295,2857112555
2025-06-18 22:05:26,REAL,2852798295,10709,2852809004,2857123264
2025-06-18 22:05:28,REAL,2852809004,10253,2852819257,2857133517
2025-06-18 22:05:30,REAL,2852819257,10321,2852829578,2857143838
2025-06-18 22:05:32,FAKE,2852829578,243,2852829821,2857154088
2025-06-18 22:05:34,REAL,2852829821,10309,2852840130,2857164397
2025-06-18 22:05:36,FAKE,2852840130,238,2852840368,2857174645
2025-06-18 22:05:38,REAL,2852840368,6364,2852846732,2857181009
2025-06-18 22:05:40,REAL,2852846732,486,2852847218,2857181495
2025-06-18 22:05:42,REAL,2852847218,479,2852847697,2857181974
2025-06-18 22:05:44,FAKE,2852847697,244,2852847941,2857182458
2025-06-18 22:05:46,REAL,2852847941,489,2852848430,2857182947
2025-06-18 22:05:48,REAL,2852848430,485,2852848915,2857183432
2025-06-18 22:05:50,REAL,2852848915,482,2852849397,2857183914
2025-06-18 22:05:52,REAL,2852849397,478,2852849875,2857184392
2025-06-18 22:05:54,FAKE,2852849875,243,2852850118,2857184874
2025-06-18 22:05:56,REAL,2852850118,481,2852850599,2857185355
2025-06-18 22:05:58,REAL,2852850599,485,2852851084,2857185840
2025-06-18 22:06:00,REAL,2852851084,482,2852851566,2857186322
2025-06-18 22:06:02,FAKE,2852851566,244,2852851810,2857186813
2025-06-18 22:06:04,REAL,2852851810,542,2852852352,2857187355
2025-06-18 22:06:06,REAL,2852852352,491,2852852843,2857187846
2025-06-18 22:06:08,REAL,2852852843,486,2852853329,2857188332
2025-06-18 22:06:10,FAKE,2852853329,243,2852853572,2857188875
2025-06-18 22:06:12,REAL,2852853572,491,2852854063,2857189366
2025-06-18 22:06:14,REAL,2852854063,483,2852854546,2857189849
2025-06-18 22:06:16,REAL,2852854546,481,2852855027,2857190330
2025-06-18 22:06:18,REAL,2852855027,489,2852855516,2857190819
2025-06-18 22:06:20,REAL,2852855516,485,2852856001,2857191304
2025-06-18 22:06:22,REAL,2852856001,478,2852856479,2857191782
2025-06-18 22:06:24,FAKE,2852856479,241,2852856720,2857192261
2025-06-18 22:06:26,FAKE,2852856720,243,2852856963,2857192747
2025-06-18 22:06:28,FAKE,2852856963,244,2852857207,2857193233
2025-06-18 22:06:30,REAL,2852857207,479,2852857686,2857193712
2025-06-18 22:06:32,REAL,2852857686,484,2852858170,2857194196
2025-06-18 22:06:34,FAKE,2852858170,238,2852858408,2857194687
2025-06-18 22:06:36,FAKE,2852858408,241,2852858649,2857195175
2025-06-18 22:06:38,REAL,2852858649,488,2852859137,2857195663
2025-06-18 22:06:40,FAKE,2852859137,241,2852859378,2857196139
2025-06-18 22:06:42,REAL,2852859378,487,2852859865,2857196626
2025-06-18 22:06:44,REAL,2852859865,482,2852860347,2857197108
2025-06-18 22:06:46,REAL,2852860347,597,2852860944,2857197705
2025-06-18 22:06:48,FAKE,2852860944,243,2852861187,2857204528
2025-06-18 22:06:50,REAL,2852861187,11035,2852872222,2857215563
2025-06-18 22:06:52,REAL,2852872222,10251,2852882473,2857225814
2025-06-18 22:06:54,REAL,2852882473,10256,2852892729,2857236070
2025-06-18 22:06:56,FAKE,2852892729,238,2852892967,2857247047
2025-06-18 22:06:58,REAL,2852892967,9528,2852902495,2857256575
2025-06-18 22:07:00,REAL,2852902495,10311,2852912806,2857266886
2025-06-18 22:07:02,FAKE,2852912806,238,2852913044,2857276542
2025-06-18 22:07:04,REAL,2852913044,483,2852913527,2857277025
2025-06-18 22:07:06,REAL,2852913527,488,2852914015,2857277513
2025-06-18 22:07:08,REAL,2852914015,481,2852914496,2857277994
2025-06-18 22:07:10,REAL,2852914496,475,2852914971,2857278469
2025-06-18 22:07:12,REAL,2852914971,489,2852915460,2857278958
2025-06-18 22:07:14,REAL,2852915460,484,2852915944,2857279442
2025-06-18 22:07:16,REAL,2852915944,478,2852916422,2857279920
2025-06-18 22:07:18,REAL,2852916422,486,2852916908,2857280406
2025-06-18 22:07:20,FAKE,2852916908,243,2852917151,2857289356
2025-06-18 22:07:22,REAL,2852917151,12227,2852929378,2857301583
2025-06-18 22:07:24,REAL,2852929378,10245,2852939623,2857311828
2025-06-18 22:07:26,REAL,2852939623,10321,2852949944,2857322149
2025-06-18 22:07:28,FAKE,2852949944,244,2852950188,2857332397
2025-06-18 22:07:30,REAL,2852950188,10259,2852960447,2857342656
2025-06-18 22:07:32,REAL,2852960447,10247,2852970694,2857352903
2025-06-18 22:07:34,FAKE,2852970694,244,2852970938,2857361962
2025-06-18 22:07:36,REAL,2852970938,485,2852971423,2857362447
2025-06-18 22:07:38,REAL,2852971423,480,2852971903,2857362927
2025-06-18 22:07:40,REAL,2852971903,484,2852972387,2857363411
2025-06-18 22:07:42,FAKE,2852972387,244,2852972631,2857363897
2025-06-18 22:07:44,REAL,2852972631,478,2852973109,2857364375
2025-06-18 22:07:46,REAL,2852973109,489,2852973598,2857364864
2025-06-18 22:07:48,REAL,2852973598,478,2852974076,2857365342
2025-06-18 22:07:50,REAL,2852974076,479,2852974555,2857365821
2025-06-18 22:07:52,FAKE,2852974555,244,2852974799,2857374367
2025-06-18 22:07:54,REAL,2852974799,10714,2852985513,2857385081
2025-06-18 22:07:56,REAL,2852985513,10257,2852995770,2857395338
2025-06-18 22:07:58,REAL,2852995770,10300,2853006070,2857405638
2025-06-18 22:08:00,REAL,2853006070,10314,2853016384,2857415952
2025-06-18 22:08:02,FAKE,2853016384,241,2853016625,2857426207
2025-06-18 22:08:04,FAKE,2853016625,243,2853016868,2857436462
2025-06-18 22:08:06,REAL,2853016868,8405,2853025273,2857444867
2025-06-18 22:08:08,FAKE,2853025273,238,2853025511,2857445353
2025-06-18 22:08:10,FAKE,2853025511,244,2853025755,2857445836
2025-06-18 22:08:12,REAL,2853025755,483,2853026238,2857446319
2025-06-18 22:08:14,REAL,2853026238,485,2853026723,2857446804
2025-06-18 22:08:16,REAL,2853026723,493,2853027216,2857447297
2025-06-18 22:08:18,FAKE,2853027216,243,2853027459,2857447779
2025-06-18 22:08:20,FAKE,2853027459,241,2853027700,2857448263
2025-06-18 22:08:22,FAKE,2853027700,238,2853027938,2857448746
2025-06-18 22:08:24,REAL,2853027938,11387,2853039325,2857460133
2025-06-18 22:08:26,REAL,2853039325,11443,2853050768,2857471576
2025-06-18 22:08:28,REAL,2853050768,10319,2853061087,2857481895
2025-06-18 22:08:30,REAL,2853061087,10250,2853071337,2857492145
2025-06-18 22:08:32,REAL,2853071337,10247,2853081584,2857502392
2025-06-18 22:08:34,REAL,2853081584,10311,2853091895,2857512703
2025-06-18 22:08:36,FAKE,2853091895,238,2853092133,2857522956
2025-06-18 22:08:38,FAKE,2853092133,238,2853092371,2857530766
2025-06-18 22:08:40,REAL,2853092371,479,2853092850,2857531245
2025-06-18 22:08:42,REAL,2853092850,483,2853093333,2857531728
2025-06-18 22:08:44,REAL,2853093333,485,2853093818,2857532213
2025-06-18 22:08:46,REAL,2853093818,489,2853094307,2857532702
2025-06-18 22:08:48,REAL,2853094307,488,2853094795,2857533190
2025-06-18 22:08:50,REAL,2853094795,485,2853095280,2857533675
2025-06-18 22:08:52,REAL,2853095280,484,2853095764,2857534159
2025-06-18 22:08:54,REAL,2853095764,491,2853096255,2857534650
2025-06-18 22:08:56,FAKE,2853096255,241,2853096496,2857535129
2025-06-18 22:08:58,REAL,2853096496,485,2853096981,2857535614
2025-06-18 22:09:00,REAL,2853096981,474,2853097455,2857536088
2025-06-18 22:09:02,REAL,2853097455,541,2853097996,2857536629
2025-06-18 22:09:04,REAL,2853097996,490,2853098486,2857537119
2025-06-18 22:09:06,FAKE,2853098486,244,2853098730,2857537594
2025-06-18 22:09:08,FAKE,2853098730,241,2853098971,2857538074
2025-06-18 22:09:10,REAL,2853098971,543,2853099514,2857538617
2025-06-18 22:09:12,REAL,2853099514,474,2853099988,2857539091
2025-06-18 22:09:14,FAKE,2853099988,243,2853100231,2857539571
2025-06-18 22:09:16,REAL,2853100231,4589,2853104820,2857544160
2025-06-18 22:09:18,REAL,2853104820,11245,2853116065,2857555405
2025-06-18 22:09:20,REAL,2853116065,10248,2853126313,2857565653
2025-06-18 22:09:22,REAL,2853126313,10243,2853136556,2857575896
2025-06-18 22:09:24,REAL,2853136556,10247,2853146803,2857586143
2025-06-18 22:09:26,REAL,2853146803,10250,2853157053,2857596393
2025-06-18 22:09:28,REAL,2853157053,10255,2853167308,2857606648
2025-06-18 22:09:30,FAKE,2853167308,243,2853167551,2857616897
2025-06-18 22:09:32,REAL,2853167551,1931,2853169482,2857618828
2025-06-18 22:09:34,FAKE,2853169482,244,2853169726,2857619304
2025-06-18 22:09:36,REAL,2853169726,490,2853170216,2857619794
2025-06-18 22:09:38,REAL,2853170216,490,2853170706,2857620284
2025-06-18 22:09:40,REAL,2853170706,483,2853171189,2857620767
2025-06-18 22:09:42,FAKE,2853171189,241,2853171430,2857621251
2025-06-18 22:09:44,REAL,2853171430,486,2853171916,2857621737
2025-06-18 22:09:46,FAKE,2853171916,243,2853172159,2857622226
2025-06-18 22:09:48,REAL,2853172159,6551,2853178710,2857628777
2025-06-18 22:09:50,REAL,2853178710,13755,2853192465,2857642532
2025-06-18 22:09:52,FAKE,2853192465,244,2853192709,2857652793
2025-06-18 22:09:54,REAL,2853192709,10012,2853202721,2857662805
2025-06-18 22:09:56,REAL,2853202721,10252,2853212973,2857673057
2025-06-18 22:09:58,REAL,2853212973,10321,2853223294,2857683378
2025-06-18 22:10:00,REAL,2853223294,10253,2853233547,2857693631
2025-06-18 22:10:02,FAKE,2853233547,241,2853233788,2857703889
2025-06-18 22:10:04,REAL,2853233788,1282,2853235070,2857705171
2025-06-18 22:10:06,REAL,2853235070,484,2853235554,2857705655
2025-06-18 22:10:08,REAL,2853235554,476,2853236030,2857706131
2025-06-18 22:10:10,REAL,2853236030,481,2853236511,2857706612
2025-06-18 22:10:12,FAKE,2853236511,243,2853236754,2857707100
2025-06-18 22:10:14,REAL,2853236754,479,2853237233,2857707579
2025-06-18 22:10:16,REAL,2853237233,484,2853237717,2857708063
2025-06-18 22:10:18,REAL,2853237717,487,2853238204,2857708550
2025-06-18 22:10:20,REAL,2853238204,488,2853238692,2857709038
2025-06-18 22:10:22,REAL,2853238692,479,2853239171,2857709517
2025-06-18 22:10:24,FAKE,2853239171,241,2853239412,2857710055
2025-06-18 22:10:26,REAL,2853239412,487,2853239899,2857710542
2025-06-18 22:10:28,REAL,2853239899,537,2853240436,2857711079
2025-06-18 22:10:30,REAL,2853240436,483,2853240919,2857711562
2025-06-18 22:10:32,FAKE,2853240919,241,2853241160,2857712040
2025-06-18 22:10:34,REAL,2853241160,485,2853241645,2857712525
2025-06-18 22:10:36,REAL,2853241645,485,2853242130,2857713010
2025-06-18 22:10:38,FAKE,2853242130,238,2853242368,2857713494
2025-06-18 22:10:40,FAKE,2853242368,238,2853242606,2857713973
2025-06-18 22:10:42,REAL,2853242606,484,2853243090,2857714457
2025-06-18 22:10:44,REAL,2853243090,486,2853243576,2857714943
2025-06-18 22:10:46,REAL,2853243576,486,2853244062,2857715429
2025-06-18 22:10:48,REAL,2853244062,485,2853244547,2857715914
2025-06-18 22:10:50,FAKE,2853244547,244,2853244791,2857716393
2025-06-18 22:10:52,REAL,2853244791,479,2853245270,2857716872
2025-06-18 22:10:54,REAL,2853245270,476,2853245746,2857717348
2025-06-18 22:10:56,FAKE,2853245746,244,2853245990,2857717824
2025-06-18 22:10:58,REAL,2853245990,482,2853246472,2857718306
2025-06-18 22:11:00,FAKE,2853246472,243,2853246715,2857718790
2025-06-18 22:11:02,REAL,2853246715,543,2853247258,2857719333
2025-06-18 22:11:04,REAL,2853247258,479,2853247737,2857719812
2025-06-18 22:11:06,REAL,2853247737,535,2853248272,2857720347
2025-06-18 22:11:08,FAKE,2853248272,238,2853248510,2857720834
2025-06-18 22:11:10,REAL,2853248510,490,2853249000,2857721324
2025-06-18 22:11:12,REAL,2853249000,476,2853249476,2857721800
2025-06-18 22:11:14,REAL,2853249476,492,2853249968,2857722292
2025-06-18 22:11:16,REAL,2853249968,483,2853250451,2857722775
2025-06-18 22:11:18,REAL,2853250451,480,2853250931,2857723255
2025-06-18 22:11:20,REAL,2853250931,474,2853251405,2857723729
2025-06-18 22:11:22,FAKE,2853251405,244,2853251649,2857724214
2025-06-18 22:11:24,REAL,2853251649,486,2853252135,2857724700
2025-06-18 22:11:26,REAL,2853252135,486,2853252621,2857725186
2025-06-18 22:11:28,FAKE,2853252621,238,2853252859,2857725666
2025-06-18 22:11:30,FAKE,2853252859,241,2853253100,2857726153
2025-06-18 22:11:32,REAL,2853253100,485,2853253585,2857726638
2025-06-18 22:11:34,FAKE,2853253585,238,2853253823,2857727119
2025-06-18 22:11:36,REAL,2853253823,484,2853254307,2857727603
2025-06-18 22:11:38,REAL,2853254307,545,2853254852,2857728148
2025-06-18 22:11:40,REAL,2853254852,481,2853255333,2857728629
2025-06-18 22:11:42,FAKE,2853255333,244,2853255577,2857729118
2025-06-18 22:11:44,REAL,2853255577,488,2853256065,2857729606
2025-06-18 22:11:46,REAL,2853256065,547,2853256612,2857730153
2025-06-18 22:11:48,REAL,2853256612,485,2853257097,2857730638
2025-06-18 22:11:50,FAKE,2853257097,244,2853257341,2857731116
2025-06-18 22:11:52,REAL,2853257341,486,2853257827,2857731602
2025-06-18 22:11:54,REAL,2853257827,1952,2853259779,2857733554
2025-06-18 22:11:56,FAKE,2853259779,241,2853260020,2857748888
2025-06-18 22:11:58,REAL,2853260020,10319,2853270339,2857759207
2025-06-18 22:12:00,FAKE,2853270339,241,2853270580,2857769461
2025-06-18 22:12:02,FAKE,2853270580,241,2853270821,2857779712
2025-06-18 22:12:04,REAL,2853270821,10256,2853281077,2857789968
2025-06-18 22:12:06,REAL,2853281077,10315,2853291392,2857800283
2025-06-18 22:12:08,FAKE,2853291392,238,2853291630,2857810534
2025-06-18 22:12:10,REAL,2853291630,3983,2853295613,2857814517
2025-06-18 22:12:12,REAL,2853295613,479,2853296092,2857814996
2025-06-18 22:12:14,FAKE,2853296092,243,2853296335,2857815526
2025-06-18 22:12:16,REAL,2853296335,486,2853296821,2857816012
2025-06-18 22:12:18,FAKE,2853296821,243,2853297064,2857816490
2025-06-18 22:12:20,REAL,2853297064,487,2853297551,2857816977
2025-06-18 22:12:22,FAKE,2853297551,244,2853297795,2857817462
2025-06-18 22:12:24,REAL,2853297795,486,2853298281,2857817948
2025-06-18 22:12:26,REAL,2853298281,2548,2853300829,2857820496
2025-06-18 22:12:28,REAL,2853300829,11703,2853312532,2857832199
2025-06-18 22:12:30,REAL,2853312532,10318,2853322850,2857842517
2025-06-18 22:12:32,REAL,2853322850,10245,2853333095,2857852762
2025-06-18 22:12:34,REAL,2853333095,10250,2853343345,2857863012
2025-06-18 22:12:36,REAL,2853343345,10321,2853353666,2857873333
2025-06-18 22:12:38,REAL,2853353666,10256,2853363922,2857883589
2025-06-18 22:12:40,REAL,2853363922,10383,2853374305,2857893972
2025-06-18 22:12:42,REAL,2853374305,3257,2853377562,2857897229
2025-06-18 22:12:44,REAL,2853377562,478,2853378040,2857897707
2025-06-18 22:12:46,REAL,2853378040,484,2853378524,2857898191
2025-06-18 22:12:48,REAL,2853378524,479,2853379003,2857898670
2025-06-18 22:12:50,REAL,2853379003,488,2853379491,2857899158
2025-06-18 22:12:52,REAL,2853379491,540,2853380031,2857899698
2025-06-18 22:12:54,REAL,2853380031,484,2853380515,2857900182
2025-06-18 22:12:56,REAL,2853380515,481,2853380996,2857900663
2025-06-18 22:12:58,REAL,2853380996,4053,2853385049,2857904716
2025-06-18 22:13:00,FAKE,2853385049,243,2853385292,2857917742
2025-06-18 22:13:02,REAL,2853385292,10244,2853395536,2857927986
2025-06-18 22:13:04,REAL,2853395536,10314,2853405850,2857938300
2025-06-18 22:13:06,REAL,2853405850,10250,2853416100,2857948550
2025-06-18 22:13:08,FAKE,2853416100,244,2853416344,2857958795
2025-06-18 22:13:10,REAL,2853416344,10318,2853426662,2857969113
2025-06-18 22:13:12,REAL,2853426662,10258,2853436920,2857979371
2025-06-18 22:13:14,FAKE,2853436920,243,2853437163,2857982168
2025-06-18 22:13:16,REAL,2853437163,482,2853437645,2857982650
2025-06-18 22:13:18,REAL,2853437645,481,2853438126,2857983131
2025-06-18 22:13:20,REAL,2853438126,485,2853438611,2857983616
2025-06-18 22:13:22,REAL,2853438611,477,2853439088,2857984093
2025-06-18 22:13:24,REAL,2853439088,485,2853439573,2857984578
2025-06-18 22:13:26,REAL,2853439573,483,2853440056,2857985061
2025-06-18 22:13:28,REAL,2853440056,489,2853440545,2857985550
2025-06-18 22:13:30,FAKE,2853440545,244,2853440789,2857990141
2025-06-18 22:13:32,REAL,2853440789,11309,2853452098,2858001450
2025-06-18 22:13:34,FAKE,2853452098,241,2853452339,2858011770
2025-06-18 22:13:36,FAKE,2853452339,238,2853452577,2858022021
2025-06-18 22:13:38,FAKE,2853452577,243,2853452820,2858032278
2025-06-18 22:13:40,REAL,2853452820,10314,2853463134,2858042592
2025-06-18 22:13:42,FAKE,2853463134,241,2853463375,2858052901
2025-06-18 22:13:44,REAL,2853463375,10251,2853473626,2858063152
2025-06-18 22:13:46,REAL,2853473626,2134,2853475760,2858065286
2025-06-18 22:13:48,REAL,2853475760,482,2853476242,2858065768
2025-06-18 22:13:50,REAL,2853476242,476,2853476718,2858066244
2025-06-18 22:13:52,REAL,2853476718,487,2853477205,2858066731
2025-06-18 22:13:54,REAL,2853477205,490,2853477695,2858067221
2025-06-18 22:13:56,REAL,2853477695,484,2853478179,2858067705
2025-06-18 22:13:58,REAL,2853478179,489,2853478668,2858068194
2025-06-18 22:14:00,REAL,2853478668,486,2853479154,2858068680
2025-06-18 22:14:02,FAKE,2853479154,243,2853479397,2858069164
2025-06-18 22:14:04,FAKE,2853479397,238,2853479635,2858069640
2025-06-18 22:14:06,REAL,2853479635,537,2853480172,2858070177
2025-06-18 22:14:08,REAL,2853480172,488,2853480660,2858070665
2025-06-18 22:14:10,REAL,2853480660,490,2853481150,2858071155
2025-06-18 22:14:12,FAKE,2853481150,238,2853481388,2858071647
2025-06-18 22:14:14,FAKE,2853481388,243,2853481631,2858072127
2025-06-18 22:14:16,REAL,2853481631,484,2853482115,2858072611
2025-06-18 22:14:18,REAL,2853482115,487,2853482602,2858073098
2025-06-18 22:14:20,REAL,2853482602,488,2853483090,2858073586
2025-06-18 22:14:22,REAL,2853483090,482,2853483572,2858074068
2025-06-18 22:14:24,REAL,2853483572,476,2853484048,2858074544
2025-06-18 22:14:26,FAKE,2853484048,241,2853484289,2858075024
2025-06-18 22:14:28,REAL,2853484289,484,2853484773,2858075508
2025-06-18 22:14:30,REAL,2853484773,485,2853485258,2858075993
2025-06-18 22:14:32,FAKE,2853485258,238,2853485496,2858076533
2025-06-18 22:14:34,REAL,2853485496,488,2853485984,2858077021
2025-06-18 22:14:36,REAL,2853485984,480,2853486464,2858077501
2025-06-18 22:14:38,REAL,2853486464,483,2853486947,2858077984
2025-06-18 22:14:40,REAL,2853486947,488,2853487435,2858078472
2025-06-18 22:14:42,REAL,2853487435,484,2853487919,2858078956
2025-06-18 22:14:44,REAL,2853487919,534,2853488453,2858079490
2025-06-18 22:14:46,REAL,2853488453,483,2853488936,2858079973
2025-06-18 22:14:48,REAL,2853488936,483,2853489419,2858080456
2025-06-18 22:14:50,REAL,2853489419,6105,2853495524,2858086561
2025-06-18 22:14:52,FAKE,2853495524,244,2853495768,2858097615
2025-06-18 22:14:54,FAKE,2853495768,243,2853496011,2858107872
2025-06-18 22:14:56,REAL,2853496011,10260,2853506271,2858118132
2025-06-18 22:14:58,FAKE,2853506271,243,2853506514,2858128455
2025-06-18 22:15:00,FAKE,2853506514,244,2853506758,2858138706
2025-06-18 22:15:02,FAKE,2853506758,243,2853507001,2858149024
2025-06-18 22:15:04,REAL,2853507001,10258,2853517259,2858159282
2025-06-18 22:15:06,REAL,2853517259,614,2853517873,2858159896
2025-06-18 22:15:08,REAL,2853517873,486,2853518359,2858160382
2025-06-18 22:15:10,REAL,2853518359,489,2853518848,2858160871
2025-06-18 22:15:12,FAKE,2853518848,243,2853519091,2858161349
2025-06-18 22:15:14,REAL,2853519091,489,2853519580,2858161838
2025-06-18 22:15:16,REAL,2853519580,483,2853520063,2858162321
2025-06-18 22:15:18,REAL,2853520063,477,2853520540,2858162798
2025-06-18 22:15:20,FAKE,2853520540,244,2853520784,2858163285
2025-06-18 22:15:22,FAKE,2853520784,238,2853521022,2858170371
2025-06-18 22:15:24,FAKE,2853521022,241,2853521263,2858181745
2025-06-18 22:15:26,REAL,2853521263,10253,2853531516,2858191998
2025-06-18 22:15:28,FAKE,2853531516,243,2853531759,2858202252
2025-06-18 22:15:30,REAL,2853531759,10321,2853542080,2858212573
2025-06-18 22:15:32,REAL,2853542080,10253,2853552333,2858222826
2025-06-18 22:15:34,REAL,2853552333,10319,2853562652,2858233145
2025-06-18 22:15:36,REAL,2853562652,9791,2853572443,2858242936
2025-06-18 22:15:38,FAKE,2853572443,243,2853572686,2858243425
2025-06-18 22:15:40,REAL,2853572686,477,2853573163,2858243902
2025-06-18 22:15:42,FAKE,2853573163,241,2853573404,2858244391
2025-06-18 22:15:44,FAKE,2853573404,244,2853573648,2858244872
2025-06-18 22:15:46,REAL,2853573648,486,2853574134,2858245358
2025-06-18 22:15:48,FAKE,2853574134,244,2853574378,2858245841
2025-06-18 22:15:50,REAL,2853574378,491,2853574869,2858246332
2025-06-18 22:15:52,REAL,2853574869,485,2853575354,2858246817
2025-06-18 22:15:54,REAL,2853575354,480,2853575834,2858247297
2025-06-18 22:15:56,REAL,2853575834,485,2853576319,2858247782
2025-06-18 22:15:58,FAKE,2853576319,244,2853576563,2858248272
2025-06-18 22:16:00,REAL,2853576563,533,2853577096,2858248805
2025-06-18 22:16:02,REAL,2853577096,488,2853577584,2858249293
2025-06-18 22:16:04,REAL,2853577584,480,2853578064,2858249773
2025-06-18 22:16:06,REAL,2853578064,487,2853578551,2858250260
2025-06-18 22:16:08,REAL,2853578551,481,2853579032,2858250741
2025-06-18 22:16:10,REAL,2853579032,484,2853579516,2858251225
2025-06-18 22:16:12,REAL,2853579516,483,2853579999,2858251708
2025-06-18 22:16:14,FAKE,2853579999,244,2853580243,2858252249
2025-06-18 22:16:16,FAKE,2853580243,244,2853580487,2858252734
2025-06-18 22:16:18,REAL,2853580487,484,2853580971,2858253218
2025-06-18 22:16:20,REAL,2853580971,486,2853581457,2858253704
2025-06-18 22:16:22,FAKE,2853581457,244,2853581701,2858254184
2025-06-18 22:16:24,FAKE,2853581701,238,2853581939,2858254668
2025-06-18 22:16:26,REAL,2853581939,8215,2853590154,2858262883
2025-06-18 22:16:28,FAKE,2853590154,238,2853590392,2858273339
2025-06-18 22:16:30,REAL,2853590392,10320,2853600712,2858283659
2025-06-18 22:16:32,REAL,2853600712,10253,2853610965,2858293912
2025-06-18 22:16:34,FAKE,2853610965,238,2853611203,2858304165
2025-06-18 22:16:36,REAL,2853611203,10250,2853621453,2858314415
2025-06-18 22:16:38,REAL,2853621453,10317,2853631770,2858324732
2025-06-18 22:16:40,REAL,2853631770,8466,2853640236,2858333198
2025-06-18 22:16:42,FAKE,2853640236,243,2853640479,2858333689
2025-06-18 22:16:44,REAL,2853640479,482,2853640961,2858334171
2025-06-18 22:16:46,REAL,2853640961,481,2853641442,2858334652
2025-06-18 22:16:48,REAL,2853641442,483,2853641925,2858335135
2025-06-18 22:16:50,FAKE,2853641925,238,2853642163,2858335623
2025-06-18 22:16:52,FAKE,2853642163,243,2853642406,2858336108
2025-06-18 22:16:54,FAKE,2853642406,243,2853642649,2858336587
2025-06-18 22:16:56,FAKE,2853642649,243,2853642892,2858337071
2025-06-18 22:16:58,REAL,2853642892,9080,2853651972,2858346151
2025-06-18 22:17:00,REAL,2853651972,10648,2853662620,2858356799
2025-06-18 22:17:02,FAKE,2853662620,238,2853662858,2858367119
2025-06-18 22:17:04,REAL,2853662858,10246,2853673104,2858377365
2025-06-18 22:17:06,FAKE,2853673104,244,2853673348,2858387683
2025-06-18 22:17:08,FAKE,2853673348,244,2853673592,2858398006
2025-06-18 22:17:10,FAKE,2853673592,241,2853673833,2858408256
2025-06-18 22:17:12,REAL,2853673833,7802,2853681635,2858416058
2025-06-18 22:17:14,FAKE,2853681635,241,2853681876,2858416538
2025-06-18 22:17:16,FAKE,2853681876,244,2853682120,2858417020
2025-06-18 22:17:18,REAL,2853682120,486,2853682606,2858417506
2025-06-18 22:17:20,REAL,2853682606,486,2853683092,2858417992
2025-06-18 22:17:22,REAL,2853683092,487,2853683579,2858418479
2025-06-18 22:17:24,REAL,2853683579,490,2853684069,2858418969
2025-06-18 22:17:26,REAL,2853684069,489,2853684558,2858419458
2025-06-18 22:17:28,FAKE,2853684558,244,2853684802,2858419937
2025-06-18 22:17:30,REAL,2853684802,484,2853685286,2858420421
2025-06-18 22:17:32,FAKE,2853685286,244,2853685530,2858420906
2025-06-18 22:17:34,REAL,2853685530,489,2853686019,2858421395
2025-06-18 22:17:36,FAKE,2853686019,244,2853686263,2858421878
2025-06-18 22:17:38,FAKE,2853686263,238,2853686501,2858422419
2025-06-18 22:17:40,FAKE,2853686501,244,2853686745,2858422909
2025-06-18 22:17:42,FAKE,2853686745,243,2853686988,2858423397
2025-06-18 22:17:44,REAL,2853686988,481,2853687469,2858423878
2025-06-18 22:17:46,FAKE,2853687469,241,2853687710,2858424369
2025-06-18 22:17:48,FAKE,2853687710,244,2853687954,2858424855
2025-06-18 22:17:50,FAKE,2853687954,244,2853688198,2858425345
2025-06-18 22:17:52,REAL,2853688198,483,2853688681,2858425828
2025-06-18 22:17:54,FAKE,2853688681,244,2853688925,2858426311
2025-06-18 22:17:56,REAL,2853688925,545,2853689470,2858426856
2025-06-18 22:17:58,REAL,2853689470,488,2853689958,2858427344
2025-06-18 22:18:00,FAKE,2853689958,243,2853690201,2858427831
2025-06-18 22:18:02,REAL,2853690201,485,2853690686,2858428316
2025-06-18 22:18:04,FAKE,2853690686,238,2853690924,2858428797
2025-06-18 22:18:06,FAKE,2853690924,243,2853691167,2858429289
2025-06-18 22:18:08,REAL,2853691167,487,2853691654,2858429776
2025-06-18 22:18:10,REAL,2853691654,479,2853692133,2858430255
2025-06-18 22:18:12,FAKE,2853692133,243,2853692376,2858430746
2025-06-18 22:18:14,REAL,2853692376,484,2853692860,2858431230
2025-06-18 22:18:16,REAL,2853692860,491,2853693351,2858431721
2025-06-18 22:18:18,REAL,2853693351,531,2853693882,2858432252
2025-06-18 22:18:20,REAL,2853693882,483,2853694365,2858432735
2025-06-18 22:18:22,FAKE,2853694365,241,2853694606,2858433224
2025-06-18 22:18:24,REAL,2853694606,480,2853695086,2858433704
2025-06-18 22:18:26,REAL,2853695086,484,2853695570,2858434188
2025-06-18 22:18:28,FAKE,2853695570,238,2853695808,2858434670
2025-06-18 22:18:30,FAKE,2853695808,244,2853696052,2858435160
2025-06-18 22:18:32,REAL,2853696052,489,2853696541,2858435649
2025-06-18 22:18:34,REAL,2853696541,492,2853697033,2858436141
2025-06-18 22:18:36,REAL,2853697033,480,2853697513,2858436621
2025-06-18 22:18:38,REAL,2853697513,481,2853697994,2858437102
2025-06-18 22:18:40,REAL,2853697994,484,2853698478,2858437586
2025-06-18 22:18:42,REAL,2853698478,481,2853698959,2858438067
2025-06-18 22:18:44,REAL,2853698959,483,2853699442,2858438550
2025-06-18 22:18:46,REAL,2853699442,474,2853699916,2858439024
2025-06-18 22:18:48,REAL,2853699916,537,2853700453,2858439561
2025-06-18 22:18:50,REAL,2853700453,488,2853700941,2858440049
2025-06-18 22:18:52,REAL,2853700941,480,2853701421,2858440529
2025-06-18 22:18:54,FAKE,2853701421,238,2853701659,2858441020
2025-06-18 22:18:56,FAKE,2853701659,238,2853701897,2858441507
2025-06-18 22:18:58,REAL,2853701897,485,2853702382,2858441992
2025-06-18 22:19:00,FAKE,2853702382,244,2853702626,2858442535
2025-06-18 22:19:02,FAKE,2853702626,243,2853702869,2858443022
2025-06-18 22:19:04,REAL,2853702869,485,2853703354,2858443507
2025-06-18 22:19:06,REAL,2853703354,487,2853703841,2858443994
2025-06-18 22:19:08,REAL,2853703841,478,2853704319,2858444472
2025-06-18 22:19:10,FAKE,2853704319,238,2853704557,2858444958
2025-06-18 22:19:12,FAKE,2853704557,238,2853704795,2858445447
2025-06-18 22:19:14,FAKE,2853704795,244,2853705039,2858445935
2025-06-18 22:19:16,FAKE,2853705039,238,2853705277,2858446426
2025-06-18 22:19:18,FAKE,2853705277,244,2853705521,2858446917
2025-06-18 22:19:20,REAL,2853705521,490,2853706011,2858447407
2025-06-18 22:19:22,REAL,2853706011,486,2853706497,2858447893
2025-06-18 22:19:24,FAKE,2853706497,241,2853706738,2858448370
2025-06-18 22:19:26,REAL,2853706738,544,2853707282,2858448914
2025-06-18 22:19:28,REAL,2853707282,485,2853707767,2858449399
2025-06-18 22:19:30,REAL,2853707767,482,2853708249,2858449881
2025-06-18 22:19:32,FAKE,2853708249,244,2853708493,2858450367
2025-06-18 22:19:34,FAKE,2853708493,243,2853708736,2858450847
2025-06-18 22:19:36,REAL,2853708736,481,2853709217,2858451328
2025-06-18 22:19:38,FAKE,2853709217,238,2853709455,2858451812
2025-06-18 22:19:40,REAL,2853709455,547,2853710002,2858452359
2025-06-18 22:19:42,REAL,2853710002,482,2853710484,2858452841
2025-06-18 22:19:44,FAKE,2853710484,238,2853710722,2858453328
2025-06-18 22:19:46,REAL,2853710722,477,2853711199,2858453805
2025-06-18 22:19:48,REAL,2853711199,484,2853711683,2858454289
2025-06-18 22:19:50,REAL,2853711683,489,2853712172,2858454778
2025-06-18 22:19:52,REAL,2853712172,476,2853712648,2858455254
2025-06-18 22:19:54,FAKE,2853712648,244,2853712892,2858455744
2025-06-18 22:19:56,REAL,2853712892,488,2853713380,2858456232
2025-06-18 22:19:58,FAKE,2853713380,243,2853713623,2858456718
2025-06-18 22:20:00,REAL,2853713623,489,2853714112,2858457207
2025-06-18 22:20:02,REAL,2853714112,1281,2853715393,2858458488
2025-06-18 22:20:04,FAKE,2853715393,243,2853715636,2858473490
2025-06-18 22:20:06,REAL,2853715636,10370,2853726006,2858483860
2025-06-18 22:20:08,REAL,2853726006,10252,2853736258,2858494112
2025-06-18 22:20:10,REAL,2853736258,10256,2853746514,2858504368
2025-06-18 22:20:12,REAL,2853746514,10248,2853756762,2858514616
2025-06-18 22:20:14,REAL,2853756762,10324,2853767086,2858524940
2025-06-18 22:20:16,FAKE,2853767086,241,2853767327,2858535192
2025-06-18 22:20:18,FAKE,2853767327,244,2853767571,2858539642
2025-06-18 22:20:20,FAKE,2853767571,243,2853767814,2858540122
2025-06-18 22:20:22,REAL,2853767814,483,2853768297,2858540605
2025-06-18 22:20:24,REAL,2853768297,9406,2853777703,2858550011
2025-06-18 22:20:26,REAL,2853777703,12171,2853789874,2858562182
2025-06-18 22:20:28,FAKE,2853789874,244,2853790118,2858572434
2025-06-18 22:20:30,FAKE,2853790118,244,2853790362,2858582756
2025-06-18 22:20:32,FAKE,2853790362,241,2853790603,2858593010
2025-06-18 22:20:34,REAL,2853790603,10259,2853800862,2858603269
2025-06-18 22:20:36,REAL,2853800862,10319,2853811181,2858613588
2025-06-18 22:20:38,REAL,2853811181,8995,2853820176,2858622583
2025-06-18 22:20:40,REAL,2853820176,488,2853820664,2858623071
2025-06-18 22:20:42,REAL,2853820664,484,2853821148,2858623555
2025-06-18 22:20:44,REAL,2853821148,484,2853821632,2858624039
2025-06-18 22:20:46,REAL,2853821632,541,2853822173,2858624580
2025-06-18 22:20:48,REAL,2853822173,488,2853822661,2858625068
2025-06-18 22:20:50,FAKE,2853822661,244,2853822905,2858625550
2025-06-18 22:20:52,REAL,2853822905,487,2853823392,2858626037
2025-06-18 22:20:54,REAL,2853823392,479,2853823871,2858626516
2025-06-18 22:20:56,FAKE,2853823871,244,2853824115,2858626998
2025-06-18 22:20:58,REAL,2853824115,484,2853824599,2858627482
2025-06-18 22:21:00,REAL,2853824599,487,2853825086,2858627969
2025-06-18 22:21:02,REAL,2853825086,483,2853825569,2858628452
2025-06-18 22:21:04,REAL,2853825569,545,2853826114,2858628997
2025-06-18 22:21:06,FAKE,2853826114,244,2853826358,2858629477
2025-06-18 22:21:08,FAKE,2853826358,244,2853826602,2858629961
2025-06-18 22:21:10,REAL,2853826602,486,2853827088,2858630447
2025-06-18 22:21:12,REAL,2853827088,486,2853827574,2858630933
2025-06-18 22:21:14,FAKE,2853827574,238,2853827812,2858631423
2025-06-18 22:21:16,REAL,2853827812,2926,2853830738,2858634349
2025-06-18 22:21:18,FAKE,2853830738,243,2853830981,2858645521
2025-06-18 22:21:20,REAL,2853830981,10261,2853841242,2858655782
2025-06-18 22:21:22,REAL,2853841242,10254,2853851496,2858666036
2025-06-18 22:21:24,REAL,2853851496,10252,2853861748,2858676288
2025-06-18 22:21:26,REAL,2853861748,10311,2853872059,2858686599
2025-06-18 22:21:28,REAL,2853872059,10307,2853882366,2858696906
2025-06-18 22:21:30,REAL,2853882366,10251,2853892617,2858707157
2025-06-18 22:21:32,REAL,2853892617,3125,2853895742,2858710282
2025-06-18 22:21:34,REAL,2853895742,489,2853896231,2858710771
2025-06-18 22:21:36,REAL,2853896231,477,2853896708,2858711248
2025-06-18 22:21:38,FAKE,2853896708,238,2853896946,2858711732
2025-06-18 22:21:40,REAL,2853896946,479,2853897425,2858712211
2025-06-18 22:21:42,FAKE,2853897425,241,2853897666,2858712691
2025-06-18 22:21:44,REAL,2853897666,481,2853898147,2858713172
2025-06-18 22:21:46,REAL,2853898147,485,2853898632,2858713657
2025-06-18 22:21:48,REAL,2853898632,4324,2853902956,2858717981
2025-06-18 22:21:50,REAL,2853902956,11713,2853914669,2858729694
2025-06-18 22:21:52,FAKE,2853914669,238,2853914907,2858739950
2025-06-18 22:21:54,REAL,2853914907,10256,2853925163,2858750206
2025-06-18 22:21:56,REAL,2853925163,10320,2853935483,2858760526
2025-06-18 22:21:58,FAKE,2853935483,241,2853935724,2858770772
2025-06-18 22:22:00,REAL,2853935724,10251,2853945975,2858781023
2025-06-18 22:22:02,REAL,2853945975,10247,2853956222,2858791270
2025-06-18 22:22:04,FAKE,2853956222,243,2853956465,2858793801
2025-06-18 22:22:06,REAL,2853956465,483,2853956948,2858794284
2025-06-18 22:22:08,REAL,2853956948,531,2853957479,2858794815
2025-06-18 22:22:10,REAL,2853957479,481,2853957960,2858795296
2025-06-18 22:22:12,REAL,2853957960,479,2853958439,2858795775
2025-06-18 22:22:14,REAL,2853958439,481,2853958920,2858796256
2025-06-18 22:22:16,FAKE,2853958920,243,2853959163,2858796736
2025-06-18 22:22:18,REAL,2853959163,478,2853959641,2858797214
2025-06-18 22:22:20,FAKE,2853959641,238,2853959879,2858801923
2025-06-18 22:22:22,REAL,2853959879,14547,2853974426,2858816470
2025-06-18 22:22:24,REAL,2853974426,10309,2853984735,2858826779
2025-06-18 22:22:26,REAL,2853984735,10253,2853994988,2858837032
2025-06-18 22:22:28,REAL,2853994988,10317,2854005305,2858847349
2025-06-18 22:22:30,REAL,2854005305,10252,2854015557,2858857601
2025-06-18 22:22:32,REAL,2854015557,10316,2854025873,2858867917
2025-06-18 22:22:34,FAKE,2854025873,244,2854026117,2858878178
2025-06-18 22:22:36,FAKE,2854026117,241,2854026358,2858880043
2025-06-18 22:22:38,FAKE,2854026358,238,2854026596,2858880525
2025-06-18 22:22:40,REAL,2854026596,492,2854027088,2858881017
2025-06-18 22:22:42,REAL,2854027088,481,2854027569,2858881498
2025-06-18 22:22:44,REAL,2854027569,484,2854028053,2858881982
2025-06-18 22:22:46,REAL,2854028053,490,2854028543,2858882472
2025-06-18 22:22:48,REAL,2854028543,547,2854029090,2858883019
2025-06-18 22:22:50,FAKE,2854029090,244,2854029334,2858883499
2025-06-18 22:22:52,REAL,2854029334,482,2854029816,2858883981
2025-06-18 22:22:54,FAKE,2854029816,244,2854030060,2858884463
2025-06-18 22:22:56,FAKE,2854030060,238,2854030298,2858884999
2025-06-18 22:22:58,REAL,2854030298,481,2854030779,2858885480
2025-06-18 22:23:00,REAL,2854030779,486,2854031265,2858885966
2025-06-18 22:23:02,REAL,2854031265,476,2854031741,2858886442
2025-06-18 22:23:04,FAKE,2854031741,238,2854031979,2858886932
2025-06-18 22:23:06,REAL,2854031979,487,2854032466,2858887419
2025-06-18 22:23:08,REAL,2854032466,476,2854032942,2858887895
2025-06-18 22:23:10,FAKE,2854032942,243,2854033185,2858888374
2025-06-18 22:23:12,REAL,2854033185,489,2854033674,2858888863
2025-06-18 22:23:14,FAKE,2854033674,244,2854033918,2858889347
2025-06-18 22:23:16,REAL,2854033918,477,2854034395,2858889824
2025-06-18 22:23:18,FAKE,2854034395,244,2854034639,2858890307
2025-06-18 22:23:20,REAL,2854034639,489,2854035128,2858890796
2025-06-18 22:23:22,REAL,2854035128,483,2854035611,2858891279
2025-06-18 22:23:24,REAL,2854035611,489,2854036100,2858891768
2025-06-18 22:23:26,FAKE,2854036100,241,2854036341,2858892249
2025-06-18 22:23:28,FAKE,2854036341,241,2854036582,2858892788
2025-06-18 22:23:30,REAL,2854036582,478,2854037060,2858893266
2025-06-18 22:23:32,FAKE,2854037060,238,2854037298,2858893756
2025-06-18 22:23:34,REAL,2854037298,540,2854037838,2858894296
2025-06-18 22:23:36,REAL,2854037838,481,2854038319,2858894777
2025-06-18 22:23:38,REAL,2854038319,494,2854038813,2858895271
2025-06-18 22:23:40,FAKE,2854038813,238,2854039051,2858901703
2025-06-18 22:23:42,REAL,2854039051,11236,2854050287,2858912939
2025-06-18 22:23:44,REAL,2854050287,10251,2854060538,2858923190
2025-06-18 22:23:46,REAL,2854060538,10244,2854070782,2858933434
2025-06-18 22:23:48,REAL,2854070782,10317,2854081099,2858943751
2025-06-18 22:23:50,REAL,2854081099,10252,2854091351,2858954003
2025-06-18 22:23:52,REAL,2854091351,10249,2854101600,2858964252
2025-06-18 22:23:54,REAL,2854101600,10126,2854111726,2858974378
2025-06-18 22:23:56,REAL,2854111726,490,2854112216,2858974868
2025-06-18 22:23:58,FAKE,2854112216,244,2854112460,2858975345
2025-06-18 22:24:00,FAKE,2854112460,243,2854112703,2858975892
2025-06-18 22:24:02,FAKE,2854112703,241,2854112944,2858976381
2025-06-18 22:24:04,REAL,2854112944,485,2854113429,2858976866
2025-06-18 22:24:06,FAKE,2854113429,238,2854113667,2858977356
2025-06-18 22:24:08,FAKE,2854113667,244,2854113911,2858977842
2025-06-18 22:24:10,REAL,2854113911,483,2854114394,2858978325
2025-06-18 22:24:12,REAL,2854114394,7633,2854122027,2858985958
2025-06-18 22:24:14,REAL,2854122027,10588,2854132615,2858996546
2025-06-18 22:24:16,REAL,2854132615,10259,2854142874,2859006805
2025-06-18 22:24:18,REAL,2854142874,10252,2854153126,2859017057
2025-06-18 22:24:20,FAKE,2854153126,241,2854153367,2859027308
2025-06-18 22:24:22,REAL,2854153367,10250,2854163617,2859037558
2025-06-18 22:24:24,REAL,2854163617,10320,2854173937,2859047878
2025-06-18 22:24:26,REAL,2854173937,9457,2854183394,2859057335
2025-06-18 22:24:28,REAL,2854183394,482,2854183876,2859057817
2025-06-18 22:24:30,FAKE,2854183876,244,2854184120,2859058350
2025-06-18 22:24:32,REAL,2854184120,483,2854184603,2859058833
2025-06-18 22:24:34,REAL,2854184603,485,2854185088,2859059318
2025-06-18 22:24:36,FAKE,2854185088,241,2854185329,2859059795
2025-06-18 22:24:38,REAL,2854185329,484,2854185813,2859060279
2025-06-18 22:24:40,REAL,2854185813,483,2854186296,2859060762
2025-06-18 22:24:42,REAL,2854186296,480,2854186776,2859061242
2025-06-18 22:24:44,REAL,2854186776,8084,2854194860,2859069326
2025-06-18 22:24:46,REAL,2854194860,11038,2854205898,2859080364
2025-06-18 22:24:48,FAKE,2854205898,238,2854206136,2859090616
2025-06-18 22:24:50,REAL,2854206136,10251,2854216387,2859100867
2025-06-18 22:24:52,REAL,2854216387,10249,2854226636,2859111116
2025-06-18 22:24:54,REAL,2854226636,10318,2854236954,2859121434
2025-06-18 22:24:56,REAL,2854236954,10244,2854247198,2859131678
2025-06-18 22:24:58,FAKE,2854247198,238,2854247436,2859140477
2025-06-18 22:25:00,REAL,2854247436,532,2854247968,2859141009
2025-06-18 22:25:02,FAKE,2854247968,243,2854248211,2859141487
2025-06-18 22:25:04,FAKE,2854248211,241,2854248452,2859141968
2025-06-18 22:25:06,REAL,2854248452,484,2854248936,2859142452
2025-06-18 22:25:08,REAL,2854248936,479,2854249415,2859142931
2025-06-18 22:25:10,REAL,2854249415,485,2854249900,2859143416
2025-06-18 22:25:12,FAKE,2854249900,238,2854250138,2859143899
2025-06-18 22:25:14,FAKE,2854250138,241,2854250379,2859144384
2025-06-18 22:25:16,REAL,2854250379,8083,2854258462,2859152467
2025-06-18 22:25:18,FAKE,2854258462,244,2854258706,2859163320
2025-06-18 22:25:20,FAKE,2854258706,244,2854258950,2859173576
2025-06-18 22:25:22,FAKE,2854258950,241,2854259191,2859183900
2025-06-18 22:25:24,FAKE,2854259191,241,2854259432,2859194149
2025-06-18 22:25:26,FAKE,2854259432,241,2854259673,2859204406
2025-06-18 22:25:28,REAL,2854259673,10250,2854269923,2859214656
2025-06-18 22:25:30,REAL,2854269923,8209,2854278132,2859222865
2025-06-18 22:25:32,REAL,2854278132,532,2854278664,2859223397
2025-06-18 22:25:34,REAL,2854278664,490,2854279154,2859223887
2025-06-18 22:25:36,REAL,2854279154,484,2854279638,2859224371
2025-06-18 22:25:38,REAL,2854279638,490,2854280128,2859224861
2025-06-18 22:25:40,FAKE,2854280128,238,2854280366,2859225345
2025-06-18 22:25:42,REAL,2854280366,487,2854280853,2859225832
2025-06-18 22:25:44,REAL,2854280853,485,2854281338,2859226317
2025-06-18 22:25:46,REAL,2854281338,482,2854281820,2859226799
2025-06-18 22:25:48,REAL,2854281820,479,2854282299,2859227278
2025-06-18 22:25:50,REAL,2854282299,485,2854282784,2859227763
2025-06-18 22:25:52,REAL,2854282784,540,2854283324,2859228303
2025-06-18 22:25:54,REAL,2854283324,479,2854283803,2859228782
2025-06-18 22:25:56,REAL,2854283803,478,2854284281,2859229260
2025-06-18 22:25:58,REAL,2854284281,488,2854284769,2859229748
2025-06-18 22:26:00,FAKE,2854284769,238,2854285007,2859230225
2025-06-18 22:26:02,FAKE,2854285007,238,2854285245,2859230767
2025-06-18 22:26:04,REAL,2854285245,489,2854285734,2859231256
2025-06-18 22:26:06,REAL,2854285734,490,2854286224,2859231746
2025-06-18 22:26:08,REAL,2854286224,485,2854286709,2859232231
2025-06-18 22:26:10,REAL,2854286709,478,2854287187,2859232709
2025-06-18 22:26:12,FAKE,2854287187,244,2854287431,2859233193
2025-06-18 22:26:14,REAL,2854287431,483,2854287914,2859233676
2025-06-18 22:26:16,FAKE,2854287914,244,2854288158,2859234162
2025-06-18 22:26:18,REAL,2854288158,483,2854288641,2859234645
2025-06-18 22:26:20,FAKE,2854288641,241,2854288882,2859246946
2025-06-18 22:26:22,REAL,2854288882,11237,2854300119,2859258183
2025-06-18 22:26:24,REAL,2854300119,10324,2854310443,2859268507
2025-06-18 22:26:26,FAKE,2854310443,241,2854310684,2859278756
2025-06-18 22:26:28,REAL,2854310684,10259,2854320943,2859289015
2025-06-18 22:26:30,REAL,2854320943,10311,2854331254,2859299326
2025-06-18 22:26:32,FAKE,2854331254,238,2854331492,2859309574
2025-06-18 22:26:34,REAL,2854331492,7008,2854338500,2859316582
2025-06-18 22:26:36,FAKE,2854338500,243,2854338743,2859317068
2025-06-18 22:26:38,REAL,2854338743,485,2854339228,2859317553
2025-06-18 22:26:40,REAL,2854339228,474,2854339702,2859318027
2025-06-18 22:26:42,REAL,2854339702,481,2854340183,2859318508
2025-06-18 22:26:44,REAL,2854340183,475,2854340658,2859318983
2025-06-18 22:26:46,REAL,2854340658,493,2854341151,2859319476
2025-06-18 22:26:48,REAL,2854341151,484,2854341635,2859319960
2025-06-18 22:26:50,FAKE,2854341635,243,2854341878,2859320444
2025-06-18 22:26:52,REAL,2854341878,242,2854342120,2859320686
2025-06-18 22:26:54,FAKE,2854342120,243,2854342363,2859321225
2025-06-18 22:26:56,FAKE,2854342363,241,2854342604,2859321703
2025-06-18 22:26:58,REAL,2854342604,484,2854343088,2859322187
2025-06-18 22:27:00,FAKE,2854343088,244,2854343332,2859322667
2025-06-18 22:27:02,REAL,2854343332,488,2854343820,2859323155
2025-06-18 22:27:04,REAL,2854343820,546,2854344366,2859323701
2025-06-18 22:27:06,REAL,2854344366,483,2854344849,2859324184
2025-06-18 22:27:08,REAL,2854344849,484,2854345333,2859324668
2025-06-18 22:27:10,REAL,2854345333,480,2854345813,2859325148
2025-06-18 22:27:12,REAL,2854345813,492,2854346305,2859325640
2025-06-18 22:27:14,REAL,2854346305,489,2854346794,2859326129
2025-06-18 22:27:16,FAKE,2854346794,244,2854347038,2859326619
2025-06-18 22:27:18,REAL,2854347038,483,2854347521,2859327102
2025-06-18 22:27:20,REAL,2854347521,475,2854347996,2859327577
2025-06-18 22:27:22,FAKE,2854347996,241,2854348237,2859328064
2025-06-18 22:27:24,REAL,2854348237,14434,2854362671,2859342498
2025-06-18 22:27:26,FAKE,2854362671,241,2854362912,2859352747
2025-06-18 22:27:28,REAL,2854362912,10320,2854373232,2859363067
2025-06-18 22:27:30,FAKE,2854373232,244,2854373476,2859373324
2025-06-18 22:27:32,REAL,2854373476,10319,2854383795,2859383643
2025-06-18 22:27:34,FAKE,2854383795,244,2854384039,2859393949
2025-06-18 22:27:36,FAKE,2854384039,244,2854384283,2859404201
2025-06-18 22:27:38,REAL,2854384283,5760,2854390043,2859409961
2025-06-18 22:27:40,REAL,2854390043,488,2854390531,2859410449
2025-06-18 22:27:42,FAKE,2854390531,238,2854390769,2859410934
2025-06-18 22:27:44,REAL,2854390769,493,2854391262,2859411427
2025-06-18 22:27:46,FAKE,2854391262,241,2854391503,2859411912
2025-06-18 22:27:48,REAL,2854391503,480,2854391983,2859412392
2025-06-18 22:27:50,REAL,2854391983,484,2854392467,2859412876
2025-06-18 22:27:52,REAL,2854392467,539,2854393006,2859413415
2025-06-18 22:27:54,FAKE,2854393006,241,2854393247,2859413896
2025-06-18 22:27:56,REAL,2854393247,491,2854393738,2859414387
2025-06-18 22:27:58,REAL,2854393738,491,2854394229,2859414878
2025-06-18 22:28:00,REAL,2854394229,480,2854394709,2859415358
2025-06-18 22:28:02,REAL,2854394709,488,2854395197,2859415846
2025-06-18 22:28:04,REAL,2854395197,486,2854395683,2859416332
2025-06-18 22:28:06,FAKE,2854395683,241,2854395924,2859416864
2025-06-18 22:28:08,FAKE,2854395924,244,2854396168,2859417353
2025-06-18 22:28:10,REAL,2854396168,475,2854396643,2859417828
2025-06-18 22:28:12,REAL,2854396643,493,2854397136,2859418321
2025-06-18 22:28:14,FAKE,2854397136,241,2854397377,2859418797
2025-06-18 22:28:16,REAL,2854397377,489,2854397866,2859419286
2025-06-18 22:28:18,REAL,2854397866,478,2854398344,2859419764
2025-06-18 22:28:20,FAKE,2854398344,238,2854398582,2859420307
2025-06-18 22:28:22,REAL,2854398582,486,2854399068,2859420793
2025-06-18 22:28:24,FAKE,2854399068,243,2854399311,2859421282
2025-06-18 22:28:26,REAL,2854399311,475,2854399786,2859421757
2025-06-18 22:28:28,FAKE,2854399786,241,2854400027,2859422235
2025-06-18 22:28:30,REAL,2854400027,488,2854400515,2859422723
2025-06-18 22:28:32,REAL,2854400515,485,2854401000,2859423208
2025-06-18 22:28:34,REAL,2854401000,478,2854401478,2859423686
2025-06-18 22:28:36,REAL,2854401478,540,2854402018,2859424226
2025-06-18 22:28:38,FAKE,2854402018,238,2854402256,2859424713
2025-06-18 22:28:40,REAL,2854402256,478,2854402734,2859425191
2025-06-18 22:28:42,FAKE,2854402734,243,2854402977,2859425676
2025-06-18 22:28:44,REAL,2854402977,483,2854403460,2859426159
2025-06-18 22:28:46,REAL,2854403460,490,2854403950,2859426649
2025-06-18 22:28:48,REAL,2854403950,7487,2854411437,2859434136
2025-06-18 22:28:50,REAL,2854411437,10845,2854422282,2859444981
2025-06-18 22:28:52,REAL,2854422282,10318,2854432600,2859455299
2025-06-18 22:28:54,REAL,2854432600,10243,2854442843,2859465542
2025-06-18 22:28:56,REAL,2854442843,10250,2854453093,2859475792
2025-06-18 22:28:58,REAL,2854453093,10328,2854463421,2859486120
2025-06-18 22:29:00,REAL,2854463421,10248,2854473669,2859496368
2025-06-18 22:29:02,FAKE,2854473669,244,2854473913,2859505367
2025-06-18 22:29:04,REAL,2854473913,544,2854474457,2859505911
2025-06-18 22:29:06,FAKE,2854474457,241,2854474698,2859506399
2025-06-18 22:29:08,REAL,2854474698,484,2854475182,2859506883
2025-06-18 22:29:10,REAL,2854475182,479,2854475661,2859507362
2025-06-18 22:29:12,REAL,2854475661,492,2854476153,2859507854
2025-06-18 22:29:14,REAL,2854476153,480,2854476633,2859508334
2025-06-18 22:29:16,REAL,2854476633,486,2854477119,2859508820
2025-06-18 22:29:18,REAL,2854477119,544,2854477663,2859509364
2025-06-18 22:29:20,FAKE,2854477663,241,2854477904,2859509844
2025-06-18 22:29:22,REAL,2854477904,489,2854478393,2859510333
2025-06-18 22:29:24,FAKE,2854478393,243,2854478636,2859510813
2025-06-18 22:29:26,REAL,2854478636,483,2854479119,2859511296
2025-06-18 22:29:28,FAKE,2854479119,238,2854479357,2859511776
2025-06-18 22:29:30,FAKE,2854479357,243,2854479600,2859512259
2025-06-18 22:29:32,REAL,2854479600,481,2854480081,2859512740
2025-06-18 22:29:34,FAKE,2854480081,243,2854480324,2859513273
2025-06-18 22:29:36,REAL,2854480324,478,2854480802,2859513751
2025-06-18 22:29:38,REAL,2854480802,485,2854481287,2859514236
2025-06-18 22:29:40,FAKE,2854481287,244,2854481531,2859514720
2025-06-18 22:29:42,REAL,2854481531,481,2854482012,2859515201
2025-06-18 22:29:44,FAKE,2854482012,244,2854482256,2859515693
2025-06-18 22:29:46,REAL,2854482256,486,2854482742,2859516179
2025-06-18 22:29:48,REAL,2854482742,536,2854483278,2859516715
2025-06-18 22:29:50,FAKE,2854483278,238,2854483516,2859517197
2025-06-18 22:29:52,FAKE,2854483516,243,2854483759,2859517682
2025-06-18 22:29:54,FAKE,2854483759,243,2854484002,2859518163
2025-06-18 22:29:56,REAL,2854484002,3195,2854487197,2859521358
2025-06-18 22:29:58,REAL,2854487197,11712,2854498909,2859533070
2025-06-18 22:30:00,REAL,2854498909,10257,2854509166,2859543327
2025-06-18 22:30:02,REAL,2854509166,10371,2854519537,2859553698
2025-06-18 22:30:04,FAKE,2854519537,238,2854519775,2859563944
2025-06-18 22:30:06,REAL,2854519775,10317,2854530092,2859574261
2025-06-18 22:30:08,REAL,2854530092,10244,2854540336,2859584505
2025-06-18 22:30:10,FAKE,2854540336,241,2854540577,2859594749
2025-06-18 22:30:12,FAKE,2854540577,243,2854540820,2859597616
2025-06-18 22:30:14,REAL,2854540820,481,2854541301,2859598097
2025-06-18 22:30:16,FAKE,2854541301,241,2854541542,2859598579
2025-06-18 22:30:18,REAL,2854541542,490,2854542032,2859599069
2025-06-18 22:30:20,REAL,2854542032,487,2854542519,2859599556
2025-06-18 22:30:22,REAL,2854542519,481,2854543000,2859600037
2025-06-18 22:30:24,FAKE,2854543000,243,2854543243,2859600524
2025-06-18 22:30:26,REAL,2854543243,539,2854543782,2859601063
2025-06-18 22:30:28,REAL,2854543782,4188,2854547970,2859605251
2025-06-18 22:30:30,REAL,2854547970,11182,2854559152,2859616433
2025-06-18 22:30:32,REAL,2854559152,10316,2854569468,2859626749
2025-06-18 22:30:34,REAL,2854569468,10257,2854579725,2859637006
2025-06-18 22:30:36,REAL,2854579725,10260,2854589985,2859647266
2025-06-18 22:30:38,FAKE,2854589985,238,2854590223,2859657575
2025-06-18 22:30:40,FAKE,2854590223,238,2854590461,2859667826
2025-06-18 22:30:42,FAKE,2854590461,244,2854590705,2859678143
2025-06-18 22:30:44,REAL,2854590705,2140,2854592845,2859680283
2025-06-18 22:30:46,REAL,2854592845,490,2854593335,2859680773
2025-06-18 22:30:48,REAL,2854593335,487,2854593822,2859681260
2025-06-18 22:30:50,REAL,2854593822,483,2854594305,2859681743
2025-06-18 22:30:52,REAL,2854594305,484,2854594789,2859682227
2025-06-18 22:30:54,REAL,2854594789,491,2854595280,2859682718
2025-06-18 22:30:56,FAKE,2854595280,243,2854595523,2859683250
2025-06-18 22:30:58,REAL,2854595523,531,2854596054,2859683781
2025-06-18 22:31:00,FAKE,2854596054,244,2854596298,2859688887
2025-06-18 22:31:02,REAL,2854596298,11108,2854607406,2859699995
2025-06-18 22:31:04,REAL,2854607406,10324,2854617730,2859710319
2025-06-18 22:31:06,REAL,2854617730,10247,2854627977,2859720566
2025-06-18 22:31:08,REAL,2854627977,10252,2854638229,2859730818
2025-06-18 22:31:10,REAL,2854638229,10250,2854648479,2859741068
2025-06-18 22:31:12,REAL,2854648479,10260,2854658739,2859751328
2025-06-18 22:31:14,FAKE,2854658739,241,2854658980,2859761650
2025-06-18 22:31:16,REAL,2854658980,1538,2854660518,2859763188
2025-06-18 22:31:18,REAL,2854660518,486,2854661004,2859763674
2025-06-18 22:31:20,REAL,2854661004,479,2854661483,2859764153
2025-06-18 22:31:22,FAKE,2854661483,241,2854661724,2859764636
2025-06-18 22:31:24,FAKE,2854661724,238,2854661962,2859765115
2025-06-18 22:31:26,REAL,2854661962,486,2854662448,2859765601
2025-06-18 22:31:28,FAKE,2854662448,241,2854662689,2859766197
2025-06-18 22:31:30,REAL,2854662689,476,2854663165,2859766673
2025-06-18 22:31:32,REAL,2854663165,7026,2854670191,2859773699
2025-06-18 22:31:34,REAL,2854670191,12164,2854682355,2859785863
2025-06-18 22:31:36,REAL,2854682355,10316,2854692671,2859796179
2025-06-18 22:31:38,REAL,2854692671,10246,2854702917,2859806425
2025-06-18 22:31:40,REAL,2854702917,10313,2854713230,2859816738
2025-06-18 22:31:42,REAL,2854713230,10255,2854723485,2859826993
2025-06-18 22:31:44,REAL,2854723485,10248,2854733733,2859837241
2025-06-18 22:31:46,REAL,2854733733,10325,2854744058,2859847566
2025-06-18 22:31:48,REAL,2854744058,943,2854745001,2859848509
2025-06-18 22:31:50,FAKE,2854745001,238,2854745239,2859848995
2025-06-18 22:31:52,REAL,2854745239,484,2854745723,2859849479
2025-06-18 22:31:54,REAL,2854745723,477,2854746200,2859849956
2025-06-18 22:31:56,REAL,2854746200,535,2854746735,2859850491
2025-06-18 22:31:58,FAKE,2854746735,243,2854746978,2859850978
2025-06-18 22:32:00,REAL,2854746978,489,2854747467,2859851467
2025-06-18 22:32:02,FAKE,2854747467,241,2854747708,2859851952
2025-06-18 22:32:04,REAL,2854747708,489,2854748197,2859852441
2025-06-18 22:32:06,FAKE,2854748197,243,2854748440,2859852931
2025-06-18 22:32:08,REAL,2854748440,482,2854748922,2859853413
2025-06-18 22:32:10,REAL,2854748922,483,2854749405,2859853896
2025-06-18 22:32:12,REAL,2854749405,531,2854749936,2859854427
2025-06-18 22:32:14,REAL,2854749936,482,2854750418,2859854909
2025-06-18 22:32:16,REAL,2854750418,481,2854750899,2859855390
2025-06-18 22:32:18,REAL,2854750899,485,2854751384,2859855875
2025-06-18 22:32:20,FAKE,2854751384,238,2854751622,2859856356
2025-06-18 22:32:22,REAL,2854751622,478,2854752100,2859856834
2025-06-18 22:32:24,FAKE,2854752100,241,2854752341,2859857365
2025-06-18 22:32:26,REAL,2854752341,487,2854752828,2859857852
2025-06-18 22:32:28,REAL,2854752828,492,2854753320,2859858344
2025-06-18 22:32:30,REAL,2854753320,491,2854753811,2859858835
2025-06-18 22:32:32,REAL,2854753811,478,2854754289,2859859313
2025-06-18 22:32:34,REAL,2854754289,493,2854754782,2859859806
2025-06-18 22:32:36,REAL,2854754782,7036,2854761818,2859866842
2025-06-18 22:32:38,FAKE,2854761818,243,2854762061,2859877618
2025-06-18 22:32:40,REAL,2854762061,10308,2854772369,2859887926
2025-06-18 22:32:42,REAL,2854772369,10250,2854782619,2859898176
2025-06-18 22:32:44,FAKE,2854782619,244,2854782863,2859908497
2025-06-18 22:32:46,REAL,2854782863,10180,2854793043,2859918677
2025-06-18 22:32:48,REAL,2854793043,10310,2854803353,2859928987
2025-06-18 22:32:50,REAL,2854803353,9458,2854812811,2859938445
2025-06-18 22:32:52,FAKE,2854812811,241,2854813052,2859938928
2025-06-18 22:32:54,FAKE,2854813052,243,2854813295,2859939473
2025-06-18 22:32:56,FAKE,2854813295,244,2854813539,2859939958
2025-06-18 22:32:58,REAL,2854813539,480,2854814019,2859940438
2025-06-18 22:33:00,REAL,2854814019,484,2854814503,2859940922
2025-06-18 22:33:02,REAL,2854814503,488,2854814991,2859941410
2025-06-18 22:33:04,FAKE,2854814991,241,2854815232,2859941890
2025-06-18 22:33:06,REAL,2854815232,476,2854815708,2859942366
2025-06-18 22:33:08,FAKE,2854815708,241,2854815949,2859950650
2025-06-18 22:33:10,FAKE,2854815949,244,2854816193,2859961290
2025-06-18 22:33:12,FAKE,2854816193,244,2854816437,2859971547
2025-06-18 22:33:14,REAL,2854816437,10316,2854826753,2859981863
2025-06-18 22:33:16,REAL,2854826753,10256,2854837009,2859992119
2025-06-18 22:33:18,REAL,2854837009,10246,2854847255,2860002365
2025-06-18 22:33:20,REAL,2854847255,10321,2854857576,2860012686
2025-06-18 22:33:22,FAKE,2854857576,243,2854857819,2860021548
2025-06-18 22:33:24,FAKE,2854857819,241,2854858060,2860022032
2025-06-18 22:33:26,FAKE,2854858060,238,2854858298,2860022514
2025-06-18 22:33:28,REAL,2854858298,484,2854858782,2860022998
2025-06-18 22:33:30,REAL,2854858782,487,2854859269,2860023485
2025-06-18 22:33:32,FAKE,2854859269,244,2854859513,2860023971
2025-06-18 22:33:34,REAL,2854859513,488,2854860001,2860024459
2025-06-18 22:33:36,FAKE,2854860001,244,2854860245,2860024939
2025-06-18 22:33:38,FAKE,2854860245,241,2854860486,2860025423
2025-06-18 22:33:40,FAKE,2854860486,241,2854860727,2860034103
2025-06-18 22:33:42,REAL,2854860727,10643,2854871370,2860044746
2025-06-18 22:33:44,REAL,2854871370,10252,2854881622,2860054998
2025-06-18 22:33:46,REAL,2854881622,10310,2854891932,2860065308
2025-06-18 22:33:48,REAL,2854891932,10245,2854902177,2860075553
2025-06-18 22:33:50,FAKE,2854902177,244,2854902421,2860085801
2025-06-18 22:33:52,REAL,2854902421,10364,2854912785,2860096165
2025-06-18 22:33:54,REAL,2854912785,8208,2854920993,2860104373
2025-06-18 22:33:56,FAKE,2854920993,244,2854921237,2860104853
2025-06-18 22:33:58,REAL,2854921237,485,2854921722,2860105338
2025-06-18 22:34:00,REAL,2854921722,483,2854922205,2860105821
2025-06-18 22:34:02,REAL,2854922205,480,2854922685,2860106301
2025-06-18 22:34:04,REAL,2854922685,484,2854923169,2860106785
2025-06-18 22:34:06,FAKE,2854923169,244,2854923413,2860107267
2025-06-18 22:34:08,FAKE,2854923413,243,2854923656,2860107755
2025-06-18 22:34:10,REAL,2854923656,487,2854924143,2860108242
2025-06-18 22:34:12,REAL,2854924143,11451,2854935594,2860119693
2025-06-18 22:34:14,REAL,2854935594,11705,2854947299,2860131398
2025-06-18 22:34:16,FAKE,2854947299,241,2854947540,2860141659
2025-06-18 22:34:18,REAL,2854947540,10248,2854957788,2860151907
2025-06-18 22:34:20,REAL,2854957788,10245,2854968033,2860162152
2025-06-18 22:34:22,REAL,2854968033,10305,2854978338,2860172457
2025-06-18 22:34:24,REAL,2854978338,10322,2854988660,2860182779
2025-06-18 22:34:26,REAL,2854988660,7545,2854996205,2860190324
2025-06-18 22:34:28,FAKE,2854996205,243,2854996448,2860190818
2025-06-18 22:34:30,REAL,2854996448,487,2854996935,2860191305
2025-06-18 22:34:32,REAL,2854996935,475,2854997410,2860191780
2025-06-18 22:34:34,REAL,2854997410,476,2854997886,2860192256
2025-06-18 22:34:36,REAL,2854997886,492,2854998378,2860192748
2025-06-18 22:34:38,REAL,2854998378,485,2854998863,2860193233
2025-06-18 22:34:40,REAL,2854998863,479,2854999342,2860193712
2025-06-18 22:34:42,REAL,2854999342,486,2854999828,2860194198
2025-06-18 22:34:44,FAKE,2854999828,244,2855000072,2860205974
2025-06-18 22:34:46,FAKE,2855000072,243,2855000315,2860217016
2025-06-18 22:34:48,REAL,2855000315,10314,2855010629,2860227330
2025-06-18 22:34:50,REAL,2855010629,10251,2855020880,2860237581
2025-06-18 22:34:52,FAKE,2855020880,243,2855021123,2860247961
2025-06-18 22:34:54,REAL,2855021123,10255,2855031378,2860258216
2025-06-18 22:34:56,REAL,2855031378,10255,2855041633,2860268471
2025-06-18 22:34:58,FAKE,2855041633,243,2855041876,2860275489
2025-06-18 22:35:00,FAKE,2855041876,244,2855042120,2860275972
2025-06-18 22:35:02,REAL,2855042120,481,2855042601,2860276453
2025-06-18 22:35:04,REAL,2855042601,475,2855043076,2860276928
2025-06-18 22:35:06,REAL,2855043076,483,2855043559,2860277411
2025-06-18 22:35:08,FAKE,2855043559,244,2855043803,2860277890
2025-06-18 22:35:10,FAKE,2855043803,243,2855044046,2860278377
2025-06-18 22:35:12,REAL,2855044046,477,2855044523,2860278854
2025-06-18 22:35:14,FAKE,2855044523,243,2855044766,2860279335
2025-06-18 22:35:16,FAKE,2855044766,238,2855045004,2860289800
2025-06-18 22:35:18,FAKE,2855045004,243,2855045247,2860300059
2025-06-18 22:35:20,REAL,2855045247,10319,2855055566,2860310378
2025-06-18 22:35:22,REAL,2855055566,10303,2855065869,2860320681
2025-06-18 22:35:24,REAL,2855065869,10322,2855076191,2860331003
2025-06-18 22:35:26,REAL,2855076191,10256,2855086447,2860341259
2025-06-18 22:35:28,REAL,2855086447,10323,2855096770,2860351582
2025-06-18 22:35:30,REAL,2855096770,6365,2855103135,2860357947
2025-06-18 22:35:32,REAL,2855103135,480,2855103615,2860358427
2025-06-18 22:35:34,FAKE,2855103615,238,2855103853,2860358913
2025-06-18 22:35:36,FAKE,2855103853,244,2855104097,2860359396
2025-06-18 22:35:38,FAKE,2855104097,238,2855104335,2860359881
2025-06-18 22:35:40,REAL,2855104335,479,2855104814,2860360360
2025-06-18 22:35:42,REAL,2855104814,486,2855105300,2860360846
2025-06-18 22:35:44,REAL,2855105300,487,2855105787,2860361333
2025-06-18 22:35:46,REAL,2855105787,482,2855106269,2860361815
2025-06-18 22:35:48,REAL,2855106269,488,2855106757,2860362303
2025-06-18 22:35:50,REAL,2855106757,492,2855107249,2860362795
2025-06-18 22:35:52,FAKE,2855107249,241,2855107490,2860363284
2025-06-18 22:35:54,REAL,2855107490,546,2855108036,2860363830
2025-06-18 22:35:56,FAKE,2855108036,241,2855108277,2860364314
2025-06-18 22:35:58,REAL,2855108277,536,2855108813,2860364850
2025-06-18 22:36:00,REAL,2855108813,492,2855109305,2860365342
2025-06-18 22:36:02,FAKE,2855109305,241,2855109546,2860365828
2025-06-18 22:36:04,FAKE,2855109546,238,2855109784,2860366307
2025-06-18 22:36:06,REAL,2855109784,488,2855110272,2860366795
2025-06-18 22:36:08,REAL,2855110272,488,2855110760,2860367283
2025-06-18 22:36:10,REAL,2855110760,484,2855111244,2860367767
2025-06-18 22:36:12,FAKE,2855111244,238,2855111482,2860368254
2025-06-18 22:36:14,REAL,2855111482,494,2855111976,2860368748
2025-06-18 22:36:16,REAL,2855111976,481,2855112457,2860369229
2025-06-18 22:36:18,FAKE,2855112457,244,2855112701,2860369710
2025-06-18 22:36:20,REAL,2855112701,480,2855113181,2860370190
2025-06-18 22:36:22,REAL,2855113181,481,2855113662,2860370671
2025-06-18 22:36:24,FAKE,2855113662,244,2855113906,2860371217
2025-06-18 22:36:26,REAL,2855113906,484,2855114390,2860371701
2025-06-18 22:36:28,FAKE,2855114390,238,2855114628,2860372187
2025-06-18 22:36:30,FAKE,2855114628,243,2855114871,2860372681
2025-06-18 22:36:32,FAKE,2855114871,243,2855115114,2860373167
2025-06-18 22:36:34,REAL,2855115114,490,2855115604,2860373657
2025-06-18 22:36:36,REAL,2855115604,489,2855116093,2860374146
2025-06-18 22:36:38,REAL,2855116093,484,2855116577,2860374630
2025-06-18 22:36:40,FAKE,2855116577,244,2855116821,2860375170
2025-06-18 22:36:42,FAKE,2855116821,244,2855117065,2860375663
2025-06-18 22:36:44,REAL,2855117065,483,2855117548,2860376146
2025-06-18 22:36:46,REAL,2855117548,483,2855118031,2860376629
2025-06-18 22:36:48,REAL,2855118031,485,2855118516,2860377114
2025-06-18 22:36:50,FAKE,2855118516,241,2855118757,2860377601
2025-06-18 22:36:52,REAL,2855118757,490,2855119247,2860378091
2025-06-18 22:36:54,FAKE,2855119247,244,2855119491,2860378638
2025-06-18 22:36:56,FAKE,2855119491,241,2855119732,2860379124
2025-06-18 22:36:58,FAKE,2855119732,243,2855119975,2860379607
2025-06-18 22:37:00,REAL,2855119975,474,2855120449,2860380081
2025-06-18 22:37:02,REAL,2855120449,485,2855120934,2860380566
2025-06-18 22:37:04,REAL,2855120934,479,2855121413,2860381045
2025-06-18 22:37:06,REAL,2855121413,484,2855121897,2860381529
2025-06-18 22:37:08,FAKE,2855121897,238,2855122135,2860382019
2025-06-18 22:37:10,REAL,2855122135,479,2855122614,2860382498
2025-06-18 22:37:12,REAL,2855122614,9202,2855131816,2860391700
2025-06-18 22:37:14,REAL,2855131816,11837,2855143653,2860403537
2025-06-18 22:37:16,FAKE,2855143653,241,2855143894,2860413786
2025-06-18 22:37:18,FAKE,2855143894,241,2855144135,2860424043
2025-06-18 22:37:20,REAL,2855144135,10311,2855154446,2860434354
2025-06-18 22:37:22,FAKE,2855154446,241,2855154687,2860444609
2025-06-18 22:37:24,REAL,2855154687,10259,2855164946,2860454868
2025-06-18 22:37:26,REAL,2855164946,9124,2855174070,2860463992
2025-06-18 22:37:28,REAL,2855174070,482,2855174552,2860464474
2025-06-18 22:37:30,REAL,2855174552,489,2855175041,2860464963
2025-06-18 22:37:32,FAKE,2855175041,244,2855175285,2860465438
2025-06-18 22:37:34,REAL,2855175285,533,2855175818,2860465971
2025-06-18 22:37:36,FAKE,2855175818,244,2855176062,2860466456
2025-06-18 22:37:38,FAKE,2855176062,238,2855176300,2860466940
2025-06-18 22:37:40,FAKE,2855176300,238,2855176538,2860467426
2025-06-18 22:37:42,REAL,2855176538,486,2855177024,2860467912
2025-06-18 22:37:44,REAL,2855177024,487,2855177511,2860468399
2025-06-18 22:37:46,FAKE,2855177511,241,2855177752,2860468887
2025-06-18 22:37:48,REAL,2855177752,486,2855178238,2860469373
2025-06-18 22:37:50,FAKE,2855178238,244,2855178482,2860469856
2025-06-18 22:37:52,FAKE,2855178482,241,2855178723,2860470336
2025-06-18 22:37:54,FAKE,2855178723,244,2855178967,2860470824
2025-06-18 22:37:56,FAKE,2855178967,243,2855179210,2860471364
2025-06-18 22:37:58,FAKE,2855179210,244,2855179454,2860471902
2025-06-18 22:38:00,REAL,2855179454,482,2855179936,2860472384
2025-06-18 22:38:02,REAL,2855179936,489,2855180425,2860472873
2025-06-18 22:38:04,REAL,2855180425,489,2855180914,2860473362
2025-06-18 22:38:06,REAL,2855180914,490,2855181404,2860473852
2025-06-18 22:38:08,REAL,2855181404,485,2855181889,2860474337
2025-06-18 22:38:10,REAL,2855181889,487,2855182376,2860474824
2025-06-18 22:38:12,REAL,2855182376,487,2855182863,2860475311
2025-06-18 22:38:14,FAKE,2855182863,238,2855183101,2860475793
2025-06-18 22:38:16,FAKE,2855183101,238,2855183339,2860476279
2025-06-18 22:38:18,REAL,2855183339,487,2855183826,2860476766
2025-06-18 22:38:20,REAL,2855183826,487,2855184313,2860477253
2025-06-18 22:38:22,REAL,2855184313,537,2855184850,2860477790
2025-06-18 22:38:24,FAKE,2855184850,241,2855185091,2860478277
2025-06-18 22:38:26,REAL,2855185091,488,2855185579,2860478765
2025-06-18 22:38:28,REAL,2855185579,542,2855186121,2860479307
2025-06-18 22:38:30,FAKE,2855186121,241,2855186362,2860479794
2025-06-18 22:38:32,REAL,2855186362,490,2855186852,2860480284
2025-06-18 22:38:34,REAL,2855186852,481,2855187333,2860480765
2025-06-18 22:38:36,REAL,2855187333,482,2855187815,2860481247
2025-06-18 22:38:38,REAL,2855187815,477,2855188292,2860481724
2025-06-18 22:38:40,REAL,2855188292,484,2855188776,2860482208
2025-06-18 22:38:42,REAL,2855188776,482,2855189258,2860482690
2025-06-18 22:38:44,REAL,2855189258,493,2855189751,2860483183
2025-06-18 22:38:46,REAL,2855189751,541,2855190292,2860483724
2025-06-18 22:38:48,REAL,2855190292,483,2855190775,2860484207
2025-06-18 22:38:50,FAKE,2855190775,243,2855191018,2860484691
2025-06-18 22:38:52,REAL,2855191018,4849,2855195867,2860489540
2025-06-18 22:38:54,REAL,2855195867,12236,2855208103,2860501776
2025-06-18 22:38:56,REAL,2855208103,10254,2855218357,2860512030
2025-06-18 22:38:58,FAKE,2855218357,241,2855218598,2860522279
2025-06-18 22:39:00,REAL,2855218598,10248,2855228846,2860532527
2025-06-18 22:39:02,REAL,2855228846,10324,2855239170,2860542851
2025-06-18 22:39:04,REAL,2855239170,10244,2855249414,2860553095
2025-06-18 22:39:06,REAL,2855249414,10258,2855259672,2860563353
2025-06-18 22:39:08,REAL,2855259672,2199,2855261871,2860565552
2025-06-18 22:39:10,REAL,2855261871,532,2855262403,2860566084
2025-06-18 22:39:12,REAL,2855262403,484,2855262887,2860566568
2025-06-18 22:39:14,REAL,2855262887,485,2855263372,2860567053
2025-06-18 22:39:16,REAL,2855263372,543,2855263915,2860567596
2025-06-18 22:39:18,REAL,2855263915,494,2855264409,2860568090
2025-06-18 22:39:20,REAL,2855264409,489,2855264898,2860568579
2025-06-18 22:39:22,REAL,2855264898,480,2855265378,2860569059
2025-06-18 22:39:24,REAL,2855265378,488,2855265866,2860569547
2025-06-18 22:39:26,FAKE,2855265866,238,2855266104,2860570031
2025-06-18 22:39:28,REAL,2855266104,478,2855266582,2860570509
2025-06-18 22:39:30,FAKE,2855266582,244,2855266826,2860570994
2025-06-18 22:39:32,REAL,2855266826,486,2855267312,2860571480
2025-06-18 22:39:34,FAKE,2855267312,244,2855267556,2860571969
2025-06-18 22:39:36,REAL,2855267556,478,2855268034,2860572447
2025-06-18 22:39:38,REAL,2855268034,477,2855268511,2860572924
2025-06-18 22:39:40,REAL,2855268511,531,2855269042,2860573455
2025-06-18 22:39:42,REAL,2855269042,487,2855269529,2860573942
2025-06-18 22:39:44,REAL,2855269529,494,2855270023,2860574436
2025-06-18 22:39:46,FAKE,2855270023,244,2855270267,2860574919
2025-06-18 22:39:48,REAL,2855270267,479,2855270746,2860575398
2025-06-18 22:39:50,REAL,2855270746,482,2855271228,2860575880
2025-06-18 22:39:52,FAKE,2855271228,241,2855271469,2860576418
2025-06-18 22:39:54,FAKE,2855271469,238,2855271707,2860576901
2025-06-18 22:39:56,REAL,2855271707,5704,2855277411,2860582605
2025-06-18 22:39:58,FAKE,2855277411,241,2855277652,2860594062
2025-06-18 22:40:00,REAL,2855277652,10250,2855287902,2860604312
2025-06-18 22:40:02,REAL,2855287902,10318,2855298220,2860614630
2025-06-18 22:40:04,REAL,2855298220,10253,2855308473,2860624883
2025-06-18 22:40:06,REAL,2855308473,10316,2855318789,2860635199
2025-06-18 22:40:08,REAL,2855318789,10252,2855329041,2860645451
2025-06-18 22:40:10,REAL,2855329041,10245,2855339286,2860655696
2025-06-18 22:40:12,FAKE,2855339286,238,2855339524,2860656647
2025-06-18 22:40:14,REAL,2855339524,479,2855340003,2860657126
2025-06-18 22:40:16,REAL,2855340003,482,2855340485,2860657608
2025-06-18 22:40:18,REAL,2855340485,543,2855341028,2860658151
2025-06-18 22:40:20,FAKE,2855341028,244,2855341272,2860658633
2025-06-18 22:40:22,REAL,2855341272,493,2855341765,2860659126
2025-06-18 22:40:24,REAL,2855341765,490,2855342255,2860659616
2025-06-18 22:40:26,REAL,2855342255,492,2855342747,2860660108
2025-06-18 22:40:28,REAL,2855342747,490,2855343237,2860660598
2025-06-18 22:40:30,REAL,2855343237,490,2855343727,2860661088
2025-06-18 22:40:32,REAL,2855343727,485,2855344212,2860661573
2025-06-18 22:40:34,REAL,2855344212,476,2855344688,2860662049
2025-06-18 22:40:36,FAKE,2855344688,241,2855344929,2860662590
2025-06-18 22:40:38,REAL,2855344929,482,2855345411,2860663072
2025-06-18 22:40:40,REAL,2855345411,478,2855345889,2860663550
2025-06-18 22:40:42,REAL,2855345889,481,2855346370,2860664031
2025-06-18 22:40:44,REAL,2855346370,539,2855346909,2860664570
2025-06-18 22:40:46,FAKE,2855346909,244,2855347153,2860665056
2025-06-18 22:40:48,FAKE,2855347153,244,2855347397,2860665545
2025-06-18 22:40:50,FAKE,2855347397,243,2855347640,2860666028
2025-06-18 22:40:52,REAL,2855347640,493,2855348133,2860666521
2025-06-18 22:40:54,REAL,2855348133,487,2855348620,2860667008
2025-06-18 22:40:56,REAL,2855348620,487,2855349107,2860667495
2025-06-18 22:40:58,REAL,2855349107,477,2855349584,2860667972
2025-06-18 22:41:00,REAL,2855349584,494,2855350078,2860668466
2025-06-18 22:41:02,REAL,2855350078,483,2855350561,2860668949
2025-06-18 22:41:04,REAL,2855350561,491,2855351052,2860669440
2025-06-18 22:41:06,REAL,2855351052,482,2855351534,2860669922
2025-06-18 22:41:08,REAL,2855351534,481,2855352015,2860670403
2025-06-18 22:41:10,REAL,2855352015,532,2855352547,2860670935
2025-06-18 22:41:12,REAL,2855352547,487,2855353034,2860671422
2025-06-18 22:41:14,REAL,2855353034,477,2855353511,2860671899
2025-06-18 22:41:16,REAL,2855353511,486,2855353997,2860672385
2025-06-18 22:41:18,REAL,2855353997,542,2855354539,2860672927
2025-06-18 22:41:20,REAL,2855354539,484,2855355023,2860673411
2025-06-18 22:41:22,REAL,2855355023,483,2855355506,2860673894
2025-06-18 22:41:24,REAL,2855355506,477,2855355983,2860674371
2025-06-18 22:41:26,REAL,2855355983,478,2855356461,2860674849
2025-06-18 22:41:28,REAL,2855356461,487,2855356948,2860675336
2025-06-18 22:41:30,REAL,2855356948,484,2855357432,2860675820
2025-06-18 22:41:32,REAL,2855357432,489,2855357921,2860676309
2025-06-18 22:41:34,REAL,2855357921,542,2855358463,2860676851
2025-06-18 22:41:36,REAL,2855358463,490,2855358953,2860677341
2025-06-18 22:41:38,FAKE,2855358953,241,2855359194,2860677817
2025-06-18 22:41:40,REAL,2855359194,487,2855359681,2860678304
2025-06-18 22:41:42,REAL,2855359681,490,2855360171,2860678794
2025-06-18 22:41:44,FAKE,2855360171,243,2855360414,2860679277
2025-06-18 22:41:46,FAKE,2855360414,244,2855360658,2860679751
2025-06-18 22:41:48,REAL,2855360658,8014,2855368672,2860687765
2025-06-18 22:41:50,FAKE,2855368672,244,2855368916,2860698676
2025-06-18 22:41:52,REAL,2855368916,10256,2855379172,2860708932
2025-06-18 22:41:54,REAL,2855379172,10326,2855389498,2860719258
2025-06-18 22:41:56,REAL,2855389498,10262,2855399760,2860729520
2025-06-18 22:41:58,REAL,2855399760,10326,2855410086,2860739846
2025-06-18 22:42:00,REAL,2855410086,10318,2855420404,2860750164
2025-06-18 22:42:02,FAKE,2855420404,238,2855420642,2860758692
2025-06-18 22:42:04,REAL,2855420642,486,2855421128,2860759178
2025-06-18 22:42:06,REAL,2855421128,489,2855421617,2860759667
2025-06-18 22:42:08,FAKE,2855421617,243,2855421860,2860760151
2025-06-18 22:42:10,REAL,2855421860,486,2855422346,2860760637
2025-06-18 22:42:12,REAL,2855422346,483,2855422829,2860761120
2025-06-18 22:42:14,FAKE,2855422829,243,2855423072,2860761607
2025-06-18 22:42:16,REAL,2855423072,490,2855423562,2860762097
2025-06-18 22:42:18,REAL,2855423562,485,2855424047,2860762582
2025-06-18 22:42:20,REAL,2855424047,542,2855424589,2860763124
2025-06-18 22:42:22,REAL,2855424589,477,2855425066,2860763601
2025-06-18 22:42:24,FAKE,2855425066,238,2855425304,2860764081
2025-06-18 22:42:26,FAKE,2855425304,244,2855425548,2860764570
2025-06-18 22:42:28,REAL,2855425548,487,2855426035,2860765057
2025-06-18 22:42:30,FAKE,2855426035,238,2855426273,2860765533
2025-06-18 22:42:32,REAL,2855426273,479,2855426752,2860766012
2025-06-18 22:42:34,REAL,2855426752,480,2855427232,2860766492
2025-06-18 22:42:36,REAL,2855427232,476,2855427708,2860766968
2025-06-18 22:42:38,FAKE,2855427708,238,2855427946,2860767451
2025-06-18 22:42:40,REAL,2855427946,3459,2855431405,2860770910
2025-06-18 22:42:42,REAL,2855431405,10983,2855442388,2860781893
2025-06-18 22:42:44,REAL,2855442388,10251,2855452639,2860792144
2025-06-18 22:42:46,FAKE,2855452639,241,2855452880,2860802449
2025-06-18 22:42:48,FAKE,2855452880,238,2855453118,2860812703
2025-06-18 22:42:50,REAL,2855453118,10311,2855463429,2860823014
2025-06-18 22:42:52,REAL,2855463429,10253,2855473682,2860833267
2025-06-18 22:42:54,REAL,2855473682,10244,2855483926,2860843511
2025-06-18 22:42:56,FAKE,2855483926,238,2855484164,2860846172
2025-06-18 22:42:58,FAKE,2855484164,241,2855484405,2860846655
2025-06-18 22:43:00,REAL,2855484405,481,2855484886,2860847136
2025-06-18 22:43:02,REAL,2855484886,486,2855485372,2860847622
2025-06-18 22:43:04,REAL,2855485372,491,2855485863,2860848113
2025-06-18 22:43:06,REAL,2855485863,482,2855486345,2860848595
2025-06-18 22:43:08,FAKE,2855486345,241,2855486586,2860849075
2025-06-18 22:43:10,FAKE,2855486586,238,2855486824,2860849557
2025-06-18 22:43:12,REAL,2855486824,4712,2855491536,2860854269
2025-06-18 22:43:14,REAL,2855491536,15011,2855506547,2860869280
2025-06-18 22:43:16,REAL,2855506547,10250,2855516797,2860879530
2025-06-18 22:43:18,REAL,2855516797,10248,2855527045,2860889778
2025-06-18 22:43:20,REAL,2855527045,10242,2855537287,2860900020
2025-06-18 22:43:22,REAL,2855537287,10314,2855547601,2860910334
2025-06-18 22:43:24,FAKE,2855547601,244,2855547845,2860920587
2025-06-18 22:43:26,FAKE,2855547845,244,2855548089,2860930845
2025-06-18 22:43:28,REAL,2855548089,2122,2855550211,2860932967
2025-06-18 22:43:30,REAL,2855550211,490,2855550701,2860933457
2025-06-18 22:43:32,REAL,2855550701,489,2855551190,2860933946
2025-06-18 22:43:34,FAKE,2855551190,244,2855551434,2860934435
2025-06-18 22:43:36,FAKE,2855551434,243,2855551677,2860934916
2025-06-18 22:43:38,FAKE,2855551677,241,2855551918,2860935403
2025-06-18 22:43:40,REAL,2855551918,244,2855552162,2860935647
2025-06-18 22:43:42,REAL,2855552162,484,2855552646,2860936131
2025-06-18 22:43:44,REAL,2855552646,484,2855553130,2860936615
2025-06-18 22:43:46,FAKE,2855553130,241,2855553371,2860937157
2025-06-18 22:43:48,REAL,2855553371,485,2855553856,2860937642
2025-06-18 22:43:50,REAL,2855553856,491,2855554347,2860938133
2025-06-18 22:43:52,FAKE,2855554347,238,2855554585,2860938616
2025-06-18 22:43:54,REAL,2855554585,487,2855555072,2860939103
2025-06-18 22:43:56,REAL,2855555072,478,2855555550,2860939581
2025-06-18 22:43:58,FAKE,2855555550,238,2855555788,2860940065
2025-06-18 22:44:00,REAL,2855555788,488,2855556276,2860940553
2025-06-18 22:44:02,REAL,2855556276,479,2855556755,2860941032
2025-06-18 22:44:04,REAL,2855556755,486,2855557241,2860941518
2025-06-18 22:44:06,REAL,2855557241,480,2855557721,2860941998
2025-06-18 22:44:08,REAL,2855557721,485,2855558206,2860942483
2025-06-18 22:44:10,FAKE,2855558206,241,2855558447,2860942961
2025-06-18 22:44:12,REAL,2855558447,539,2855558986,2860943500
2025-06-18 22:44:14,REAL,2855558986,483,2855559469,2860943983
2025-06-18 22:44:16,REAL,2855559469,6896,2855566365,2860950879
2025-06-18 22:44:18,REAL,2855566365,13156,2855579521,2860964035
2025-06-18 22:44:20,REAL,2855579521,10324,2855589845,2860974359
2025-06-18 22:44:22,FAKE,2855589845,238,2855590083,2860984613
2025-06-18 22:44:24,REAL,2855590083,10252,2855600335,2860994865
2025-06-18 22:44:26,FAKE,2855600335,244,2855600579,2861005181
2025-06-18 22:44:28,REAL,2855600579,10322,2855610901,2861015503
2025-06-18 22:44:30,FAKE,2855610901,238,2855611139,2861025747
2025-06-18 22:44:32,FAKE,2855611139,244,2855611383,2861026564
2025-06-18 22:44:34,FAKE,2855611383,243,2855611626,2861027044
2025-06-18 22:44:36,REAL,2855611626,478,2855612104,2861027522
2025-06-18 22:44:38,FAKE,2855612104,244,2855612348,2861028008
2025-06-18 22:44:40,REAL,2855612348,481,2855612829,2861028489
2025-06-18 22:44:42,REAL,2855612829,484,2855613313,2861028973
2025-06-18 22:44:44,FAKE,2855613313,243,2855613556,2861029453
2025-06-18 22:44:46,REAL,2855613556,488,2855614044,2861029941
2025-06-18 22:44:48,REAL,2855614044,6759,2855620803,2861036700
2025-06-18 22:44:50,REAL,2855620803,11106,2855631909,2861047806
2025-06-18 22:44:52,REAL,2855631909,10255,2855642164,2861058061
2025-06-18 22:44:54,REAL,2855642164,10261,2855652425,2861068322
2025-06-18 22:44:56,REAL,2855652425,10257,2855662682,2861078579
2025-06-18 22:44:58,FAKE,2855662682,243,2855662925,2861088839
2025-06-18 22:45:00,REAL,2855662925,10322,2855673247,2861099161
2025-06-18 22:45:02,FAKE,2855673247,241,2855673488,2861109149
2025-06-18 22:45:04,FAKE,2855673488,244,2855673732,2861109629
2025-06-18 22:45:06,REAL,2855673732,493,2855674225,2861110122
2025-06-18 22:45:08,REAL,2855674225,474,2855674699,2861110596
2025-06-18 22:45:10,REAL,2855674699,488,2855675187,2861111084
2025-06-18 22:45:12,REAL,2855675187,493,2855675680,2861111577
2025-06-18 22:45:14,FAKE,2855675680,243,2855675923,2861112064
2025-06-18 22:45:16,REAL,2855675923,484,2855676407,2861112548
2025-06-18 22:45:18,FAKE,2855676407,241,2855676648,2861113024
2025-06-18 22:45:20,REAL,2855676648,488,2855677136,2861113512
2025-06-18 22:45:22,REAL,2855677136,547,2855677683,2861114059
2025-06-18 22:45:24,FAKE,2855677683,241,2855677924,2861114553
2025-06-18 22:45:26,REAL,2855677924,487,2855678411,2861115040
2025-06-18 22:45:28,FAKE,2855678411,243,2855678654,2861115518
2025-06-18 22:45:30,REAL,2855678654,540,2855679194,2861116058
2025-06-18 22:45:32,FAKE,2855679194,241,2855679435,2861116534
2025-06-18 22:45:34,FAKE,2855679435,243,2855679678,2861117017
2025-06-18 22:45:36,FAKE,2855679678,241,2855679919,2861117508
2025-06-18 22:45:38,FAKE,2855679919,238,2855680157,2861117987
2025-06-18 22:45:40,REAL,2855680157,2076,2855682233,2861120063
2025-06-18 22:45:42,FAKE,2855682233,241,2855682474,2861135070
2025-06-18 22:45:44,REAL,2855682474,10315,2855692789,2861145385
2025-06-18 22:45:46,FAKE,2855692789,243,2855693032,2861155641
2025-06-18 22:45:48,REAL,2855693032,10322,2855703354,2861165963
2025-06-18 22:45:50,REAL,2855703354,10248,2855713602,2861176211
2025-06-18 22:45:52,REAL,2855713602,10244,2855723846,2861186455
2025-06-18 22:45:54,REAL,2855723846,10314,2855734160,2861196769
2025-06-18 22:45:56,FAKE,2855734160,238,2855734398,2861200821
2025-06-18 22:45:58,FAKE,2855734398,244,2855734642,2861201303
2025-06-18 22:46:00,REAL,2855734642,482,2855735124,2861201785
2025-06-18 22:46:02,FAKE,2855735124,244,2855735368,2861202268
2025-06-18 22:46:04,REAL,2855735368,480,2855735848,2861202748
2025-06-18 22:46:06,REAL,2855735848,488,2855736336,2861203236
2025-06-18 22:46:08,FAKE,2855736336,238,2855736574,2861203773
2025-06-18 22:46:10,REAL,2855736574,478,2855737052,2861204251
2025-06-18 22:46:12,REAL,2855737052,2803,2855739855,2861207054
2025-06-18 22:46:14,REAL,2855739855,11568,2855751423,2861218622
2025-06-18 22:46:16,REAL,2855751423,10253,2855761676,2861228875
2025-06-18 22:46:18,FAKE,2855761676,241,2855761917,2861239189
2025-06-18 22:46:20,REAL,2855761917,10255,2855772172,2861249444
2025-06-18 22:46:22,REAL,2855772172,10248,2855782420,2861259692
2025-06-18 22:46:24,REAL,2855782420,10319,2855792739,2861270011
2025-06-18 22:46:26,REAL,2855792739,10250,2855802989,2861280261
2025-06-18 22:46:28,REAL,2855802989,3452,2855806441,2861283713
2025-06-18 22:46:30,FAKE,2855806441,243,2855806684,2861284201
2025-06-18 22:46:32,REAL,2855806684,480,2855807164,2861284681
2025-06-18 22:46:34,REAL,2855807164,489,2855807653,2861285170
2025-06-18 22:46:36,REAL,2855807653,488,2855808141,2861285658
2025-06-18 22:46:38,REAL,2855808141,485,2855808626,2861286143
2025-06-18 22:46:40,REAL,2855808626,483,2855809109,2861286626
2025-06-18 22:46:42,REAL,2855809109,479,2855809588,2861287105
2025-06-18 22:46:44,REAL,2855809588,3134,2855812722,2861290239
2025-06-18 22:46:46,REAL,2855812722,14539,2855827261,2861304778
2025-06-18 22:46:48,REAL,2855827261,10365,2855837626,2861315143
2025-06-18 22:46:50,FAKE,2855837626,238,2855837864,2861325400
2025-06-18 22:46:52,REAL,2855837864,10318,2855848182,2861335718
2025-06-18 22:46:54,FAKE,2855848182,243,2855848425,2861345968
2025-06-18 22:46:56,REAL,2855848425,10252,2855858677,2861356220
2025-06-18 22:46:58,FAKE,2855858677,238,2855858915,2861366538
2025-06-18 22:47:00,REAL,2855858915,2856,2855861771,2861369394
2025-06-18 22:47:02,FAKE,2855861771,238,2855862009,2861369874
2025-06-18 22:47:04,FAKE,2855862009,243,2855862252,2861370360
2025-06-18 22:47:06,REAL,2855862252,483,2855862735,2861370843
2025-06-18 22:47:08,REAL,2855862735,476,2855863211,2861371319
2025-06-18 22:47:10,REAL,2855863211,488,2855863699,2861371807
2025-06-18 22:47:12,REAL,2855863699,483,2855864182,2861372290
2025-06-18 22:47:14,REAL,2855864182,478,2855864660,2861372768
2025-06-18 22:47:16,REAL,2855864660,4118,2855868778,2861376886
2025-06-18 22:47:18,REAL,2855868778,11576,2855880354,2861388462
2025-06-18 22:47:20,REAL,2855880354,10249,2855890603,2861398711
2025-06-18 22:47:22,REAL,2855890603,10314,2855900917,2861409025
2025-06-18 22:47:24,REAL,2855900917,10255,2855911172,2861419280
2025-06-18 22:47:26,REAL,2855911172,10374,2855921546,2861429654
2025-06-18 22:47:28,REAL,2855921546,10253,2855931799,2861439907
2025-06-18 22:47:30,REAL,2855931799,10316,2855942115,2861450223
2025-06-18 22:47:32,REAL,2855942115,2195,2855944310,2861452418
2025-06-18 22:47:34,REAL,2855944310,476,2855944786,2861452894
2025-06-18 22:47:36,REAL,2855944786,484,2855945270,2861453378
2025-06-18 22:47:38,REAL,2855945270,481,2855945751,2861453859
2025-06-18 22:47:40,REAL,2855945751,480,2855946231,2861454339
2025-06-18 22:47:42,REAL,2855946231,484,2855946715,2861454823
2025-06-18 22:47:44,REAL,2855946715,484,2855947199,2861455307
2025-06-18 22:47:46,REAL,2855947199,492,2855947691,2861455799
2025-06-18 22:47:48,REAL,2855947691,4988,2855952679,2861460787
2025-06-18 22:47:50,REAL,2855952679,11370,2855964049,2861472157
2025-06-18 22:47:52,FAKE,2855964049,243,2855964292,2861482404
2025-06-18 22:47:54,REAL,2855964292,10253,2855974545,2861492657
2025-06-18 22:47:56,REAL,2855974545,10316,2855984861,2861502973
2025-06-18 22:47:58,FAKE,2855984861,238,2855985099,2861513220
2025-06-18 22:48:00,REAL,2855985099,10252,2855995351,2861523472
2025-06-18 22:48:02,REAL,2855995351,10318,2856005669,2861533790
2025-06-18 22:48:04,FAKE,2856005669,244,2856005913,2861535335
2025-06-18 22:48:06,REAL,2856005913,540,2856006453,2861535875
2025-06-18 22:48:08,FAKE,2856006453,241,2856006694,2861536353
2025-06-18 22:48:10,FAKE,2856006694,238,2856006932,2861536838
2025-06-18 22:48:12,REAL,2856006932,486,2856007418,2861537324
2025-06-18 22:48:14,FAKE,2856007418,243,2856007661,2861537806
2025-06-18 22:48:16,REAL,2856007661,478,2856008139,2861538284
2025-06-18 22:48:18,REAL,2856008139,484,2856008623,2861538768
2025-06-18 22:48:20,REAL,2856008623,479,2856009102,2861539247
2025-06-18 22:48:22,REAL,2856009102,486,2856009588,2861539733
2025-06-18 22:48:24,REAL,2856009588,484,2856010072,2861540217
2025-06-18 22:48:26,REAL,2856010072,490,2856010562,2861540707
2025-06-18 22:48:28,REAL,2856010562,484,2856011046,2861541191
2025-06-18 22:48:30,REAL,2856011046,479,2856011525,2861541670
2025-06-18 22:48:32,REAL,2856011525,484,2856012009,2861542154
2025-06-18 22:48:34,REAL,2856012009,480,2856012489,2861542634
2025-06-18 22:48:36,FAKE,2856012489,244,2856012733,2861543123
2025-06-18 22:48:38,FAKE,2856012733,241,2856012974,2861543600
2025-06-18 22:48:40,REAL,2856012974,544,2856013518,2861544144
2025-06-18 22:48:42,REAL,2856013518,489,2856014007,2861544633
2025-06-18 22:48:44,REAL,2856014007,532,2856014539,2861545165
2025-06-18 22:48:46,REAL,2856014539,483,2856015022,2861545648
2025-06-18 22:48:48,REAL,2856015022,475,2856015497,2861546123
2025-06-18 22:48:50,REAL,2856015497,480,2856015977,2861546603
2025-06-18 22:48:52,REAL,2856015977,486,2856016463,2861547089
2025-06-18 22:48:54,FAKE,2856016463,241,2856016704,2861547574
2025-06-18 22:48:56,REAL,2856016704,491,2856017195,2861548065
2025-06-18 22:48:58,REAL,2856017195,481,2856017676,2861548546
2025-06-18 22:49:00,REAL,2856017676,479,2856018155,2861549025
2025-06-18 22:49:02,REAL,2856018155,7092,2856025247,2861556117
2025-06-18 22:49:04,REAL,2856025247,13295,2856038542,2861569412
2025-06-18 22:49:06,FAKE,2856038542,238,2856038780,2861579732
2025-06-18 22:49:08,FAKE,2856038780,238,2856039018,2861589988
2025-06-18 22:49:10,REAL,2856039018,10246,2856049264,2861600234
2025-06-18 22:49:12,REAL,2856049264,10261,2856059525,2861610495
2025-06-18 22:49:14,REAL,2856059525,10313,2856069838,2861620808
2025-06-18 22:49:16,FAKE,2856069838,238,2856070076,2861630933
2025-06-18 22:49:18,REAL,2856070076,486,2856070562,2861631419
2025-06-18 22:49:20,REAL,2856070562,486,2856071048,2861631905
2025-06-18 22:49:22,FAKE,2856071048,243,2856071291,2861632389
2025-06-18 22:49:24,REAL,2856071291,489,2856071780,2861632878
2025-06-18 22:49:26,REAL,2856071780,539,2856072319,2861633417
2025-06-18 22:49:28,FAKE,2856072319,244,2856072563,2861633904
2025-06-18 22:49:30,FAKE,2856072563,243,2856072806,2861634386
2025-06-18 22:49:32,REAL,2856072806,489,2856073295,2861634875
2025-06-18 22:49:34,REAL,2856073295,7019,2856080314,2861641894
2025-06-18 22:49:36,REAL,2856080314,10913,2856091227,2861652807
2025-06-18 22:49:38,REAL,2856091227,10256,2856101483,2861663063
2025-06-18 22:49:40,REAL,2856101483,10319,2856111802,2861673382
2025-06-18 22:49:42,REAL,2856111802,10519,2856122321,2861683901
2025-06-18 22:49:44,REAL,2856122321,10050,2856132371,2861693951
2025-06-18 22:49:46,REAL,2856132371,10255,2856142626,2861704206
2025-06-18 22:49:48,FAKE,2856142626,243,2856142869,2861713790
2025-06-18 22:49:50,FAKE,2856142869,238,2856143107,2861714272
2025-06-18 22:49:52,REAL,2856143107,487,2856143594,2861714759
2025-06-18 22:49:54,FAKE,2856143594,244,2856143838,2861715243
2025-06-18 22:49:56,REAL,2856143838,491,2856144329,2861715734
2025-06-18 22:49:58,REAL,2856144329,488,2856144817,2861716222
2025-06-18 22:50:00,REAL,2856144817,492,2856145309,2861716714
2025-06-18 22:50:02,REAL,2856145309,486,2856145795,2861717200
2025-06-18 22:50:04,FAKE,2856145795,244,2856146039,2861717684
2025-06-18 22:50:06,REAL,2856146039,9541,2856155580,2861727225
2025-06-18 22:50:08,FAKE,2856155580,241,2856155821,2861739715
2025-06-18 22:50:10,REAL,2856155821,10300,2856166121,2861750015
2025-06-18 22:50:12,FAKE,2856166121,241,2856166362,2861760333
2025-06-18 22:50:14,FAKE,2856166362,241,2856166603,2861770592
2025-06-18 22:50:16,REAL,2856166603,10250,2856176853,2861780842
2025-06-18 22:50:18,REAL,2856176853,10325,2856187178,2861791167
2025-06-18 22:50:20,REAL,2856187178,8933,2856196111,2861800100
2025-06-18 22:50:22,REAL,2856196111,490,2856196601,2861800590
2025-06-18 22:50:24,REAL,2856196601,484,2856197085,2861801074
2025-06-18 22:50:26,REAL,2856197085,483,2856197568,2861801557
2025-06-18 22:50:28,REAL,2856197568,491,2856198059,2861802048
2025-06-18 22:50:30,REAL,2856198059,480,2856198539,2861802528
2025-06-18 22:50:32,FAKE,2856198539,244,2856198783,2861803017
2025-06-18 22:50:34,REAL,2856198783,482,2856199265,2861803499
2025-06-18 22:50:36,REAL,2856199265,558,2856199823,2861804057
2025-06-18 22:50:38,REAL,2856199823,10262,2856210085,2861814319
2025-06-18 22:50:40,FAKE,2856210085,244,2856210329,2861826088
2025-06-18 22:50:42,FAKE,2856210329,244,2856210573,2861836404
2025-06-18 22:50:44,REAL,2856210573,10253,2856220826,2861846657
2025-06-18 22:50:46,REAL,2856220826,10249,2856231075,2861856906
2025-06-18 22:50:48,REAL,2856231075,10255,2856241330,2861867161
2025-06-18 22:50:50,FAKE,2856241330,238,2856241568,2861877476
2025-06-18 22:50:52,FAKE,2856241568,238,2856241806,2861885799
2025-06-18 22:50:54,REAL,2856241806,479,2856242285,2861886278
2025-06-18 22:50:56,REAL,2856242285,486,2856242771,2861886764
2025-06-18 22:50:58,REAL,2856242771,482,2856243253,2861887246
2025-06-18 22:51:00,REAL,2856243253,481,2856243734,2861887727
2025-06-18 22:51:02,REAL,2856243734,482,2856244216,2861888209
2025-06-18 22:51:04,REAL,2856244216,481,2856244697,2861888690
2025-06-18 22:51:06,REAL,2856244697,490,2856245187,2861889180
2025-06-18 22:51:08,REAL,2856245187,491,2856245678,2861889671
2025-06-18 22:51:10,FAKE,2856245678,238,2856245916,2861890149
2025-06-18 22:51:12,FAKE,2856245916,243,2856246159,2861890631
2025-06-18 22:51:14,REAL,2856246159,486,2856246645,2861891117
2025-06-18 22:51:16,REAL,2856246645,490,2856247135,2861891607
2025-06-18 22:51:18,REAL,2856247135,482,2856247617,2861892089
2025-06-18 22:51:20,REAL,2856247617,477,2856248094,2861892566
2025-06-18 22:51:22,REAL,2856248094,493,2856248587,2861893059
2025-06-18 22:51:24,FAKE,2856248587,238,2856248825,2861893544
2025-06-18 22:51:26,REAL,2856248825,532,2856249357,2861894076
2025-06-18 22:51:28,REAL,2856249357,480,2856249837,2861894556
2025-06-18 22:51:30,FAKE,2856249837,243,2856250080,2861895032
2025-06-18 22:51:32,REAL,2856250080,484,2856250564,2861895516
2025-06-18 22:51:34,FAKE,2856250564,243,2856250807,2861895994
2025-06-18 22:51:36,FAKE,2856250807,243,2856251050,2861896535
2025-06-18 22:51:38,FAKE,2856251050,243,2856251293,2861897009
2025-06-18 22:51:40,REAL,2856251293,494,2856251787,2861897503
2025-06-18 22:51:42,REAL,2856251787,10333,2856262120,2861907836
2025-06-18 22:51:44,REAL,2856262120,10452,2856272572,2861918288
2025-06-18 22:51:46,REAL,2856272572,10259,2856282831,2861928547
2025-06-18 22:51:48,REAL,2856282831,10250,2856293081,2861938797
2025-06-18 22:51:50,FAKE,2856293081,243,2856293324,2861949055
2025-06-18 22:51:52,FAKE,2856293324,241,2856293565,2861959304
2025-06-18 22:51:54,REAL,2856293565,10319,2856303884,2861969623
2025-06-18 22:51:56,REAL,2856303884,7018,2856310902,2861976641
2025-06-18 22:51:58,REAL,2856310902,490,2856311392,2861977131
2025-06-18 22:52:00,REAL,2856311392,478,2856311870,2861977609
2025-06-18 22:52:02,REAL,2856311870,490,2856312360,2861978099
2025-06-18 22:52:04,FAKE,2856312360,241,2856312601,2861978578
2025-06-18 22:52:06,REAL,2856312601,479,2856313080,2861979057
2025-06-18 22:52:08,REAL,2856313080,492,2856313572,2861979549
2025-06-18 22:52:10,REAL,2856313572,490,2856314062,2861980039
2025-06-18 22:52:12,REAL,2856314062,485,2856314547,2861980524
2025-06-18 22:52:14,FAKE,2856314547,244,2856314791,2861981011
2025-06-18 22:52:16,FAKE,2856314791,241,2856315032,2861981502
2025-06-18 22:52:18,FAKE,2856315032,238,2856315270,2861982039
2025-06-18 22:52:20,FAKE,2856315270,238,2856315508,2861982518
2025-06-18 22:52:22,REAL,2856315508,485,2856315993,2861983003
2025-06-18 22:52:24,REAL,2856315993,487,2856316480,2861983490
2025-06-18 22:52:26,REAL,2856316480,484,2856316964,2861983974
2025-06-18 22:52:28,REAL,2856316964,539,2856317503,2861984513
2025-06-18 22:52:30,REAL,2856317503,481,2856317984,2861984994
2025-06-18 22:52:32,FAKE,2856317984,243,2856318227,2861985485
2025-06-18 22:52:34,FAKE,2856318227,244,2856318471,2861985966
2025-06-18 22:52:36,FAKE,2856318471,244,2856318715,2861986453
2025-06-18 22:52:38,REAL,2856318715,489,2856319204,2861986942
2025-06-18 22:52:40,FAKE,2856319204,238,2856319442,2861987422
2025-06-18 22:52:42,FAKE,2856319442,244,2856319686,2861987900
2025-06-18 22:52:44,REAL,2856319686,488,2856320174,2861988388
2025-06-18 22:52:46,REAL,2856320174,14503,2856334677,2862002891
2025-06-18 22:52:48,REAL,2856334677,10252,2856344929,2862013143
2025-06-18 22:52:50,REAL,2856344929,10319,2856355248,2862023462
2025-06-18 22:52:52,REAL,2856355248,10249,2856365497,2862033711
2025-06-18 22:52:54,REAL,2856365497,10252,2856375749,2862043963
2025-06-18 22:52:56,REAL,2856375749,10252,2856386001,2862054215
2025-06-18 22:52:58,REAL,2856386001,10323,2856396324,2862064538
2025-06-18 22:53:00,REAL,2856396324,5765,2856402089,2862070303
2025-06-18 22:53:02,REAL,2856402089,547,2856402636,2862070850
2025-06-18 22:53:04,FAKE,2856402636,241,2856402877,2862071331
2025-06-18 22:53:06,REAL,2856402877,488,2856403365,2862071819
2025-06-18 22:53:08,FAKE,2856403365,244,2856403609,2862072304
2025-06-18 22:53:10,REAL,2856403609,485,2856404094,2862072789
2025-06-18 22:53:12,FAKE,2856404094,238,2856404332,2862073272
2025-06-18 22:53:14,REAL,2856404332,485,2856404817,2862073757
2025-06-18 22:53:16,FAKE,2856404817,243,2856405060,2862074239
2025-06-18 22:53:18,FAKE,2856405060,244,2856405304,2862074718
2025-06-18 22:53:20,FAKE,2856405304,238,2856405542,2862075206
2025-06-18 22:53:22,REAL,2856405542,482,2856406024,2862075688
2025-06-18 22:53:24,REAL,2856406024,487,2856406511,2862076175
2025-06-18 22:53:26,REAL,2856406511,483,2856406994,2862076658
2025-06-18 22:53:28,REAL,2856406994,482,2856407476,2862077140
2025-06-18 22:53:30,REAL,2856407476,477,2856407953,2862077617
2025-06-18 22:53:32,REAL,2856407953,540,2856408493,2862078157
2025-06-18 22:53:34,REAL,2856408493,479,2856408972,2862078636
2025-06-18 22:53:36,FAKE,2856408972,243,2856409215,2862079113
2025-06-18 22:53:38,REAL,2856409215,483,2856409698,2862079596
2025-06-18 22:53:40,FAKE,2856409698,244,2856409942,2862080079
2025-06-18 22:53:42,REAL,2856409942,484,2856410426,2862080563
2025-06-18 22:53:44,REAL,2856410426,543,2856410969,2862081106
2025-06-18 22:53:46,REAL,2856410969,490,2856411459,2862081596
2025-06-18 22:53:48,REAL,2856411459,480,2856411939,2862082076
2025-06-18 22:53:50,REAL,2856411939,490,2856412429,2862082566
2025-06-18 22:53:52,REAL,2856412429,484,2856412913,2862083050
2025-06-18 22:53:54,REAL,2856412913,485,2856413398,2862083535
2025-06-18 22:53:56,REAL,2856413398,484,2856413882,2862084019
2025-06-18 22:53:58,REAL,2856413882,1280,2856415162,2862085299
2025-06-18 22:54:00,FAKE,2856415162,241,2856415403,2862097266
2025-06-18 22:54:02,REAL,2856415403,10255,2856425658,2862107521
2025-06-18 22:54:04,REAL,2856425658,10251,2856435909,2862117772
2025-06-18 22:54:06,REAL,2856435909,10252,2856446161,2862128024
2025-06-18 22:54:08,REAL,2856446161,10250,2856456411,2862138274
2025-06-18 22:54:10,FAKE,2856456411,243,2856456654,2862148521
2025-06-18 22:54:12,REAL,2856456654,10250,2856466904,2862158771
2025-06-18 22:54:14,REAL,2856466904,4519,2856471423,2862163290
2025-06-18 22:54:16,REAL,2856471423,481,2856471904,2862163771
2025-06-18 22:54:18,REAL,2856471904,491,2856472395,2862164262
2025-06-18 22:54:20,FAKE,2856472395,241,2856472636,2862164742
2025-06-18 22:54:22,FAKE,2856472636,244,2856472880,2862165227
2025-06-18 22:54:24,FAKE,2856472880,241,2856473121,2862165714
2025-06-18 22:54:26,FAKE,2856473121,238,2856473359,2862166196
2025-06-18 22:54:28,FAKE,2856473359,244,2856473603,2862166684
2025-06-18 22:54:30,REAL,2856473603,2593,2856476196,2862169277
2025-06-18 22:54:32,FAKE,2856476196,238,2856476434,2862181385
2025-06-18 22:54:34,REAL,2856476434,10249,2856486683,2862191634
2025-06-18 22:54:36,REAL,2856486683,10260,2856496943,2862201894
2025-06-18 22:54:38,FAKE,2856496943,241,2856497184,2862212211
2025-06-18 22:54:40,REAL,2856497184,10252,2856507436,2862222463
2025-06-18 22:54:42,REAL,2856507436,10252,2856517688,2862232715
2025-06-18 22:54:44,REAL,2856517688,10450,2856528138,2862243165
2025-06-18 22:54:46,REAL,2856528138,3724,2856531862,2862246889
2025-06-18 22:54:48,REAL,2856531862,478,2856532340,2862247367
2025-06-18 22:54:50,REAL,2856532340,480,2856532820,2862247847
2025-06-18 22:54:52,FAKE,2856532820,241,2856533061,2862248328
2025-06-18 22:54:54,REAL,2856533061,485,2856533546,2862248813
2025-06-18 22:54:56,REAL,2856533546,492,2856534038,2862249305
2025-06-18 22:54:58,REAL,2856534038,485,2856534523,2862249790
2025-06-18 22:55:00,FAKE,2856534523,241,2856534764,2862250275
2025-06-18 22:55:02,REAL,2856534764,2942,2856537706,2862253217
2025-06-18 22:55:04,REAL,2856537706,11246,2856548952,2862264463
2025-06-18 22:55:06,FAKE,2856548952,238,2856549190,2862274783
2025-06-18 22:55:08,REAL,2856549190,10180,2856559370,2862284963
2025-06-18 22:55:10,REAL,2856559370,10310,2856569680,2862295273
2025-06-18 22:55:12,FAKE,2856569680,243,2856569923,2862305528
2025-06-18 22:55:14,REAL,2856569923,10312,2856580235,2862315840
2025-06-18 22:55:16,REAL,2856580235,10252,2856590487,2862326092
2025-06-18 22:55:18,REAL,2856590487,3255,2856593742,2862329347
2025-06-18 22:55:20,FAKE,2856593742,238,2856593980,2862329832
2025-06-18 22:55:22,REAL,2856593980,479,2856594459,2862330311
2025-06-18 22:55:24,FAKE,2856594459,244,2856594703,2862330791
2025-06-18 22:55:26,REAL,2856594703,487,2856595190,2862331278
2025-06-18 22:55:28,REAL,2856595190,485,2856595675,2862331763
2025-06-18 22:55:30,REAL,2856595675,485,2856596160,2862332248
2025-06-18 22:55:32,REAL,2856596160,484,2856596644,2862332732
2025-06-18 22:55:34,FAKE,2856596644,238,2856596882,2862336459
2025-06-18 22:55:36,REAL,2856596882,10577,2856607459,2862347036
2025-06-18 22:55:38,REAL,2856607459,10315,2856617774,2862357351
2025-06-18 22:55:40,FAKE,2856617774,241,2856618015,2862367600
2025-06-18 22:55:42,REAL,2856618015,10319,2856628334,2862377919
2025-06-18 22:55:44,REAL,2856628334,10261,2856638595,2862388180
2025-06-18 22:55:46,FAKE,2856638595,243,2856638838,2862398496
2025-06-18 22:55:48,REAL,2856638838,10248,2856649086,2862408744
2025-06-18 22:55:50,FAKE,2856649086,243,2856649329,2862411338
2025-06-18 22:55:52,REAL,2856649329,480,2856649809,2862411818
2025-06-18 22:55:54,FAKE,2856649809,244,2856650053,2862412301
2025-06-18 22:55:56,REAL,2856650053,481,2856650534,2862412782
2025-06-18 22:55:58,FAKE,2856650534,241,2856650775,2862413267
2025-06-18 22:56:00,REAL,2856650775,542,2856651317,2862413809
2025-06-18 22:56:02,REAL,2856651317,484,2856651801,2862414293
2025-06-18 22:56:04,REAL,2856651801,476,2856652277,2862414769
2025-06-18 22:56:06,REAL,2856652277,4659,2856656936,2862419428
2025-06-18 22:56:08,FAKE,2856656936,244,2856657180,2862430809
2025-06-18 22:56:10,REAL,2856657180,10255,2856667435,2862441064
2025-06-18 22:56:12,REAL,2856667435,10251,2856677686,2862451315
2025-06-18 22:56:14,REAL,2856677686,10251,2856687937,2862461566
2025-06-18 22:56:16,REAL,2856687937,10315,2856698252,2862471881
2025-06-18 22:56:18,FAKE,2856698252,241,2856698493,2862482133
2025-06-18 22:56:20,REAL,2856698493,10260,2856708753,2862492393
2025-06-18 22:56:22,REAL,2856708753,2000,2856710753,2862494393
2025-06-18 22:56:24,REAL,2856710753,487,2856711240,2862494880
2025-06-18 22:56:26,REAL,2856711240,492,2856711732,2862495372
2025-06-18 22:56:28,REAL,2856711732,476,2856712208,2862495848
2025-06-18 22:56:30,REAL,2856712208,494,2856712702,2862496342
2025-06-18 22:56:32,REAL,2856712702,479,2856713181,2862496821
2025-06-18 22:56:34,FAKE,2856713181,241,2856713422,2862497306
2025-06-18 22:56:36,FAKE,2856713422,244,2856713666,2862497782
2025-06-18 22:56:38,FAKE,2856713666,241,2856713907,2862504353
2025-06-18 22:56:40,FAKE,2856713907,238,2856714145,2862517831
2025-06-18 22:56:42,REAL,2856714145,10246,2856724391,2862528077
2025-06-18 22:56:44,REAL,2856724391,10378,2856734769,2862538455
2025-06-18 22:56:46,FAKE,2856734769,238,2856735007,2862548708
2025-06-18 22:56:48,REAL,2856735007,10253,2856745260,2862558961
2025-06-18 22:56:50,REAL,2856745260,10249,2856755509,2862569210
2025-06-18 22:56:52,REAL,2856755509,10248,2856765757,2862579458
2025-06-18 22:56:54,REAL,2856765757,1337,2856767094,2862580795
2025-06-18 22:56:56,REAL,2856767094,480,2856767574,2862581275
2025-06-18 22:56:58,FAKE,2856767574,241,2856767815,2862581753
2025-06-18 22:57:00,FAKE,2856767815,238,2856768053,2862582234
2025-06-18 22:57:02,REAL,2856768053,491,2856768544,2862582725
2025-06-18 22:57:04,REAL,2856768544,480,2856769024,2862583205
2025-06-18 22:57:06,REAL,2856769024,481,2856769505,2862583686
2025-06-18 22:57:08,REAL,2856769505,489,2856769994,2862584175
2025-06-18 22:57:10,REAL,2856769994,484,2856770478,2862584659
2025-06-18 22:57:12,REAL,2856770478,479,2856770957,2862585138
2025-06-18 22:57:14,REAL,2856770957,476,2856771433,2862585614
2025-06-18 22:57:16,REAL,2856771433,15014,2856786447,2862600628
2025-06-18 22:57:18,REAL,2856786447,10249,2856796696,2862610877
2025-06-18 22:57:20,REAL,2856796696,10245,2856806941,2862621122
2025-06-18 22:57:22,FAKE,2856806941,243,2856807184,2862631382
2025-06-18 22:57:24,REAL,2856807184,10249,2856817433,2862641631
2025-06-18 22:57:26,REAL,2856817433,10314,2856827747,2862651945
2025-06-18 22:57:28,REAL,2856827747,10254,2856838001,2862662199
2025-06-18 22:57:30,FAKE,2856838001,238,2856838239,2862667764
2025-06-18 22:57:32,REAL,2856838239,485,2856838724,2862668249
2025-06-18 22:57:34,FAKE,2856838724,241,2856838965,2862668729
2025-06-18 22:57:36,REAL,2856838965,493,2856839458,2862669222
2025-06-18 22:57:38,FAKE,2856839458,243,2856839701,2862669696
2025-06-18 22:57:40,FAKE,2856839701,241,2856839942,2862670177
2025-06-18 22:57:42,FAKE,2856839942,241,2856840183,2862670667
2025-06-18 22:57:44,REAL,2856840183,480,2856840663,2862671147
2025-06-18 22:57:46,FAKE,2856840663,244,2856840907,2862671765
2025-06-18 22:57:48,REAL,2856840907,12171,2856853078,2862683936
2025-06-18 22:57:50,REAL,2856853078,10317,2856863395,2862694253
2025-06-18 22:57:52,REAL,2856863395,10256,2856873651,2862704509
2025-06-18 22:57:54,FAKE,2856873651,244,2856873895,2862714769
2025-06-18 22:57:56,REAL,2856873895,10247,2856884142,2862725016
2025-06-18 22:57:58,REAL,2856884142,10251,2856894393,2862735267
2025-06-18 22:58:00,REAL,2856894393,10249,2856904642,2862745516
2025-06-18 22:58:02,REAL,2856904642,4914,2856909556,2862750430
2025-06-18 22:58:04,REAL,2856909556,479,2856910035,2862750909
2025-06-18 22:58:06,REAL,2856910035,487,2856910522,2862751396
2025-06-18 22:58:08,REAL,2856910522,484,2856911006,2862751880
2025-06-18 22:58:10,REAL,2856911006,477,2856911483,2862752357
2025-06-18 22:58:12,REAL,2856911483,485,2856911968,2862752842
2025-06-18 22:58:14,REAL,2856911968,542,2856912510,2862753384
2025-06-18 22:58:16,FAKE,2856912510,243,2856912753,2862753875
2025-06-18 22:58:18,REAL,2856912753,475,2856913228,2862754350
2025-06-18 22:58:20,FAKE,2856913228,244,2856913472,2862754829
2025-06-18 22:58:22,REAL,2856913472,475,2856913947,2862755304
2025-06-18 22:58:24,FAKE,2856913947,241,2856914188,2862755788
2025-06-18 22:58:26,FAKE,2856914188,243,2856914431,2862756265
2025-06-18 22:58:28,REAL,2856914431,482,2856914913,2862756747
2025-06-18 22:58:30,REAL,2856914913,484,2856915397,2862757231
2025-06-18 22:58:32,FAKE,2856915397,238,2856915635,2862757723
2025-06-18 22:58:34,FAKE,2856915635,238,2856915873,2862758202
2025-06-18 22:58:36,REAL,2856915873,482,2856916355,2862758684
2025-06-18 22:58:38,REAL,2856916355,544,2856916899,2862759228
2025-06-18 22:58:40,REAL,2856916899,493,2856917392,2862759721
2025-06-18 22:58:42,FAKE,2856917392,244,2856917636,2862760202
2025-06-18 22:58:44,FAKE,2856917636,244,2856917880,2862760686
2025-06-18 22:58:46,FAKE,2856917880,244,2856918124,2862761173
2025-06-18 22:58:48,FAKE,2856918124,241,2856918365,2862761660
2025-06-18 22:58:50,REAL,2856918365,2217,2856920582,2862763877
2025-06-18 22:58:52,FAKE,2856920582,243,2856920825,2862778226
2025-06-18 22:58:54,FAKE,2856920825,244,2856921069,2862788484
2025-06-18 22:58:56,REAL,2856921069,10257,2856931326,2862798741
2025-06-18 22:58:58,REAL,2856931326,10323,2856941649,2862809064
2025-06-18 22:59:00,REAL,2856941649,10308,2856951957,2862819372
2025-06-18 22:59:02,FAKE,2856951957,241,2856952198,2862829622
2025-06-18 22:59:04,FAKE,2856952198,241,2856952439,2862839874
2025-06-18 22:59:06,REAL,2856952439,3716,2856956155,2862843590
2025-06-18 22:59:08,REAL,2856956155,486,2856956641,2862844076
2025-06-18 22:59:10,REAL,2856956641,488,2856957129,2862844564
2025-06-18 22:59:12,FAKE,2856957129,244,2856957373,2862845047
2025-06-18 22:59:14,REAL,2856957373,485,2856957858,2862845532
2025-06-18 22:59:16,FAKE,2856957858,238,2856958096,2862846011
2025-06-18 22:59:18,FAKE,2856958096,244,2856958340,2862846492
2025-06-18 22:59:20,REAL,2856958340,490,2856958830,2862846982
2025-06-18 22:59:22,FAKE,2856958830,244,2856959074,2862847471
2025-06-18 22:59:24,FAKE,2856959074,238,2856959312,2862847949
2025-06-18 22:59:26,REAL,2856959312,477,2856959789,2862848426
2025-06-18 22:59:28,REAL,2856959789,9209,2856968998,2862857635
2025-06-18 22:59:30,REAL,2856968998,10452,2856979450,2862868087
2025-06-18 22:59:32,REAL,2856979450,10323,2856989773,2862878410
2025-06-18 22:59:34,FAKE,2856989773,238,2856990011,2862888661
2025-06-18 22:59:36,REAL,2856990011,10245,2857000256,2862898906
2025-06-18 22:59:38,FAKE,2857000256,241,2857000497,2862909158
2025-06-18 22:59:40,REAL,2857000497,10318,2857010815,2862919476
2025-06-18 22:59:42,FAKE,2857010815,238,2857011053,2862927352
2025-06-18 22:59:44,REAL,2857011053,486,2857011539,2862927838
2025-06-18 22:59:46,REAL,2857011539,490,2857012029,2862928328
2025-06-18 22:59:48,REAL,2857012029,487,2857012516,2862928815
2025-06-18 22:59:50,FAKE,2857012516,243,2857012759,2862929301
2025-06-18 22:59:52,REAL,2857012759,486,2857013245,2862929787
2025-06-18 22:59:54,REAL,2857013245,541,2857013786,2862930328
2025-06-18 22:59:56,FAKE,2857013786,238,2857014024,2862930818
2025-06-18 22:59:58,FAKE,2857014024,238,2857014262,2862931301
2025-06-18 23:00:00,FAKE,2857014262,244,2857014506,2862940766
2025-06-18 23:00:02,FAKE,2857014506,238,2857014744,2862951212
2025-06-18 23:00:04,REAL,2857014744,10256,2857025000,2862961468
2025-06-18 23:00:06,REAL,2857025000,10318,2857035318,2862971786
2025-06-18 23:00:08,FAKE,2857035318,243,2857035561,2862982034
2025-06-18 23:00:10,REAL,2857035561,10256,2857045817,2862992290
2025-06-18 23:00:12,REAL,2857045817,10316,2857056133,2863002606
2025-06-18 23:00:14,REAL,2857056133,7280,2857063413,2863009886
2025-06-18 23:00:16,FAKE,2857063413,238,2857063651,2863010379
2025-06-18 23:00:18,FAKE,2857063651,243,2857063894,2863010860
2025-06-18 23:00:20,FAKE,2857063894,238,2857064132,2863011397
2025-06-18 23:00:22,REAL,2857064132,482,2857064614,2863011879
2025-06-18 23:00:24,FAKE,2857064614,238,2857064852,2863012356
2025-06-18 23:00:26,REAL,2857064852,486,2857065338,2863012842
2025-06-18 23:00:28,REAL,2857065338,487,2857065825,2863013329
2025-06-18 23:00:30,REAL,2857065825,241,2857066066,2863013570
2025-06-18 23:00:32,REAL,2857066066,489,2857066555,2863014059
2025-06-18 23:00:34,FAKE,2857066555,244,2857066799,2863014537
2025-06-18 23:00:36,REAL,2857066799,488,2857067287,2863015025
2025-06-18 23:00:38,FAKE,2857067287,243,2857067530,2863015506
2025-06-18 23:00:40,FAKE,2857067530,243,2857067773,2863015992
2025-06-18 23:00:42,REAL,2857067773,480,2857068253,2863016472
2025-06-18 23:00:44,REAL,2857068253,486,2857068739,2863016958
2025-06-18 23:00:46,REAL,2857068739,479,2857069218,2863017437
2025-06-18 23:00:48,REAL,2857069218,536,2857069754,2863017973
2025-06-18 23:00:50,REAL,2857069754,538,2857070292,2863018511
2025-06-18 23:00:52,FAKE,2857070292,241,2857070533,2863018999
2025-06-18 23:00:54,FAKE,2857070533,238,2857070771,2863019487
2025-06-18 23:00:56,REAL,2857070771,485,2857071256,2863019972
2025-06-18 23:00:58,REAL,2857071256,488,2857071744,2863020460
2025-06-18 23:01:00,REAL,2857071744,489,2857072233,2863020949
2025-06-18 23:01:02,REAL,2857072233,486,2857072719,2863021435
2025-06-18 23:01:04,FAKE,2857072719,238,2857072957,2863021927
2025-06-18 23:01:06,REAL,2857072957,489,2857073446,2863022416
2025-06-18 23:01:08,REAL,2857073446,490,2857073936,2863022906
2025-06-18 23:01:10,REAL,2857073936,477,2857074413,2863023383
2025-06-18 23:01:12,FAKE,2857074413,238,2857074651,2863023871
2025-06-18 23:01:14,FAKE,2857074651,244,2857074895,2863024407
2025-06-18 23:01:16,REAL,2857074895,483,2857075378,2863024890
2025-06-18 23:01:18,REAL,2857075378,481,2857075859,2863025371
2025-06-18 23:01:20,REAL,2857075859,487,2857076346,2863025858
2025-06-18 23:01:22,REAL,2857076346,486,2857076832,2863026344
2025-06-18 23:01:24,FAKE,2857076832,244,2857077076,2863026822
2025-06-18 23:01:26,REAL,2857077076,489,2857077565,2863027311
2025-06-18 23:01:28,REAL,2857077565,474,2857078039,2863027785
2025-06-18 23:01:30,REAL,2857078039,484,2857078523,2863028269
2025-06-18 23:01:32,FAKE,2857078523,243,2857078766,2863028758
2025-06-18 23:01:34,REAL,2857078766,481,2857079247,2863029239
2025-06-18 23:01:36,FAKE,2857079247,238,2857079485,2863044052
2025-06-18 23:01:38,REAL,2857079485,10310,2857089795,2863054362
2025-06-18 23:01:40,FAKE,2857089795,238,2857090033,2863064670
2025-06-18 23:01:42,REAL,2857090033,10314,2857100347,2863074984
2025-06-18 23:01:44,REAL,2857100347,10254,2857110601,2863085238
2025-06-18 23:01:46,FAKE,2857110601,243,2857110844,2863095486
2025-06-18 23:01:48,REAL,2857110844,10314,2857121158,2863105800
2025-06-18 23:01:50,REAL,2857121158,5500,2857126658,2863111300
2025-06-18 23:01:52,FAKE,2857126658,244,2857126902,2863111782
2025-06-18 23:01:54,REAL,2857126902,478,2857127380,2863112260
2025-06-18 23:01:56,REAL,2857127380,479,2857127859,2863112739
2025-06-18 23:01:58,REAL,2857127859,484,2857128343,2863113223
2025-06-18 23:02:00,FAKE,2857128343,241,2857128584,2863113703
2025-06-18 23:02:02,REAL,2857128584,483,2857129067,2863114186
2025-06-18 23:02:04,REAL,2857129067,480,2857129547,2863114666
2025-06-18 23:02:06,REAL,2857129547,533,2857130080,2863115199
2025-06-18 23:02:08,REAL,2857130080,485,2857130565,2863115684
2025-06-18 23:02:10,FAKE,2857130565,238,2857130803,2863116169
2025-06-18 23:02:12,REAL,2857130803,480,2857131283,2863116649
2025-06-18 23:02:14,FAKE,2857131283,244,2857131527,2863117142
2025-06-18 23:02:16,FAKE,2857131527,238,2857131765,2863117631
2025-06-18 23:02:18,REAL,2857131765,486,2857132251,2863118117
2025-06-18 23:02:20,FAKE,2857132251,244,2857132495,2863118607
2025-06-18 23:02:22,FAKE,2857132495,243,2857132738,2863119097
2025-06-18 23:02:24,REAL,2857132738,533,2857133271,2863119630
2025-06-18 23:02:26,REAL,2857133271,490,2857133761,2863120120
2025-06-18 23:02:28,FAKE,2857133761,241,2857134002,2863120604
2025-06-18 23:02:30,REAL,2857134002,483,2857134485,2863121087
2025-06-18 23:02:32,REAL,2857134485,488,2857134973,2863121575
2025-06-18 23:02:34,REAL,2857134973,536,2857135509,2863122111
2025-06-18 23:02:36,FAKE,2857135509,238,2857135747,2863122589
2025-06-18 23:02:38,FAKE,2857135747,243,2857135990,2863123074
2025-06-18 23:02:40,FAKE,2857135990,243,2857136233,2863123564
2025-06-18 23:02:42,REAL,2857136233,483,2857136716,2863124047
2025-06-18 23:02:44,REAL,2857136716,488,2857137204,2863124535
2025-06-18 23:02:46,REAL,2857137204,493,2857137697,2863125028
2025-06-18 23:02:48,REAL,2857137697,482,2857138179,2863125510
2025-06-18 23:02:50,REAL,2857138179,485,2857138664,2863125995
2025-06-18 23:02:52,REAL,2857138664,481,2857139145,2863126476
2025-06-18 23:02:54,FAKE,2857139145,238,2857139383,2863126961
2025-06-18 23:02:56,FAKE,2857139383,244,2857139627,2863127435
2025-06-18 23:02:58,REAL,2857139627,479,2857140106,2863127914
2025-06-18 23:03:00,FAKE,2857140106,241,2857140347,2863136181
2025-06-18 23:03:02,REAL,2857140347,10977,2857151324,2863147158
2025-06-18 23:03:04,REAL,2857151324,10248,2857161572,2863157406
2025-06-18 23:03:06,REAL,2857161572,10252,2857171824,2863167658
2025-06-18 23:03:08,REAL,2857171824,10313,2857182137,2863177971
2025-06-18 23:03:10,REAL,2857182137,10247,2857192384,2863188218
2025-06-18 23:03:12,REAL,2857192384,10259,2857202643,2863198477
2025-06-18 23:03:14,FAKE,2857202643,244,2857202887,2863207217
2025-06-18 23:03:16,REAL,2857202887,490,2857203377,2863207707
2025-06-18 23:03:18,REAL,2857203377,481,2857203858,2863208188
2025-06-18 23:03:20,REAL,2857203858,481,2857204339,2863208669
2025-06-18 23:03:22,FAKE,2857204339,238,2857204577,2863209159
2025-06-18 23:03:24,FAKE,2857204577,241,2857204818,2863209643
2025-06-18 23:03:26,REAL,2857204818,543,2857205361,2863210186
2025-06-18 23:03:28,REAL,2857205361,481,2857205842,2863210667
2025-06-18 23:03:30,REAL,2857205842,481,2857206323,2863211148
2025-06-18 23:03:32,REAL,2857206323,484,2857206807,2863211632
2025-06-18 23:03:34,FAKE,2857206807,243,2857207050,2863212114
2025-06-18 23:03:36,REAL,2857207050,481,2857207531,2863212595
2025-06-18 23:03:38,REAL,2857207531,491,2857208022,2863213086
2025-06-18 23:03:40,REAL,2857208022,483,2857208505,2863213569
2025-06-18 23:03:42,REAL,2857208505,479,2857208984,2863214048
2025-06-18 23:03:44,FAKE,2857208984,241,2857209225,2863214537
2025-06-18 23:03:46,REAL,2857209225,543,2857209768,2863215080
2025-06-18 23:03:48,REAL,2857209768,487,2857210255,2863215567
2025-06-18 23:03:50,REAL,2857210255,481,2857210736,2863216048
2025-06-18 23:03:52,REAL,2857210736,489,2857211225,2863216537
2025-06-18 23:03:54,FAKE,2857211225,241,2857211466,2863217081
2025-06-18 23:03:56,FAKE,2857211466,244,2857211710,2863217558
2025-06-18 23:03:58,REAL,2857211710,479,2857212189,2863218037
2025-06-18 23:04:00,FAKE,2857212189,238,2857212427,2863218515
2025-06-18 23:04:02,REAL,2857212427,481,2857212908,2863218996
2025-06-18 23:04:04,REAL,2857212908,12569,2857225477,2863231565
2025-06-18 23:04:06,FAKE,2857225477,244,2857225721,2863242808
2025-06-18 23:04:08,REAL,2857225721,10325,2857236046,2863253133
2025-06-18 23:04:10,REAL,2857236046,10248,2857246294,2863263381
2025-06-18 23:04:12,REAL,2857246294,10246,2857256540,2863273627
2025-06-18 23:04:14,REAL,2857256540,10317,2857266857,2863283944
2025-06-18 23:04:16,REAL,2857266857,10253,2857277110,2863294197
2025-06-18 23:04:18,REAL,2857277110,7414,2857284524,2863301611
2025-06-18 23:04:20,REAL,2857284524,491,2857285015,2863302102
2025-06-18 23:04:22,FAKE,2857285015,238,2857285253,2863302579
2025-06-18 23:04:24,FAKE,2857285253,243,2857285496,2863303070
2025-06-18 23:04:26,REAL,2857285496,484,2857285980,2863303554
2025-06-18 23:04:28,FAKE,2857285980,238,2857286218,2863304040
2025-06-18 23:04:30,FAKE,2857286218,238,2857286456,2863304529
2025-06-18 23:04:32,FAKE,2857286456,244,2857286700,2863305011
2025-06-18 23:04:34,FAKE,2857286700,243,2857286943,2863305500
2025-06-18 23:04:36,FAKE,2857286943,241,2857287184,2863316035
2025-06-18 23:04:38,REAL,2857287184,10457,2857297641,2863326492
2025-06-18 23:04:40,FAKE,2857297641,243,2857297884,2863336812
2025-06-18 23:04:42,REAL,2857297884,10244,2857308128,2863347056
2025-06-18 23:04:44,REAL,2857308128,10316,2857318444,2863357372
2025-06-18 23:04:46,REAL,2857318444,10245,2857328689,2863367617
2025-06-18 23:04:48,REAL,2857328689,10323,2857339012,2863377940
2025-06-18 23:04:50,REAL,2857339012,6754,2857345766,2863384694
2025-06-18 23:04:52,REAL,2857345766,483,2857346249,2863385177
2025-06-18 23:04:54,REAL,2857346249,485,2857346734,2863385662
2025-06-18 23:04:56,REAL,2857346734,484,2857347218,2863386146
2025-06-18 23:04:58,REAL,2857347218,477,2857347695,2863386623
2025-06-18 23:05:00,REAL,2857347695,480,2857348175,2863387103
2025-06-18 23:05:02,REAL,2857348175,494,2857348669,2863387597
2025-06-18 23:05:04,REAL,2857348669,484,2857349153,2863388081
2025-06-18 23:05:06,REAL,2857349153,492,2857349645,2863388573
2025-06-18 23:05:08,REAL,2857349645,10990,2857360635,2863399563
2025-06-18 23:05:10,REAL,2857360635,10326,2857370961,2863409889
2025-06-18 23:05:12,REAL,2857370961,10250,2857381211,2863420139
2025-06-18 23:05:14,REAL,2857381211,10258,2857391469,2863430397
2025-06-18 23:05:16,REAL,2857391469,10313,2857401782,2863440710
2025-06-18 23:05:18,REAL,2857401782,10255,2857412037,2863450965
2025-06-18 23:05:20,REAL,2857412037,10251,2857422288,2863461216
2025-06-18 23:05:22,REAL,2857422288,6221,2857428509,2863467437
2025-06-18 23:05:24,FAKE,2857428509,241,2857428750,2863467913
2025-06-18 23:05:26,REAL,2857428750,488,2857429238,2863468401
2025-06-18 23:05:28,FAKE,2857429238,238,2857429476,2863468881
2025-06-18 23:05:30,REAL,2857429476,475,2857429951,2863469356
2025-06-18 23:05:32,REAL,2857429951,483,2857430434,2863469839
2025-06-18 23:05:34,FAKE,2857430434,244,2857430678,2863470319
2025-06-18 23:05:36,FAKE,2857430678,244,2857430922,2863470857
2025-06-18 23:05:38,REAL,2857430922,492,2857431414,2863471349
2025-06-18 23:05:40,FAKE,2857431414,238,2857431652,2863483461
2025-06-18 23:05:42,FAKE,2857431652,244,2857431896,2863493775
2025-06-18 23:05:44,FAKE,2857431896,244,2857432140,2863504032
2025-06-18 23:05:46,REAL,2857432140,10245,2857442385,2863514277
2025-06-18 23:05:48,REAL,2857442385,11042,2857453427,2863525319
2025-06-18 23:05:50,REAL,2857453427,9527,2857462954,2863534846
2025-06-18 23:05:52,REAL,2857462954,10312,2857473266,2863545158
2025-06-18 23:05:54,FAKE,2857473266,241,2857473507,2863550715
2025-06-18 23:05:56,REAL,2857473507,490,2857473997,2863551205
2025-06-18 23:05:58,REAL,2857473997,485,2857474482,2863551690
2025-06-18 23:06:00,REAL,2857474482,494,2857474976,2863552184
2025-06-18 23:06:02,REAL,2857474976,483,2857475459,2863552667
2025-06-18 23:06:04,REAL,2857475459,493,2857475952,2863553160
2025-06-18 23:06:06,REAL,2857475952,490,2857476442,2863553650
2025-06-18 23:06:08,REAL,2857476442,482,2857476924,2863554132
2025-06-18 23:06:10,REAL,2857476924,493,2857477417,2863554625
2025-06-18 23:06:12,REAL,2857477417,486,2857477903,2863555111
2025-06-18 23:06:14,REAL,2857477903,482,2857478385,2863555593
2025-06-18 23:06:16,REAL,2857478385,491,2857478876,2863556084
2025-06-18 23:06:18,REAL,2857478876,481,2857479357,2863556565
2025-06-18 23:06:20,REAL,2857479357,491,2857479848,2863557056
2025-06-18 23:06:22,REAL,2857479848,475,2857480323,2863557531
2025-06-18 23:06:24,REAL,2857480323,483,2857480806,2863558014
2025-06-18 23:06:26,REAL,2857480806,594,2857481400,2863558608
2025-06-18 23:06:28,FAKE,2857481400,241,2857481641,2863559091
2025-06-18 23:06:30,REAL,2857481641,485,2857482126,2863559576
2025-06-18 23:06:32,REAL,2857482126,491,2857482617,2863560067
2025-06-18 23:06:34,REAL,2857482617,491,2857483108,2863560558
2025-06-18 23:06:36,REAL,2857483108,482,2857483590,2863561040
2025-06-18 23:06:38,FAKE,2857483590,244,2857483834,2863561528
2025-06-18 23:06:40,FAKE,2857483834,241,2857484075,2863562014
2025-06-18 23:06:42,REAL,2857484075,1555,2857485630,2863563569
2025-06-18 23:06:44,FAKE,2857485630,243,2857485873,2863575213
2025-06-18 23:06:46,REAL,2857485873,10251,2857496124,2863585464
2025-06-18 23:06:48,REAL,2857496124,10310,2857506434,2863595774
2025-06-18 23:06:50,FAKE,2857506434,243,2857506677,2863606029
2025-06-18 23:06:52,REAL,2857506677,10242,2857516919,2863616271
2025-06-18 23:06:54,REAL,2857516919,10250,2857527169,2863626521
2025-06-18 23:06:56,REAL,2857527169,10251,2857537420,2863636772
2025-06-18 23:06:58,FAKE,2857537420,244,2857537664,2863641089
2025-06-18 23:07:00,REAL,2857537664,488,2857538152,2863641577
2025-06-18 23:07:02,REAL,2857538152,479,2857538631,2863642056
2025-06-18 23:07:04,FAKE,2857538631,238,2857538869,2863642536
2025-06-18 23:07:06,REAL,2857538869,484,2857539353,2863643020
2025-06-18 23:07:08,FAKE,2857539353,238,2857539591,2863643500
2025-06-18 23:07:10,REAL,2857539591,486,2857540077,2863643986
2025-06-18 23:07:12,REAL,2857540077,482,2857540559,2863644468
2025-06-18 23:07:14,REAL,2857540559,2603,2857543162,2863647071
2025-06-18 23:07:16,REAL,2857543162,12294,2857555456,2863659365
2025-06-18 23:07:18,FAKE,2857555456,241,2857555697,2863669666
2025-06-18 23:07:20,FAKE,2857555697,238,2857555935,2863679977
2025-06-18 23:07:22,REAL,2857555935,10259,2857566194,2863690236
2025-06-18 23:07:24,REAL,2857566194,10259,2857576453,2863700495
2025-06-18 23:07:26,REAL,2857576453,10317,2857586770,2863710812
2025-06-18 23:07:28,REAL,2857586770,10251,2857597021,2863721063
2025-06-18 23:07:30,FAKE,2857597021,243,2857597264,2863724775
2025-06-18 23:07:32,REAL,2857597264,487,2857597751,2863725262
2025-06-18 23:07:34,REAL,2857597751,485,2857598236,2863725747
2025-06-18 23:07:36,FAKE,2857598236,244,2857598480,2863726240
2025-06-18 23:07:38,REAL,2857598480,477,2857598957,2863726717
2025-06-18 23:07:40,FAKE,2857598957,244,2857599201,2863727205
2025-06-18 23:07:42,FAKE,2857599201,238,2857599439,2863727686
2025-06-18 23:07:44,REAL,2857599439,492,2857599931,2863728178
2025-06-18 23:07:46,FAKE,2857599931,244,2857600175,2863731300
2025-06-18 23:07:48,REAL,2857600175,11645,2857611820,2863742945
2025-06-18 23:07:50,REAL,2857611820,10310,2857622130,2863753255
2025-06-18 23:07:52,REAL,2857622130,10317,2857632447,2863763572
2025-06-18 23:07:54,REAL,2857632447,10246,2857642693,2863773818
2025-06-18 23:07:56,REAL,2857642693,10328,2857653021,2863784146
2025-06-18 23:07:58,FAKE,2857653021,244,2857653265,2863794393
2025-06-18 23:08:00,REAL,2857653265,10311,2857663576,2863804704
2025-06-18 23:08:02,REAL,2857663576,3057,2857666633,2863807761
2025-06-18 23:08:04,REAL,2857666633,477,2857667110,2863808238
2025-06-18 23:08:06,REAL,2857667110,480,2857667590,2863808718
2025-06-18 23:08:08,REAL,2857667590,479,2857668069,2863809197
2025-06-18 23:08:10,FAKE,2857668069,243,2857668312,2863809733
2025-06-18 23:08:12,REAL,2857668312,480,2857668792,2863810213
2025-06-18 23:08:14,FAKE,2857668792,243,2857669035,2863810706
2025-06-18 23:08:16,REAL,2857669035,486,2857669521,2863811192
2025-06-18 23:08:18,REAL,2857669521,3726,2857673247,2863814918
2025-06-18 23:08:20,REAL,2857673247,13741,2857686988,2863828659
2025-06-18 23:08:22,FAKE,2857686988,243,2857687231,2863838979
2025-06-18 23:08:24,FAKE,2857687231,241,2857687472,2863849225
2025-06-18 23:08:26,REAL,2857687472,10251,2857697723,2863859476
2025-06-18 23:08:28,REAL,2857697723,10316,2857708039,2863869792
2025-06-18 23:08:30,REAL,2857708039,10258,2857718297,2863880050
2025-06-18 23:08:32,REAL,2857718297,10255,2857728552,2863890305
2025-06-18 23:08:34,FAKE,2857728552,243,2857728795,2863892764
2025-06-18 23:08:36,REAL,2857728795,490,2857729285,2863893254
2025-06-18 23:08:38,REAL,2857729285,487,2857729772,2863893741
2025-06-18 23:08:40,FAKE,2857729772,241,2857730013,2863894224
2025-06-18 23:08:42,REAL,2857730013,488,2857730501,2863894712
2025-06-18 23:08:44,REAL,2857730501,482,2857730983,2863895194
2025-06-18 23:08:46,REAL,2857730983,481,2857731464,2863895675
2025-06-18 23:08:48,FAKE,2857731464,243,2857731707,2863896163
2025-06-18 23:08:50,REAL,2857731707,488,2857732195,2863896651
2025-06-18 23:08:52,REAL,2857732195,481,2857732676,2863897132
2025-06-18 23:08:54,FAKE,2857732676,238,2857732914,2863897679
2025-06-18 23:08:56,REAL,2857732914,490,2857733404,2863898169
2025-06-18 23:08:58,FAKE,2857733404,244,2857733648,2863898653
2025-06-18 23:09:00,FAKE,2857733648,244,2857733892,2863899198
2025-06-18 23:09:02,REAL,2857733892,491,2857734383,2863899689
2025-06-18 23:09:04,FAKE,2857734383,244,2857734627,2863900177
2025-06-18 23:09:06,FAKE,2857734627,243,2857734870,2863900665
2025-06-18 23:09:08,FAKE,2857734870,244,2857735114,2863901148
2025-06-18 23:09:10,REAL,2857735114,483,2857735597,2863901631
2025-06-18 23:09:12,FAKE,2857735597,243,2857735840,2863902118
2025-06-18 23:09:14,FAKE,2857735840,238,2857736078,2863902600
2025-06-18 23:09:16,REAL,2857736078,483,2857736561,2863903083
2025-06-18 23:09:18,REAL,2857736561,481,2857737042,2863903564
2025-06-18 23:09:20,REAL,2857737042,483,2857737525,2863904047
2025-06-18 23:09:22,REAL,2857737525,5247,2857742772,2863909294
2025-06-18 23:09:24,FAKE,2857742772,244,2857743016,2863920414
2025-06-18 23:09:26,REAL,2857743016,10325,2857753341,2863930739
2025-06-18 23:09:28,REAL,2857753341,10249,2857763590,2863940988
2025-06-18 23:09:30,FAKE,2857763590,244,2857763834,2863951238
2025-06-18 23:09:32,REAL,2857763834,10315,2857774149,2863961553
2025-06-18 23:09:34,FAKE,2857774149,244,2857774393,2863971801
2025-06-18 23:09:36,REAL,2857774393,10321,2857784714,2863982122
2025-06-18 23:09:38,REAL,2857784714,1138,2857785852,2863983260
2025-06-18 23:09:40,REAL,2857785852,482,2857786334,2863983742
2025-06-18 23:09:42,REAL,2857786334,486,2857786820,2863984228
2025-06-18 23:09:44,FAKE,2857786820,238,2857787058,2863984771
2025-06-18 23:09:46,REAL,2857787058,481,2857787539,2863985252
2025-06-18 23:09:48,FAKE,2857787539,238,2857787777,2863985742
2025-06-18 23:09:50,REAL,2857787777,483,2857788260,2863986225
2025-06-18 23:09:52,REAL,2857788260,485,2857788745,2863986710
2025-06-18 23:09:54,REAL,2857788745,6227,2857794972,2863992937
2025-06-18 23:09:56,FAKE,2857794972,241,2857795213,2864004041
2025-06-18 23:09:58,REAL,2857795213,10259,2857805472,2864014300
2025-06-18 23:10:00,REAL,2857805472,10245,2857815717,2864024545
2025-06-18 23:10:02,REAL,2857815717,10252,2857825969,2864034797
2025-06-18 23:10:04,REAL,2857825969,10254,2857836223,2864045051
2025-06-18 23:10:06,FAKE,2857836223,243,2857836466,2864055376
2025-06-18 23:10:08,FAKE,2857836466,243,2857836709,2864065692
2025-06-18 23:10:10,FAKE,2857836709,244,2857836953,2864066180
2025-06-18 23:10:12,REAL,2857836953,484,2857837437,2864066664
2025-06-18 23:10:14,REAL,2857837437,490,2857837927,2864067154
2025-06-18 23:10:16,FAKE,2857837927,244,2857838171,2864067643
2025-06-18 23:10:18,FAKE,2857838171,238,2857838409,2864068134
2025-06-18 23:10:20,REAL,2857838409,478,2857838887,2864068612
2025-06-18 23:10:22,REAL,2857838887,489,2857839376,2864069101
2025-06-18 23:10:24,REAL,2857839376,484,2857839860,2864069585
2025-06-18 23:10:26,FAKE,2857839860,241,2857840101,2864070129
2025-06-18 23:10:28,REAL,2857840101,545,2857840646,2864070674
2025-06-18 23:10:30,REAL,2857840646,491,2857841137,2864071165
2025-06-18 23:10:32,REAL,2857841137,492,2857841629,2864071657
2025-06-18 23:10:34,REAL,2857841629,477,2857842106,2864072134
2025-06-18 23:10:36,FAKE,2857842106,243,2857842349,2864072622
2025-06-18 23:10:38,FAKE,2857842349,243,2857842592,2864073110
2025-06-18 23:10:40,REAL,2857842592,488,2857843080,2864073598
2025-06-18 23:10:42,FAKE,2857843080,241,2857843321,2864074081
2025-06-18 23:10:44,FAKE,2857843321,238,2857843559,2864074558
2025-06-18 23:10:46,REAL,2857843559,479,2857844038,2864075037
2025-06-18 23:10:48,REAL,2857844038,485,2857844523,2864075522
2025-06-18 23:10:50,FAKE,2857844523,238,2857844761,2864076003
2025-06-18 23:10:52,REAL,2857844761,479,2857845240,2864076482
2025-06-18 23:10:54,FAKE,2857845240,244,2857845484,2864076967
2025-06-18 23:10:56,REAL,2857845484,481,2857845965,2864077448
2025-06-18 23:10:58,FAKE,2857845965,238,2857846203,2864077936
2025-06-18 23:11:00,FAKE,2857846203,241,2857846444,2864078419
2025-06-18 23:11:02,REAL,2857846444,534,2857846978,2864078953
2025-06-18 23:11:04,REAL,2857846978,483,2857847461,2864079436
2025-06-18 23:11:06,REAL,2857847461,478,2857847939,2864079914
2025-06-18 23:11:08,REAL,2857847939,482,2857848421,2864080396
2025-06-18 23:11:10,REAL,2857848421,534,2857848955,2864080930
2025-06-18 23:11:12,FAKE,2857848955,241,2857849196,2864081413
2025-06-18 23:11:14,REAL,2857849196,486,2857849682,2864081899
2025-06-18 23:11:16,FAKE,2857849682,241,2857849923,2864082382
2025-06-18 23:11:18,FAKE,2857849923,244,2857850167,2864082864
2025-06-18 23:11:20,FAKE,2857850167,243,2857850410,2864083352
2025-06-18 23:11:22,REAL,2857850410,486,2857850896,2864083838
2025-06-18 23:11:24,REAL,2857850896,485,2857851381,2864084323
2025-06-18 23:11:26,REAL,2857851381,478,2857851859,2864084801
2025-06-18 23:11:28,REAL,2857851859,486,2857852345,2864085287
2025-06-18 23:11:30,FAKE,2857852345,238,2857852583,2864085775
2025-06-18 23:11:32,REAL,2857852583,485,2857853068,2864086260
2025-06-18 23:11:34,REAL,2857853068,484,2857853552,2864086744
2025-06-18 23:11:36,FAKE,2857853552,244,2857853796,2864087231
2025-06-18 23:11:38,FAKE,2857853796,243,2857854039,2864087778
2025-06-18 23:11:40,REAL,2857854039,484,2857854523,2864088262
2025-06-18 23:11:42,REAL,2857854523,483,2857855006,2864088745
2025-06-18 23:11:44,FAKE,2857855006,244,2857855250,2864089227
2025-06-18 23:11:46,FAKE,2857855250,241,2857855491,2864089704
2025-06-18 23:11:48,REAL,2857855491,486,2857855977,2864090190
2025-06-18 23:11:50,FAKE,2857855977,238,2857856215,2864093118
2025-06-18 23:11:52,REAL,2857856215,11895,2857868110,2864105013
2025-06-18 23:11:54,REAL,2857868110,10309,2857878419,2864115322
2025-06-18 23:11:56,REAL,2857878419,10251,2857888670,2864125573
2025-06-18 23:11:58,REAL,2857888670,10247,2857898917,2864135820
2025-06-18 23:12:00,REAL,2857898917,10248,2857909165,2864146068
2025-06-18 23:12:02,REAL,2857909165,10324,2857919489,2864156392
2025-06-18 23:12:04,REAL,2857919489,10256,2857929745,2864166648
2025-06-18 23:12:06,REAL,2857929745,3187,2857932932,2864169835
2025-06-18 23:12:08,REAL,2857932932,489,2857933421,2864170324
2025-06-18 23:12:10,REAL,2857933421,484,2857933905,2864170808
2025-06-18 23:12:12,FAKE,2857933905,241,2857934146,2864171287
2025-06-18 23:12:14,REAL,2857934146,489,2857934635,2864171776
2025-06-18 23:12:16,FAKE,2857934635,243,2857934878,2864172265
2025-06-18 23:12:18,REAL,2857934878,485,2857935363,2864172750
2025-06-18 23:12:20,FAKE,2857935363,241,2857935604,2864173232
2025-06-18 23:12:22,REAL,2857935604,482,2857936086,2864173714
2025-06-18 23:12:24,REAL,2857936086,540,2857936626,2864174254
2025-06-18 23:12:26,REAL,2857936626,490,2857937116,2864174744
2025-06-18 23:12:28,REAL,2857937116,477,2857937593,2864175221
2025-06-18 23:12:30,REAL,2857937593,490,2857938083,2864175711
2025-06-18 23:12:32,REAL,2857938083,483,2857938566,2864176194
2025-06-18 23:12:34,FAKE,2857938566,238,2857938804,2864176679
2025-06-18 23:12:36,REAL,2857938804,544,2857939348,2864177223
2025-06-18 23:12:38,REAL,2857939348,488,2857939836,2864177711
2025-06-18 23:12:40,REAL,2857939836,480,2857940316,2864178191
2025-06-18 23:12:42,FAKE,2857940316,244,2857940560,2864178677
2025-06-18 23:12:44,REAL,2857940560,476,2857941036,2864179153
2025-06-18 23:12:46,REAL,2857941036,479,2857941515,2864179632
2025-06-18 23:12:48,FAKE,2857941515,244,2857941759,2864180121
2025-06-18 23:12:50,FAKE,2857941759,241,2857942000,2864180605
2025-06-18 23:12:52,FAKE,2857942000,243,2857942243,2864181086
2025-06-18 23:12:54,REAL,2857942243,4383,2857946626,2864185469
2025-06-18 23:12:56,REAL,2857946626,11379,2857958005,2864196848
2025-06-18 23:12:58,REAL,2857958005,10256,2857968261,2864207104
2025-06-18 23:13:00,REAL,2857968261,10246,2857978507,2864217350
2025-06-18 23:13:02,FAKE,2857978507,241,2857978748,2864227672
2025-06-18 23:13:04,FAKE,2857978748,241,2857978989,2864237924
2025-06-18 23:13:06,FAKE,2857978989,244,2857979233,2864248168
2025-06-18 23:13:08,REAL,2857979233,10317,2857989550,2864258485
2025-06-18 23:13:10,REAL,2857989550,2004,2857991554,2864260489
2025-06-18 23:13:12,FAKE,2857991554,243,2857991797,2864260971
2025-06-18 23:13:14,REAL,2857991797,479,2857992276,2864261450
2025-06-18 23:13:16,REAL,2857992276,486,2857992762,2864261936
2025-06-18 23:13:18,FAKE,2857992762,244,2857993006,2864262480
2025-06-18 23:13:20,REAL,2857993006,481,2857993487,2864262961
2025-06-18 23:13:22,FAKE,2857993487,244,2857993731,2864263447
2025-06-18 23:13:24,FAKE,2857993731,244,2857993975,2864263933
2025-06-18 23:13:26,FAKE,2857993975,243,2857994218,2864269438
2025-06-18 23:13:28,REAL,2857994218,13484,2858007702,2864282922
2025-06-18 23:13:30,REAL,2858007702,10315,2858018017,2864293237
2025-06-18 23:13:32,REAL,2858018017,10254,2858028271,2864303491
2025-06-18 23:13:34,REAL,2858028271,10253,2858038524,2864313744
2025-06-18 23:13:36,REAL,2858038524,10253,2858048777,2864323997
2025-06-18 23:13:38,REAL,2858048777,10255,2858059032,2864334252
2025-06-18 23:13:40,REAL,2858059032,10322,2858069354,2864344574
2025-06-18 23:13:42,REAL,2858069354,1345,2858070699,2864345919
2025-06-18 23:13:44,FAKE,2858070699,238,2858070937,2864346404
2025-06-18 23:13:46,REAL,2858070937,483,2858071420,2864346887
2025-06-18 23:13:48,REAL,2858071420,484,2858071904,2864347371
2025-06-18 23:13:50,REAL,2858071904,485,2858072389,2864347856
2025-06-18 23:13:52,FAKE,2858072389,238,2858072627,2864348339
2025-06-18 23:13:54,REAL,2858072627,487,2858073114,2864348826
2025-06-18 23:13:56,FAKE,2858073114,243,2858073357,2864349304
2025-06-18 23:13:58,FAKE,2858073357,244,2858073601,2864349842
2025-06-18 23:14:00,REAL,2858073601,488,2858074089,2864350330
2025-06-18 23:14:02,REAL,2858074089,485,2858074574,2864350815
2025-06-18 23:14:04,REAL,2858074574,486,2858075060,2864351301
2025-06-18 23:14:06,REAL,2858075060,481,2858075541,2864351782
2025-06-18 23:14:08,REAL,2858075541,487,2858076028,2864352269
2025-06-18 23:14:10,REAL,2858076028,483,2858076511,2864352752
2025-06-18 23:14:12,FAKE,2858076511,243,2858076754,2864353236
2025-06-18 23:14:14,REAL,2858076754,476,2858077230,2864353712
2025-06-18 23:14:16,FAKE,2858077230,241,2858077471,2864354255
2025-06-18 23:14:18,REAL,2858077471,481,2858077952,2864354736
2025-06-18 23:14:20,FAKE,2858077952,241,2858078193,2864355275
2025-06-18 23:14:22,REAL,2858078193,475,2858078668,2864355750
2025-06-18 23:14:24,FAKE,2858078668,238,2858078906,2864356234
2025-06-18 23:14:26,REAL,2858078906,478,2858079384,2864356712
2025-06-18 23:14:28,REAL,2858079384,489,2858079873,2864357201
2025-06-18 23:14:30,REAL,2858079873,6166,2858086039,2864363367
2025-06-18 23:14:32,REAL,2858086039,10844,2858096883,2864374211
2025-06-18 23:14:34,REAL,2858096883,10255,2858107138,2864384466
2025-06-18 23:14:36,FAKE,2858107138,244,2858107382,2864394718
2025-06-18 23:14:38,REAL,2858107382,10251,2858117633,2864404969
2025-06-18 23:14:40,FAKE,2858117633,241,2858117874,2864415213
2025-06-18 23:14:42,REAL,2858117874,10372,2858128246,2864425585
2025-06-18 23:14:44,REAL,2858128246,9859,2858138105,2864435444
2025-06-18 23:14:46,REAL,2858138105,490,2858138595,2864435934
2025-06-18 23:14:48,REAL,2858138595,489,2858139084,2864436423
2025-06-18 23:14:50,REAL,2858139084,488,2858139572,2864436911
2025-06-18 23:14:52,FAKE,2858139572,244,2858139816,2864437403
2025-06-18 23:14:54,REAL,2858139816,487,2858140303,2864437890
2025-06-18 23:14:56,REAL,2858140303,487,2858140790,2864438377
2025-06-18 23:14:58,FAKE,2858140790,238,2858141028,2864438862
2025-06-18 23:15:00,REAL,2858141028,480,2858141508,2864439342
2025-06-18 23:15:02,REAL,2858141508,483,2858141991,2864439825
2025-06-18 23:15:04,REAL,2858141991,533,2858142524,2864440358
2025-06-18 23:15:06,REAL,2858142524,490,2858143014,2864440848
2025-06-18 23:15:08,REAL,2858143014,479,2858143493,2864441327
2025-06-18 23:15:10,FAKE,2858143493,244,2858143737,2864441812
2025-06-18 23:15:12,REAL,2858143737,489,2858144226,2864442301
2025-06-18 23:15:14,REAL,2858144226,482,2858144708,2864442783
2025-06-18 23:15:16,REAL,2858144708,490,2858145198,2864443273
2025-06-18 23:15:18,REAL,2858145198,487,2858145685,2864443760
2025-06-18 23:15:20,REAL,2858145685,538,2858146223,2864444298
2025-06-18 23:15:22,FAKE,2858146223,243,2858146466,2864444774
2025-06-18 23:15:24,FAKE,2858146466,238,2858146704,2864445262
2025-06-18 23:15:26,FAKE,2858146704,238,2858146942,2864445808
2025-06-18 23:15:28,FAKE,2858146942,243,2858147185,2864446293
2025-06-18 23:15:30,REAL,2858147185,480,2858147665,2864446773
2025-06-18 23:15:32,FAKE,2858147665,238,2858147903,2864447258
2025-06-18 23:15:34,REAL,2858147903,486,2858148389,2864447744
2025-06-18 23:15:36,FAKE,2858148389,241,2858148630,2864448228
2025-06-18 23:15:38,FAKE,2858148630,244,2858148874,2864448714
2025-06-18 23:15:40,FAKE,2858148874,243,2858149117,2864449193
2025-06-18 23:15:42,REAL,2858149117,481,2858149598,2864449674
2025-06-18 23:15:44,REAL,2858149598,475,2858150073,2864450149
2025-06-18 23:15:46,REAL,2858150073,488,2858150561,2864450637
2025-06-18 23:15:48,REAL,2858150561,477,2858151038,2864451114
2025-06-18 23:15:50,REAL,2858151038,536,2858151574,2864451650
2025-06-18 23:15:52,FAKE,2858151574,243,2858151817,2864452130
2025-06-18 23:15:54,REAL,2858151817,2927,2858154744,2864455057
2025-06-18 23:15:56,REAL,2858154744,11708,2858166452,2864466765
2025-06-18 23:15:58,REAL,2858166452,10255,2858176707,2864477020
2025-06-18 23:16:00,FAKE,2858176707,244,2858176951,2864487337
2025-06-18 23:16:02,REAL,2858176951,10260,2858187211,2864497597
2025-06-18 23:16:04,REAL,2858187211,10250,2858197461,2864507847
2025-06-18 23:16:06,REAL,2858197461,10321,2858207782,2864518168
2025-06-18 23:16:08,FAKE,2858207782,243,2858208025,2864528417
2025-06-18 23:16:10,REAL,2858208025,3388,2858211413,2864531805
2025-06-18 23:16:12,REAL,2858211413,535,2858211948,2864532340
2025-06-18 23:16:14,REAL,2858211948,491,2858212439,2864532831
2025-06-18 23:16:16,REAL,2858212439,485,2858212924,2864533316
2025-06-18 23:16:18,REAL,2858212924,485,2858213409,2864533801
2025-06-18 23:16:20,REAL,2858213409,483,2858213892,2864534284
2025-06-18 23:16:22,FAKE,2858213892,241,2858214133,2864534762
2025-06-18 23:16:24,REAL,2858214133,477,2858214610,2864535239
2025-06-18 23:16:26,REAL,2858214610,3589,2858218199,2864538828
2025-06-18 23:16:28,REAL,2858218199,11842,2858230041,2864550670
2025-06-18 23:16:30,FAKE,2858230041,238,2858230279,2864560990
2025-06-18 23:16:32,REAL,2858230279,10248,2858240527,2864571238
2025-06-18 23:16:34,FAKE,2858240527,238,2858240765,2864581605
2025-06-18 23:16:36,REAL,2858240765,10315,2858251080,2864591920
2025-06-18 23:16:38,REAL,2858251080,10258,2858261338,2864602178
2025-06-18 23:16:40,REAL,2858261338,10323,2858271661,2864612501
2025-06-18 23:16:42,FAKE,2858271661,238,2858271899,2864615287
2025-06-18 23:16:44,REAL,2858271899,480,2858272379,2864615767
2025-06-18 23:16:46,REAL,2858272379,480,2858272859,2864616247
2025-06-18 23:16:48,FAKE,2858272859,244,2858273103,2864616732
2025-06-18 23:16:50,REAL,2858273103,493,2858273596,2864617225
2025-06-18 23:16:52,FAKE,2858273596,238,2858273834,2864617706
2025-06-18 23:16:54,REAL,2858273834,488,2858274322,2864618194
2025-06-18 23:16:56,FAKE,2858274322,241,2858274563,2864618738
2025-06-18 23:16:58,REAL,2858274563,490,2858275053,2864619228
2025-06-18 23:17:00,FAKE,2858275053,238,2858275291,2864619711
2025-06-18 23:17:02,FAKE,2858275291,244,2858275535,2864620191
2025-06-18 23:17:04,REAL,2858275535,484,2858276019,2864620675
2025-06-18 23:17:06,FAKE,2858276019,241,2858276260,2864621164
2025-06-18 23:17:08,FAKE,2858276260,238,2858276498,2864621655
2025-06-18 23:17:10,REAL,2858276498,480,2858276978,2864622135
2025-06-18 23:17:12,REAL,2858276978,476,2858277454,2864622611
2025-06-18 23:17:14,FAKE,2858277454,241,2858277695,2864623099
2025-06-18 23:17:16,REAL,2858277695,478,2858278173,2864623577
2025-06-18 23:17:18,REAL,2858278173,600,2858278773,2864624177
2025-06-18 23:17:20,REAL,2858278773,486,2858279259,2864624663
2025-06-18 23:17:22,REAL,2858279259,238,2858279497,2864624901
2025-06-18 23:17:24,REAL,2858279497,480,2858279977,2864625381
2025-06-18 23:17:26,REAL,2858279977,479,2858280456,2864625860
2025-06-18 23:17:28,REAL,2858280456,482,2858280938,2864626342
2025-06-18 23:17:30,REAL,2858280938,4975,2858285913,2864631317
2025-06-18 23:17:32,REAL,2858285913,11186,2858297099,2864642503
2025-06-18 23:17:34,REAL,2858297099,10321,2858307420,2864652824
2025-06-18 23:17:36,REAL,2858307420,10247,2858317667,2864663071
2025-06-18 23:17:38,FAKE,2858317667,243,2858317910,2864673323
2025-06-18 23:17:40,REAL,2858317910,10369,2858328279,2864683692
2025-06-18 23:17:42,REAL,2858328279,10249,2858338528,2864693941
2025-06-18 23:17:44,REAL,2858338528,10251,2858348779,2864704192
2025-06-18 23:17:46,REAL,2858348779,1543,2858350322,2864705735
2025-06-18 23:17:48,FAKE,2858350322,243,2858350565,2864706222
2025-06-18 23:17:50,REAL,2858350565,486,2858351051,2864706708
2025-06-18 23:17:52,FAKE,2858351051,241,2858351292,2864707193
2025-06-18 23:17:54,FAKE,2858351292,241,2858351533,2864707683
2025-06-18 23:17:56,FAKE,2858351533,238,2858351771,2864708171
2025-06-18 23:17:58,REAL,2858351771,479,2858352250,2864708650
2025-06-18 23:18:00,REAL,2858352250,486,2858352736,2864709136
2025-06-18 23:18:02,REAL,2858352736,6296,2858359032,2864715432
2025-06-18 23:18:04,REAL,2858359032,11248,2858370280,2864726680
2025-06-18 23:18:06,FAKE,2858370280,238,2858370518,2864736926
2025-06-18 23:18:08,FAKE,2858370518,244,2858370762,2864747180
2025-06-18 23:18:10,FAKE,2858370762,244,2858371006,2864757494
2025-06-18 23:18:12,FAKE,2858371006,241,2858371247,2864767737
2025-06-18 23:18:14,REAL,2858371247,10255,2858381502,2864777992
2025-06-18 23:18:16,FAKE,2858381502,241,2858381743,2864788252
2025-06-18 23:18:18,FAKE,2858381743,241,2858381984,2864789131
2025-06-18 23:18:20,REAL,2858381984,486,2858382470,2864789617
2025-06-18 23:18:22,REAL,2858382470,476,2858382946,2864790093
2025-06-18 23:18:24,REAL,2858382946,541,2858383487,2864790634
2025-06-18 23:18:26,FAKE,2858383487,244,2858383731,2864791116
2025-06-18 23:18:28,REAL,2858383731,479,2858384210,2864791595
2025-06-18 23:18:30,REAL,2858384210,537,2858384747,2864792132
2025-06-18 23:18:32,REAL,2858384747,481,2858385228,2864792613
2025-06-18 23:18:34,REAL,2858385228,483,2858385711,2864793096
2025-06-18 23:18:36,FAKE,2858385711,244,2858385955,2864793586
2025-06-18 23:18:38,FAKE,2858385955,244,2858386199,2864794069
2025-06-18 23:18:40,REAL,2858386199,480,2858386679,2864794549
2025-06-18 23:18:42,REAL,2858386679,479,2858387158,2864795028
2025-06-18 23:18:44,REAL,2858387158,479,2858387637,2864795507
2025-06-18 23:18:46,FAKE,2858387637,238,2858387875,2864796048
2025-06-18 23:18:48,FAKE,2858387875,241,2858388116,2864796541
2025-06-18 23:18:50,REAL,2858388116,486,2858388602,2864797027
2025-06-18 23:18:52,FAKE,2858388602,244,2858388846,2864797512
2025-06-18 23:18:54,REAL,2858388846,486,2858389332,2864797998
2025-06-18 23:18:56,FAKE,2858389332,241,2858389573,2864798532
2025-06-18 23:18:58,REAL,2858389573,478,2858390051,2864799010
2025-06-18 23:19:00,REAL,2858390051,483,2858390534,2864799493
2025-06-18 23:19:02,REAL,2858390534,480,2858391014,2864799973
2025-06-18 23:19:04,FAKE,2858391014,241,2858391255,2864800451
2025-06-18 23:19:06,REAL,2858391255,7216,2858398471,2864807667
2025-06-18 23:19:08,REAL,2858398471,10710,2858409181,2864818377
2025-06-18 23:19:10,REAL,2858409181,10254,2858419435,2864828631
2025-06-18 23:19:12,REAL,2858419435,10321,2858429756,2864838952
2025-06-18 23:19:14,REAL,2858429756,10257,2858440013,2864849209
2025-06-18 23:19:16,FAKE,2858440013,241,2858440254,2864859462
2025-06-18 23:19:18,REAL,2858440254,10318,2858450572,2864869780
2025-06-18 23:19:20,REAL,2858450572,9394,2858459966,2864879174
2025-06-18 23:19:22,REAL,2858459966,488,2858460454,2864879662
2025-06-18 23:19:24,REAL,2858460454,484,2858460938,2864880146
2025-06-18 23:19:26,REAL,2858460938,480,2858461418,2864880626
2025-06-18 23:19:28,REAL,2858461418,484,2858461902,2864881110
2025-06-18 23:19:30,REAL,2858461902,484,2858462386,2864881594
2025-06-18 23:19:32,REAL,2858462386,545,2858462931,2864882139
2025-06-18 23:19:34,REAL,2858462931,543,2858463474,2864882682
2025-06-18 23:19:36,FAKE,2858463474,244,2858463718,2864883162
2025-06-18 23:19:38,REAL,2858463718,482,2858464200,2864883644
2025-06-18 23:19:40,REAL,2858464200,483,2858464683,2864884127
2025-06-18 23:19:42,REAL,2858464683,489,2858465172,2864884616
2025-06-18 23:19:44,FAKE,2858465172,241,2858465413,2864885097
2025-06-18 23:19:46,FAKE,2858465413,241,2858465654,2864885576
2025-06-18 23:19:48,REAL,2858465654,483,2858466137,2864886059
2025-06-18 23:19:50,FAKE,2858466137,244,2858466381,2864886539
2025-06-18 23:19:52,FAKE,2858466381,244,2858466625,2864887027
2025-06-18 23:19:54,FAKE,2858466625,241,2858466866,2864887507
2025-06-18 23:19:56,REAL,2858466866,482,2858467348,2864887989
2025-06-18 23:19:58,REAL,2858467348,485,2858467833,2864888474
2025-06-18 23:20:00,REAL,2858467833,545,2858468378,2864889019
2025-06-18 23:20:02,REAL,2858468378,486,2858468864,2864889505
2025-06-18 23:20:04,REAL,2858468864,480,2858469344,2864889985
2025-06-18 23:20:06,REAL,2858469344,482,2858469826,2864890467
2025-06-18 23:20:08,FAKE,2858469826,243,2858470069,2864890949
2025-06-18 23:20:10,FAKE,2858470069,244,2858470313,2864899631
2025-06-18 23:20:12,FAKE,2858470313,238,2858470551,2864910137
2025-06-18 23:20:14,REAL,2858470551,10251,2858480802,2864920388
2025-06-18 23:20:16,FAKE,2858480802,243,2858481045,2864930633
2025-06-18 23:20:18,FAKE,2858481045,244,2858481289,2864940883
2025-06-18 23:20:20,REAL,2858481289,10316,2858491605,2864951199
2025-06-18 23:20:22,FAKE,2858491605,244,2858491849,2864961502
2025-06-18 23:20:24,REAL,2858491849,8204,2858500053,2864969706
2025-06-18 23:20:26,REAL,2858500053,484,2858500537,2864970190
2025-06-18 23:20:28,FAKE,2858500537,244,2858500781,2864970673
2025-06-18 23:20:30,FAKE,2858500781,244,2858501025,2864971157
2025-06-18 23:20:32,FAKE,2858501025,243,2858501268,2864971642
2025-06-18 23:20:34,REAL,2858501268,486,2858501754,2864972128
2025-06-18 23:20:36,FAKE,2858501754,243,2858501997,2864972664
2025-06-18 23:20:38,REAL,2858501997,483,2858502480,2864973147
2025-06-18 23:20:40,REAL,2858502480,486,2858502966,2864973633
2025-06-18 23:20:42,FAKE,2858502966,241,2858503207,2864974124
2025-06-18 23:20:44,REAL,2858503207,492,2858503699,2864974616
2025-06-18 23:20:46,REAL,2858503699,481,2858504180,2864975097
2025-06-18 23:20:48,REAL,2858504180,481,2858504661,2864975578
2025-06-18 23:20:50,REAL,2858504661,488,2858505149,2864976066
2025-06-18 23:20:52,REAL,2858505149,482,2858505631,2864976548
2025-06-18 23:20:54,REAL,2858505631,490,2858506121,2864977038
2025-06-18 23:20:56,REAL,2858506121,492,2858506613,2864977530
2025-06-18 23:20:58,REAL,2858506613,486,2858507099,2864978016
2025-06-18 23:21:00,FAKE,2858507099,244,2858507343,2864978497
2025-06-18 23:21:02,REAL,2858507343,541,2858507884,2864979038
2025-06-18 23:21:04,REAL,2858507884,487,2858508371,2864979525
2025-06-18 23:21:06,REAL,2858508371,489,2858508860,2864980014
2025-06-18 23:21:08,REAL,2858508860,488,2858509348,2864980502
2025-06-18 23:21:10,REAL,2858509348,485,2858509833,2864980987
2025-06-18 23:21:12,FAKE,2858509833,244,2858510077,2864981529
2025-06-18 23:21:14,FAKE,2858510077,238,2858510315,2864982019
2025-06-18 23:21:16,REAL,2858510315,492,2858510807,2864982511
2025-06-18 23:21:18,REAL,2858510807,487,2858511294,2864982998
2025-06-18 23:21:20,FAKE,2858511294,243,2858511537,2864983484
2025-06-18 23:21:22,REAL,2858511537,490,2858512027,2864983974
2025-06-18 23:21:24,FAKE,2858512027,244,2858512271,2864984455
2025-06-18 23:21:26,REAL,2858512271,485,2858512756,2864984940
2025-06-18 23:21:28,REAL,2858512756,480,2858513236,2864985420
2025-06-18 23:21:30,REAL,2858513236,543,2858513779,2864985963
2025-06-18 23:21:32,REAL,2858513779,488,2858514267,2864986451
2025-06-18 23:21:34,FAKE,2858514267,243,2858514510,2864986935
2025-06-18 23:21:36,REAL,2858514510,489,2858514999,2864987424
2025-06-18 23:21:38,REAL,2858514999,484,2858515483,2864987908
2025-06-18 23:21:40,REAL,2858515483,485,2858515968,2864988393
2025-06-18 23:21:42,REAL,2858515968,493,2858516461,2864988886
2025-06-18 23:21:44,REAL,2858516461,484,2858516945,2864989370
2025-06-18 23:21:46,REAL,2858516945,479,2858517424,2864989849
2025-06-18 23:21:48,FAKE,2858517424,241,2858517665,2864990336
2025-06-18 23:21:50,FAKE,2858517665,243,2858517908,2864990820
2025-06-18 23:21:52,REAL,2858517908,481,2858518389,2864991301
2025-06-18 23:21:54,REAL,2858518389,489,2858518878,2864991790
2025-06-18 23:21:56,REAL,2858518878,542,2858519420,2864992332
2025-06-18 23:21:58,REAL,2858519420,483,2858519903,2864992815
2025-06-18 23:22:00,FAKE,2858519903,241,2858520144,2864993360
2025-06-18 23:22:02,REAL,2858520144,489,2858520633,2864993849
2025-06-18 23:22:04,FAKE,2858520633,241,2858520874,2864994334
2025-06-18 23:22:06,REAL,2858520874,480,2858521354,2864994814
2025-06-18 23:22:08,FAKE,2858521354,238,2858521592,2864995303
2025-06-18 23:22:10,REAL,2858521592,483,2858522075,2864995786
2025-06-18 23:22:12,REAL,2858522075,484,2858522559,2864996270
2025-06-18 23:22:14,REAL,2858522559,486,2858523045,2864996756
2025-06-18 23:22:16,REAL,2858523045,484,2858523529,2864997240
2025-06-18 23:22:18,REAL,2858523529,484,2858524013,2864997724
2025-06-18 23:22:20,FAKE,2858524013,243,2858524256,2864998213
2025-06-18 23:22:22,REAL,2858524256,549,2858524805,2864998762
2025-06-18 23:22:24,REAL,2858524805,491,2858525296,2864999253
2025-06-18 23:22:26,REAL,2858525296,481,2858525777,2864999734
2025-06-18 23:22:28,REAL,2858525777,485,2858526262,2865000219
2025-06-18 23:22:30,FAKE,2858526262,243,2858526505,2865000711
2025-06-18 23:22:32,FAKE,2858526505,241,2858526746,2865001191
2025-06-18 23:22:34,REAL,2858526746,480,2858527226,2865001671
2025-06-18 23:22:36,REAL,2858527226,491,2858527717,2865002162
2025-06-18 23:22:38,REAL,2858527717,478,2858528195,2865002640
2025-06-18 23:22:40,REAL,2858528195,484,2858528679,2865003124
2025-06-18 23:22:42,FAKE,2858528679,243,2858528922,2865003610
2025-06-18 23:22:44,REAL,2858528922,481,2858529403,2865004091
2025-06-18 23:22:46,REAL,2858529403,484,2858529887,2865004575
2025-06-18 23:22:48,FAKE,2858529887,244,2858530131,2865005066
2025-06-18 23:22:50,REAL,2858530131,536,2858530667,2865005602
2025-06-18 23:22:52,REAL,2858530667,477,2858531144,2865006079
2025-06-18 23:22:54,REAL,2858531144,6762,2858537906,2865012841
2025-06-18 23:22:56,FAKE,2858537906,241,2858538147,2865024019
2025-06-18 23:22:58,REAL,2858538147,10253,2858548400,2865034272
2025-06-18 23:23:00,FAKE,2858548400,238,2858548638,2865044587
2025-06-18 23:23:02,FAKE,2858548638,241,2858548879,2865054836
2025-06-18 23:23:04,FAKE,2858548879,241,2858549120,2865065081
2025-06-18 23:23:06,FAKE,2858549120,244,2858549364,2865075402
2025-06-18 23:23:08,REAL,2858549364,9861,2858559225,2865085263
2025-06-18 23:23:10,FAKE,2858559225,244,2858559469,2865085752
2025-06-18 23:23:12,REAL,2858559469,492,2858559961,2865086244
2025-06-18 23:23:14,REAL,2858559961,477,2858560438,2865086721
2025-06-18 23:23:16,REAL,2858560438,492,2858560930,2865087213
2025-06-18 23:23:18,FAKE,2858560930,244,2858561174,2865087692
2025-06-18 23:23:20,REAL,2858561174,487,2858561661,2865088179
2025-06-18 23:23:22,REAL,2858561661,485,2858562146,2865088664
2025-06-18 23:23:24,REAL,2858562146,482,2858562628,2865089146
2025-06-18 23:23:26,REAL,2858562628,484,2858563112,2865089630
2025-06-18 23:23:28,FAKE,2858563112,243,2858563355,2865090116
2025-06-18 23:23:30,REAL,2858563355,478,2858563833,2865090594
2025-06-18 23:23:32,FAKE,2858563833,241,2858564074,2865091082
2025-06-18 23:23:34,REAL,2858564074,482,2858564556,2865091564
2025-06-18 23:23:36,REAL,2858564556,485,2858565041,2865092049
2025-06-18 23:23:38,FAKE,2858565041,238,2858565279,2865092591
2025-06-18 23:23:40,REAL,2858565279,540,2858565819,2865093131
2025-06-18 23:23:42,FAKE,2858565819,244,2858566063,2865093611
2025-06-18 23:23:44,REAL,2858566063,490,2858566553,2865094101
2025-06-18 23:23:46,REAL,2858566553,487,2858567040,2865094588
2025-06-18 23:23:48,REAL,2858567040,478,2858567518,2865095066
2025-06-18 23:23:50,REAL,2858567518,482,2858568000,2865095548
2025-06-18 23:23:52,FAKE,2858568000,243,2858568243,2865096029
2025-06-18 23:23:54,FAKE,2858568243,243,2858568486,2865096513
2025-06-18 23:23:56,FAKE,2858568486,238,2858568724,2865097004
2025-06-18 23:23:58,REAL,2858568724,8083,2858576807,2865105087
2025-06-18 23:24:00,FAKE,2858576807,243,2858577050,2865115537
2025-06-18 23:24:02,REAL,2858577050,10249,2858587299,2865125786
2025-06-18 23:24:04,REAL,2858587299,10309,2858597608,2865136095
2025-06-18 23:24:06,REAL,2858597608,10255,2858607863,2865146350
2025-06-18 23:24:08,REAL,2858607863,10249,2858618112,2865156599
2025-06-18 23:24:10,REAL,2858618112,10313,2858628425,2865166912
2025-06-18 23:24:12,FAKE,2858628425,243,2858628668,2865175509
2025-06-18 23:24:14,REAL,2858628668,484,2858629152,2865175993
2025-06-18 23:24:16,REAL,2858629152,481,2858629633,2865176474
2025-06-18 23:24:18,REAL,2858629633,488,2858630121,2865176962
2025-06-18 23:24:20,REAL,2858630121,484,2858630605,2865177446
2025-06-18 23:24:22,FAKE,2858630605,241,2858630846,2865177931
2025-06-18 23:24:24,FAKE,2858630846,243,2858631089,2865178420
2025-06-18 23:24:26,REAL,2858631089,483,2858631572,2865178903
2025-06-18 23:24:28,REAL,2858631572,539,2858632111,2865179442
2025-06-18 23:24:30,REAL,2858632111,10590,2858642701,2865190032
2025-06-18 23:24:32,REAL,2858642701,11710,2858654411,2865201742
2025-06-18 23:24:34,REAL,2858654411,10248,2858664659,2865211990
2025-06-18 23:24:36,REAL,2858664659,10318,2858674977,2865222308
2025-06-18 23:24:38,FAKE,2858674977,241,2858675218,2865232554
2025-06-18 23:24:40,FAKE,2858675218,241,2858675459,2865242809
2025-06-18 23:24:42,REAL,2858675459,10254,2858685713,2865253063
2025-06-18 23:24:44,FAKE,2858685713,241,2858685954,2865261065
2025-06-18 23:24:46,FAKE,2858685954,244,2858686198,2865261553
2025-06-18 23:24:48,FAKE,2858686198,241,2858686439,2865262036
2025-06-18 23:24:50,REAL,2858686439,478,2858686917,2865262514
2025-06-18 23:24:52,FAKE,2858686917,238,2858687155,2865263003
2025-06-18 23:24:54,REAL,2858687155,484,2858687639,2865263487
2025-06-18 23:24:56,FAKE,2858687639,238,2858687877,2865264025
2025-06-18 23:24:58,REAL,2858687877,485,2858688362,2865264510
2025-06-18 23:25:00,REAL,2858688362,481,2858688843,2865264991
2025-06-18 23:25:02,REAL,2858688843,487,2858689330,2865265478
2025-06-18 23:25:04,FAKE,2858689330,238,2858689568,2865265963
2025-06-18 23:25:06,REAL,2858689568,484,2858690052,2865266447
2025-06-18 23:25:08,FAKE,2858690052,238,2858690290,2865266938
2025-06-18 23:25:10,FAKE,2858690290,243,2858690533,2865267426
2025-06-18 23:25:12,REAL,2858690533,482,2858691015,2865267908
2025-06-18 23:25:14,REAL,2858691015,478,2858691493,2865268386
2025-06-18 23:25:16,REAL,2858691493,549,2858692042,2865268935
2025-06-18 23:25:18,REAL,2858692042,487,2858692529,2865269422
2025-06-18 23:25:20,REAL,2858692529,485,2858693014,2865269907
2025-06-18 23:25:22,FAKE,2858693014,241,2858693255,2865270396
2025-06-18 23:25:24,REAL,2858693255,494,2858693749,2865270890
2025-06-18 23:25:26,REAL,2858693749,532,2858694281,2865271422
2025-06-18 23:25:28,REAL,2858694281,477,2858694758,2865271899
2025-06-18 23:25:30,REAL,2858694758,489,2858695247,2865272388
2025-06-18 23:25:32,REAL,2858695247,485,2858695732,2865272873
2025-06-18 23:25:34,REAL,2858695732,485,2858696217,2865273358
2025-06-18 23:25:36,REAL,2858696217,485,2858696702,2865273843
2025-06-18 23:25:38,REAL,2858696702,479,2858697181,2865274322
2025-06-18 23:25:40,REAL,2858697181,487,2858697668,2865274809
2025-06-18 23:25:42,REAL,2858697668,480,2858698148,2865275289
2025-06-18 23:25:44,REAL,2858698148,481,2858698629,2865275770
2025-06-18 23:25:46,REAL,2858698629,483,2858699112,2865276253
2025-06-18 23:25:48,REAL,2858699112,478,2858699590,2865276731
2025-06-18 23:25:50,REAL,2858699590,10655,2858710245,2865287386
2025-06-18 23:25:52,REAL,2858710245,10252,2858720497,2865297638
2025-06-18 23:25:54,REAL,2858720497,10311,2858730808,2865307949
2025-06-18 23:25:56,REAL,2858730808,10246,2858741054,2865318195
2025-06-18 23:25:58,FAKE,2858741054,241,2858741295,2865328512
2025-06-18 23:26:00,FAKE,2858741295,243,2858741538,2865338770
2025-06-18 23:26:02,REAL,2858741538,10318,2858751856,2865349088
2025-06-18 23:26:04,REAL,2858751856,6420,2858758276,2865355508
2025-06-18 23:26:06,REAL,2858758276,484,2858758760,2865355992
2025-06-18 23:26:08,REAL,2858758760,477,2858759237,2865356469
2025-06-18 23:26:10,REAL,2858759237,487,2858759724,2865356956
2025-06-18 23:26:12,FAKE,2858759724,244,2858759968,2865357447
2025-06-18 23:26:14,REAL,2858759968,481,2858760449,2865357928
2025-06-18 23:26:16,FAKE,2858760449,241,2858760690,2865358409
2025-06-18 23:26:18,REAL,2858760690,487,2858761177,2865358896
2025-06-18 23:26:20,REAL,2858761177,485,2858761662,2865359381
2025-06-18 23:26:22,REAL,2858761662,547,2858762209,2865359928
2025-06-18 23:26:24,REAL,2858762209,481,2858762690,2865360409
2025-06-18 23:26:26,FAKE,2858762690,243,2858762933,2865360898
2025-06-18 23:26:28,REAL,2858762933,476,2858763409,2865361374
2025-06-18 23:26:30,FAKE,2858763409,241,2858763650,2865361853
2025-06-18 23:26:32,FAKE,2858763650,243,2858763893,2865362329
2025-06-18 23:26:34,FAKE,2858763893,243,2858764136,2865362814
2025-06-18 23:26:36,FAKE,2858764136,241,2858764377,2865363352
2025-06-18 23:26:38,REAL,2858764377,484,2858764861,2865363836
2025-06-18 23:26:40,FAKE,2858764861,243,2858765104,2865364326
2025-06-18 23:26:42,FAKE,2858765104,241,2858765345,2865364801
2025-06-18 23:26:44,REAL,2858765345,483,2858765828,2865365284
2025-06-18 23:26:46,FAKE,2858765828,241,2858766069,2865365768
2025-06-18 23:26:48,REAL,2858766069,486,2858766555,2865366254
2025-06-18 23:26:50,REAL,2858766555,489,2858767044,2865366743
2025-06-18 23:26:52,REAL,2858767044,539,2858767583,2865367282
2025-06-18 23:26:54,REAL,2858767583,484,2858768067,2865367766
2025-06-18 23:26:56,REAL,2858768067,481,2858768548,2865368247
2025-06-18 23:26:58,REAL,2858768548,487,2858769035,2865368734
2025-06-18 23:27:00,FAKE,2858769035,241,2858769276,2865369221
2025-06-18 23:27:02,REAL,2858769276,486,2858769762,2865369707
2025-06-18 23:27:04,REAL,2858769762,483,2858770245,2865370190
2025-06-18 23:27:06,REAL,2858770245,478,2858770723,2865370668
2025-06-18 23:27:08,REAL,2858770723,484,2858771207,2865371152
2025-06-18 23:27:10,FAKE,2858771207,244,2858771451,2865371637
2025-06-18 23:27:12,REAL,2858771451,482,2858771933,2865372119
2025-06-18 23:27:14,REAL,2858771933,6783,2858778716,2865378902
2025-06-18 23:27:16,REAL,2858778716,10987,2858789703,2865389889
2025-06-18 23:27:18,FAKE,2858789703,241,2858789944,2865400208
2025-06-18 23:27:20,REAL,2858789944,10309,2858800253,2865410517
2025-06-18 23:27:22,REAL,2858800253,10317,2858810570,2865420834
2025-06-18 23:27:24,REAL,2858810570,10242,2858820812,2865431076
2025-06-18 23:27:26,REAL,2858820812,10787,2858831599,2865441863
2025-06-18 23:27:28,REAL,2858831599,9266,2858840865,2865451129
2025-06-18 23:27:30,REAL,2858840865,483,2858841348,2865451612
2025-06-18 23:27:32,REAL,2858841348,479,2858841827,2865452091
2025-06-18 23:27:34,FAKE,2858841827,241,2858842068,2865452571
2025-06-18 23:27:36,REAL,2858842068,486,2858842554,2865453057
2025-06-18 23:27:38,REAL,2858842554,486,2858843040,2865453543
2025-06-18 23:27:40,FAKE,2858843040,238,2858843278,2865454026
2025-06-18 23:27:42,REAL,2858843278,482,2858843760,2865454508
2025-06-18 23:27:44,REAL,2858843760,484,2858844244,2865454992
2025-06-18 23:27:46,FAKE,2858844244,238,2858844482,2865462348
2025-06-18 23:27:48,FAKE,2858844482,241,2858844723,2865473193
2025-06-18 23:27:50,FAKE,2858844723,244,2858844967,2865483447
2025-06-18 23:27:52,REAL,2858844967,10319,2858855286,2865493766
2025-06-18 23:27:54,REAL,2858855286,10257,2858865543,2865504023
2025-06-18 23:27:56,REAL,2858865543,10250,2858875793,2865514273
2025-06-18 23:27:58,FAKE,2858875793,244,2858876037,2865524594
2025-06-18 23:28:00,REAL,2858876037,9070,2858885107,2865533664
2025-06-18 23:28:02,REAL,2858885107,485,2858885592,2865534149
2025-06-18 23:28:04,FAKE,2858885592,244,2858885836,2865534627
2025-06-18 23:28:06,REAL,2858885836,484,2858886320,2865535111
2025-06-18 23:28:08,REAL,2858886320,483,2858886803,2865535594
2025-06-18 23:28:10,FAKE,2858886803,238,2858887041,2865536085
2025-06-18 23:28:12,REAL,2858887041,481,2858887522,2865536566
2025-06-18 23:28:14,REAL,2858887522,478,2858888000,2865537044
2025-06-18 23:28:16,REAL,2858888000,479,2858888479,2865537523
2025-06-18 23:28:18,FAKE,2858888479,238,2858888717,2865547708
2025-06-18 23:28:20,REAL,2858888717,12039,2858900756,2865559747
2025-06-18 23:28:22,REAL,2858900756,10245,2858911001,2865569992
2025-06-18 23:28:24,REAL,2858911001,10259,2858921260,2865580251
2025-06-18 23:28:26,FAKE,2858921260,241,2858921501,2865590561
2025-06-18 23:28:28,REAL,2858921501,10253,2858931754,2865600814
2025-06-18 23:28:30,REAL,2858931754,10250,2858942004,2865611064
2025-06-18 23:28:32,REAL,2858942004,8472,2858950476,2865619536
2025-06-18 23:28:34,FAKE,2858950476,244,2858950720,2865620018
2025-06-18 23:28:36,REAL,2858950720,485,2858951205,2865620503
2025-06-18 23:28:38,REAL,2858951205,484,2858951689,2865620987
2025-06-18 23:28:40,REAL,2858951689,486,2858952175,2865621473
2025-06-18 23:28:42,FAKE,2858952175,244,2858952419,2865621962
2025-06-18 23:28:44,FAKE,2858952419,244,2858952663,2865622441
2025-06-18 23:28:46,REAL,2858952663,550,2858953213,2865622991
2025-06-18 23:28:48,REAL,2858953213,476,2858953689,2865623467
2025-06-18 23:28:50,REAL,2858953689,489,2858954178,2865623956
2025-06-18 23:28:52,FAKE,2858954178,244,2858954422,2865624438
2025-06-18 23:28:54,REAL,2858954422,483,2858954905,2865624921
2025-06-18 23:28:56,REAL,2858954905,489,2858955394,2865625410
2025-06-18 23:28:58,FAKE,2858955394,241,2858955635,2865625892
2025-06-18 23:29:00,REAL,2858955635,482,2858956117,2865626374
2025-06-18 23:29:02,REAL,2858956117,484,2858956601,2865626858
2025-06-18 23:29:04,REAL,2858956601,536,2858957137,2865627394
2025-06-18 23:29:06,FAKE,2858957137,241,2858957378,2865627869
2025-06-18 23:29:08,FAKE,2858957378,238,2858957616,2865628358
2025-06-18 23:29:10,REAL,2858957616,476,2858958092,2865628834
2025-06-18 23:29:12,REAL,2858958092,477,2858958569,2865629311
2025-06-18 23:29:14,REAL,2858958569,483,2858959052,2865629794
2025-06-18 23:29:16,REAL,2858959052,486,2858959538,2865630280
2025-06-18 23:29:18,REAL,2858959538,487,2858960025,2865630767
2025-06-18 23:29:20,FAKE,2858960025,241,2858960266,2865631254
2025-06-18 23:29:22,FAKE,2858960266,244,2858960510,2865631745
2025-06-18 23:29:24,REAL,2858960510,483,2858960993,2865632228
2025-06-18 23:29:26,REAL,2858960993,485,2858961478,2865632713
2025-06-18 23:29:28,FAKE,2858961478,244,2858961722,2865633194
2025-06-18 23:29:30,FAKE,2858961722,243,2858961965,2865633731
2025-06-18 23:29:32,FAKE,2858961965,244,2858962209,2865634218
2025-06-18 23:29:34,FAKE,2858962209,243,2858962452,2865634703
2025-06-18 23:29:36,REAL,2858962452,490,2858962942,2865635193
2025-06-18 23:29:38,FAKE,2858962942,238,2858963180,2865645455
2025-06-18 23:29:40,REAL,2858963180,10448,2858973628,2865655903
2025-06-18 23:29:42,FAKE,2858973628,241,2858973869,2865666151
2025-06-18 23:29:44,FAKE,2858973869,244,2858974113,2865676466
2025-06-18 23:29:46,FAKE,2858974113,244,2858974357,2865686717
2025-06-18 23:29:48,REAL,2858974357,10315,2858984672,2865697032
2025-06-18 23:29:50,REAL,2858984672,10255,2858994927,2865707287
2025-06-18 23:29:52,REAL,2858994927,6888,2859001815,2865714175
2025-06-18 23:29:54,REAL,2859001815,488,2859002303,2865714663
2025-06-18 23:29:56,FAKE,2859002303,244,2859002547,2865715145
2025-06-18 23:29:58,FAKE,2859002547,244,2859002791,2865715628
2025-06-18 23:30:00,REAL,2859002791,482,2859003273,2865716110
2025-06-18 23:30:02,REAL,2859003273,475,2859003748,2865716585
2025-06-18 23:30:04,REAL,2859003748,481,2859004229,2865717066
2025-06-18 23:30:06,FAKE,2859004229,244,2859004473,2865717554
2025-06-18 23:30:08,REAL,2859004473,486,2859004959,2865718040
2025-06-18 23:30:10,REAL,2859004959,478,2859005437,2865718518
2025-06-18 23:30:12,REAL,2859005437,483,2859005920,2865719001
2025-06-18 23:30:14,REAL,2859005920,546,2859006466,2865719547
2025-06-18 23:30:16,FAKE,2859006466,241,2859006707,2865720027
2025-06-18 23:30:18,FAKE,2859006707,241,2859006948,2865720507
2025-06-18 23:30:20,FAKE,2859006948,241,2859007189,2865720989
2025-06-18 23:30:22,REAL,2859007189,489,2859007678,2865721478
2025-06-18 23:30:24,REAL,2859007678,541,2859008219,2865722019
2025-06-18 23:30:26,REAL,2859008219,488,2859008707,2865722507
2025-06-18 23:30:28,FAKE,2859008707,238,2859008945,2865722994
2025-06-18 23:30:30,REAL,2859008945,490,2859009435,2865723484
2025-06-18 23:30:32,REAL,2859009435,482,2859009917,2865723966
2025-06-18 23:30:34,REAL,2859009917,487,2859010404,2865724453
2025-06-18 23:30:36,REAL,2859010404,479,2859010883,2865724932
2025-06-18 23:30:38,FAKE,2859010883,243,2859011126,2865725412
2025-06-18 23:30:40,REAL,2859011126,478,2859011604,2865725890
2025-06-18 23:30:42,REAL,2859011604,481,2859012085,2865726371
2025-06-18 23:30:44,REAL,2859012085,483,2859012568,2865726854
2025-06-18 23:30:46,FAKE,2859012568,241,2859012809,2865727338
2025-06-18 23:30:48,REAL,2859012809,485,2859013294,2865727823
2025-06-18 23:30:50,FAKE,2859013294,244,2859013538,2865728309
2025-06-18 23:30:52,REAL,2859013538,486,2859014024,2865728795
2025-06-18 23:30:54,FAKE,2859014024,243,2859014267,2865729271
2025-06-18 23:30:56,FAKE,2859014267,238,2859014505,2865729750
2025-06-18 23:30:58,FAKE,2859014505,243,2859014748,2865730231
2025-06-18 23:31:00,REAL,2859014748,534,2859015282,2865730765
2025-06-18 23:31:02,FAKE,2859015282,244,2859015526,2865737333
2025-06-18 23:31:04,REAL,2859015526,10778,2859026304,2865748111
2025-06-18 23:31:06,REAL,2859026304,10312,2859036616,2865758423
2025-06-18 23:31:08,REAL,2859036616,10258,2859046874,2865768681
2025-06-18 23:31:10,REAL,2859046874,10255,2859057129,2865778936
2025-06-18 23:31:12,REAL,2859057129,10325,2859067454,2865789261
2025-06-18 23:31:14,REAL,2859067454,10254,2859077708,2865799515
2025-06-18 23:31:16,REAL,2859077708,10186,2859087894,2865809701
2025-06-18 23:31:18,REAL,2859087894,493,2859088387,2865810194
2025-06-18 23:31:20,REAL,2859088387,486,2859088873,2865810680
2025-06-18 23:31:22,REAL,2859088873,484,2859089357,2865811164
2025-06-18 23:31:24,FAKE,2859089357,243,2859089600,2865811644
2025-06-18 23:31:26,REAL,2859089600,484,2859090084,2865812128
2025-06-18 23:31:28,REAL,2859090084,485,2859090569,2865812613
2025-06-18 23:31:30,REAL,2859090569,489,2859091058,2865813102
2025-06-18 23:31:32,REAL,2859091058,485,2859091543,2865813587
2025-06-18 23:31:34,REAL,2859091543,480,2859092023,2865814067
2025-06-18 23:31:36,REAL,2859092023,485,2859092508,2865814552
2025-06-18 23:31:38,FAKE,2859092508,244,2859092752,2865815035
2025-06-18 23:31:40,REAL,2859092752,480,2859093232,2865815515
2025-06-18 23:31:42,FAKE,2859093232,241,2859093473,2865815989
2025-06-18 23:31:44,FAKE,2859093473,241,2859093714,2865816531
2025-06-18 23:31:46,FAKE,2859093714,238,2859093952,2865817007
2025-06-18 23:31:48,REAL,2859093952,539,2859094491,2865817546
2025-06-18 23:31:50,FAKE,2859094491,244,2859094735,2865818028
2025-06-18 23:31:52,REAL,2859094735,494,2859095229,2865818522
2025-06-18 23:31:54,REAL,2859095229,483,2859095712,2865819005
2025-06-18 23:31:56,FAKE,2859095712,241,2859095953,2865819490
2025-06-18 23:31:58,REAL,2859095953,477,2859096430,2865819967
2025-06-18 23:32:00,REAL,2859096430,485,2859096915,2865820452
2025-06-18 23:32:02,REAL,2859096915,477,2859097392,2865820929
2025-06-18 23:32:04,REAL,2859097392,491,2859097883,2865821420
2025-06-18 23:32:06,FAKE,2859097883,244,2859098127,2865830299
2025-06-18 23:32:08,REAL,2859098127,12306,2859110433,2865842605
2025-06-18 23:32:10,FAKE,2859110433,241,2859110674,2865852917
2025-06-18 23:32:12,REAL,2859110674,10257,2859120931,2865863174
2025-06-18 23:32:14,FAKE,2859120931,243,2859121174,2865873429
2025-06-18 23:32:16,REAL,2859121174,10318,2859131492,2865883747
2025-06-18 23:32:18,FAKE,2859131492,243,2859131735,2865894003
2025-06-18 23:32:20,FAKE,2859131735,244,2859131979,2865902939
2025-06-18 23:32:22,REAL,2859131979,491,2859132470,2865903430
2025-06-18 23:32:24,REAL,2859132470,477,2859132947,2865903907
2025-06-18 23:32:26,REAL,2859132947,488,2859133435,2865904395
2025-06-18 23:32:28,REAL,2859133435,484,2859133919,2865904879
2025-06-18 23:32:30,REAL,2859133919,536,2859134455,2865905415
2025-06-18 23:32:32,REAL,2859134455,493,2859134948,2865905908
2025-06-18 23:32:34,REAL,2859134948,480,2859135428,2865906388
2025-06-18 23:32:36,REAL,2859135428,477,2859135905,2865906865
2025-06-18 23:32:38,REAL,2859135905,477,2859136382,2865907342
2025-06-18 23:32:40,REAL,2859136382,484,2859136866,2865907826
2025-06-18 23:32:42,REAL,2859136866,486,2859137352,2865908312
2025-06-18 23:32:44,REAL,2859137352,474,2859137826,2865908786
2025-06-18 23:32:46,FAKE,2859137826,238,2859138064,2865909267
2025-06-18 23:32:48,FAKE,2859138064,243,2859138307,2865909758
2025-06-18 23:32:50,REAL,2859138307,480,2859138787,2865910238
2025-06-18 23:32:52,REAL,2859138787,486,2859139273,2865910724
2025-06-18 23:32:54,FAKE,2859139273,243,2859139516,2865919988
2025-06-18 23:32:56,FAKE,2859139516,241,2859139757,2865930504
2025-06-18 23:32:58,REAL,2859139757,10321,2859150078,2865940825
2025-06-18 23:33:00,REAL,2859150078,10248,2859160326,2865951073
2025-06-18 23:33:02,FAKE,2859160326,241,2859160567,2865961319
2025-06-18 23:33:04,REAL,2859160567,10244,2859170811,2865971563
2025-06-18 23:33:06,REAL,2859170811,10252,2859181063,2865981815
2025-06-18 23:33:08,REAL,2859181063,8073,2859189136,2865989888
2025-06-18 23:33:10,FAKE,2859189136,238,2859189374,2865990366
2025-06-18 23:33:12,REAL,2859189374,483,2859189857,2865990849
2025-06-18 23:33:14,FAKE,2859189857,238,2859190095,2865994435
2025-06-18 23:33:16,REAL,2859190095,14343,2859204438,2866008778
2025-06-18 23:33:18,REAL,2859204438,10247,2859214685,2866019025
2025-06-18 23:33:20,REAL,2859214685,10253,2859224938,2866029278
2025-06-18 23:33:22,REAL,2859224938,10258,2859235196,2866039536
2025-06-18 23:33:24,REAL,2859235196,10251,2859245447,2866049787
2025-06-18 23:33:26,REAL,2859245447,10312,2859255759,2866060099
2025-06-18 23:33:28,REAL,2859255759,10253,2859266012,2866070352
2025-06-18 23:33:30,REAL,2859266012,2727,2859268739,2866073079
2025-06-18 23:33:32,FAKE,2859268739,244,2859268983,2866073553
2025-06-18 23:33:34,REAL,2859268983,482,2859269465,2866074035
2025-06-18 23:33:36,REAL,2859269465,542,2859270007,2866074577
2025-06-18 23:33:38,FAKE,2859270007,238,2859270245,2866075057
2025-06-18 23:33:40,REAL,2859270245,484,2859270729,2866075541
2025-06-18 23:33:42,FAKE,2859270729,243,2859270972,2866076020
2025-06-18 23:33:44,REAL,2859270972,481,2859271453,2866076501
2025-06-18 23:33:46,FAKE,2859271453,244,2859271697,2866081024
2025-06-18 23:33:48,REAL,2859271697,11848,2859283545,2866092872
2025-06-18 23:33:50,FAKE,2859283545,238,2859283783,2866103126
2025-06-18 23:33:52,REAL,2859283783,10314,2859294097,2866113440
2025-06-18 23:33:54,REAL,2859294097,10250,2859304347,2866123690
2025-06-18 23:33:56,FAKE,2859304347,244,2859304591,2866133934
2025-06-18 23:33:58,FAKE,2859304591,243,2859304834,2866144250
2025-06-18 23:34:00,FAKE,2859304834,243,2859305077,2866154561
2025-06-18 23:34:02,REAL,2859305077,2137,2859307214,2866156698
2025-06-18 23:34:04,REAL,2859307214,246,2859307460,2866156944
2025-06-18 23:34:06,REAL,2859307460,488,2859307948,2866157432
2025-06-18 23:34:08,FAKE,2859307948,241,2859308189,2866157971
2025-06-18 23:34:10,REAL,2859308189,483,2859308672,2866158454
2025-06-18 23:34:12,FAKE,2859308672,241,2859308913,2866158932
2025-06-18 23:34:14,REAL,2859308913,488,2859309401,2866159420
2025-06-18 23:34:16,REAL,2859309401,480,2859309881,2866159900
2025-06-18 23:34:18,REAL,2859309881,480,2859310361,2866160380
2025-06-18 23:34:20,REAL,2859310361,485,2859310846,2866160865
2025-06-18 23:34:22,REAL,2859310846,478,2859311324,2866161343
2025-06-18 23:34:24,REAL,2859311324,485,2859311809,2866161828
2025-06-18 23:34:26,REAL,2859311809,480,2859312289,2866162308
2025-06-18 23:34:28,REAL,2859312289,484,2859312773,2866162792
2025-06-18 23:34:30,REAL,2859312773,546,2859313319,2866163338
2025-06-18 23:34:32,REAL,2859313319,477,2859313796,2866163815
2025-06-18 23:34:34,REAL,2859313796,478,2859314274,2866164293
2025-06-18 23:34:36,REAL,2859314274,484,2859314758,2866164777
2025-06-18 23:34:38,FAKE,2859314758,238,2859314996,2866165261
2025-06-18 23:34:40,REAL,2859314996,11108,2859326104,2866176369
2025-06-18 23:34:42,REAL,2859326104,10253,2859336357,2866186622
2025-06-18 23:34:44,FAKE,2859336357,244,2859336601,2866196876
2025-06-18 23:34:46,REAL,2859336601,10304,2859346905,2866207180
2025-06-18 23:34:48,REAL,2859346905,10251,2859357156,2866217431
2025-06-18 23:34:50,FAKE,2859357156,243,2859357399,2866227743
2025-06-18 23:34:52,REAL,2859357399,10251,2859367650,2866237994
2025-06-18 23:34:54,FAKE,2859367650,244,2859367894,2866244023
2025-06-18 23:34:56,REAL,2859367894,475,2859368369,2866244498
2025-06-18 23:34:58,REAL,2859368369,486,2859368855,2866244984
2025-06-18 23:35:00,FAKE,2859368855,238,2859369093,2866245520
2025-06-18 23:35:02,REAL,2859369093,482,2859369575,2866246002
2025-06-18 23:35:04,REAL,2859369575,483,2859370058,2866246485
2025-06-18 23:35:06,REAL,2859370058,482,2859370540,2866246967
2025-06-18 23:35:08,REAL,2859370540,488,2859371028,2866247455
2025-06-18 23:35:10,REAL,2859371028,485,2859371513,2866247940
2025-06-18 23:35:12,FAKE,2859371513,241,2859371754,2866259913
2025-06-18 23:35:14,REAL,2859371754,10244,2859381998,2866270157
2025-06-18 23:35:16,FAKE,2859381998,241,2859382239,2866280475
2025-06-18 23:35:18,REAL,2859382239,10257,2859392496,2866290732
2025-06-18 23:35:20,REAL,2859392496,10247,2859402743,2866300979
2025-06-18 23:35:22,FAKE,2859402743,243,2859402986,2866311294
2025-06-18 23:35:24,REAL,2859402986,10261,2859413247,2866321555
2025-06-18 23:35:26,FAKE,2859413247,238,2859413485,2866326988
2025-06-18 23:35:28,REAL,2859413485,485,2859413970,2866327473
2025-06-18 23:35:30,FAKE,2859413970,243,2859414213,2866327953
2025-06-18 23:35:32,REAL,2859414213,6700,2859420913,2866334653
2025-06-18 23:35:34,REAL,2859420913,11006,2859431919,2866345659
2025-06-18 23:35:36,FAKE,2859431919,244,2859432163,2866355908
2025-06-18 23:35:38,FAKE,2859432163,241,2859432404,2866366156
2025-06-18 23:35:40,REAL,2859432404,10252,2859442656,2866376408
2025-06-18 23:35:42,REAL,2859442656,10319,2859452975,2866386727
2025-06-18 23:35:44,REAL,2859452975,10249,2859463224,2866396976
2025-06-18 23:35:46,REAL,2859463224,9995,2859473219,2866406971
2025-06-18 23:35:48,REAL,2859473219,492,2859473711,2866407463
2025-06-18 23:35:50,REAL,2859473711,484,2859474195,2866407947
2025-06-18 23:35:52,REAL,2859474195,478,2859474673,2866408425
2025-06-18 23:35:54,FAKE,2859474673,238,2859474911,2866408960
2025-06-18 23:35:56,REAL,2859474911,485,2859475396,2866409445
2025-06-18 23:35:58,REAL,2859475396,483,2859475879,2866409928
2025-06-18 23:36:00,REAL,2859475879,487,2859476366,2866410415
2025-06-18 23:36:02,REAL,2859476366,487,2859476853,2866410902
2025-06-18 23:36:04,REAL,2859476853,489,2859477342,2866411391
2025-06-18 23:36:06,REAL,2859477342,491,2859477833,2866411882
2025-06-18 23:36:08,FAKE,2859477833,244,2859478077,2866412367
2025-06-18 23:36:10,REAL,2859478077,488,2859478565,2866412855
2025-06-18 23:36:12,REAL,2859478565,490,2859479055,2866413345
2025-06-18 23:36:14,REAL,2859479055,494,2859479549,2866413839
2025-06-18 23:36:16,REAL,2859479549,543,2859480092,2866414382
2025-06-18 23:36:18,REAL,2859480092,542,2859480634,2866414924
2025-06-18 23:36:20,REAL,2859480634,490,2859481124,2866415414
2025-06-18 23:36:22,REAL,2859481124,479,2859481603,2866415893
2025-06-18 23:36:24,FAKE,2859481603,241,2859481844,2866416377
2025-06-18 23:36:26,FAKE,2859481844,238,2859482082,2866416857
2025-06-18 23:36:28,REAL,2859482082,492,2859482574,2866417349
2025-06-18 23:36:30,FAKE,2859482574,238,2859482812,2866417835
2025-06-18 23:36:32,REAL,2859482812,486,2859483298,2866418321
2025-06-18 23:36:34,FAKE,2859483298,238,2859483536,2866418806
2025-06-18 23:36:36,REAL,2859483536,484,2859484020,2866419290
2025-06-18 23:36:38,REAL,2859484020,541,2859484561,2866419831
2025-06-18 23:36:40,REAL,2859484561,489,2859485050,2866420320
2025-06-18 23:36:42,REAL,2859485050,476,2859485526,2866420796
2025-06-18 23:36:44,FAKE,2859485526,238,2859485764,2866421273
2025-06-18 23:36:46,REAL,2859485764,484,2859486248,2866421757
2025-06-18 23:36:48,REAL,2859486248,491,2859486739,2866422248
2025-06-18 23:36:50,FAKE,2859486739,244,2859486983,2866422737
2025-06-18 23:36:52,REAL,2859486983,475,2859487458,2866423212
2025-06-18 23:36:54,REAL,2859487458,477,2859487935,2866423689
2025-06-18 23:36:56,REAL,2859487935,486,2859488421,2866424175
2025-06-18 23:36:58,FAKE,2859488421,243,2859488664,2866424658
2025-06-18 23:37:00,FAKE,2859488664,243,2859488907,2866425191
2025-06-18 23:37:02,FAKE,2859488907,244,2859489151,2866425675
2025-06-18 23:37:04,REAL,2859489151,487,2859489638,2866426162
2025-06-18 23:37:06,REAL,2859489638,542,2859490180,2866426704
2025-06-18 23:37:08,REAL,2859490180,482,2859490662,2866427186
2025-06-18 23:37:10,FAKE,2859490662,243,2859490905,2866427671
2025-06-18 23:37:12,REAL,2859490905,488,2859491393,2866428159
2025-06-18 23:37:14,REAL,2859491393,481,2859491874,2866428640
2025-06-18 23:37:16,REAL,2859491874,487,2859492361,2866429127
2025-06-18 23:37:18,FAKE,2859492361,244,2859492605,2866429615
2025-06-18 23:37:20,FAKE,2859492605,243,2859492848,2866430153
2025-06-18 23:37:22,REAL,2859492848,481,2859493329,2866430634
2025-06-18 23:37:24,REAL,2859493329,9071,2859502400,2866439705
2025-06-18 23:37:26,REAL,2859502400,10650,2859513050,2866450355
2025-06-18 23:37:28,FAKE,2859513050,243,2859513293,2866460613
2025-06-18 23:37:30,REAL,2859513293,10318,2859523611,2866470931
2025-06-18 23:37:32,REAL,2859523611,10248,2859533859,2866481179
2025-06-18 23:37:34,REAL,2859533859,10253,2859544112,2866491432
2025-06-18 23:37:36,REAL,2859544112,10314,2859554426,2866501746
2025-06-18 23:37:38,REAL,2859554426,7747,2859562173,2866509493
2025-06-18 23:37:40,REAL,2859562173,489,2859562662,2866509982
2025-06-18 23:37:42,FAKE,2859562662,241,2859562903,2866510473
2025-06-18 23:37:44,FAKE,2859562903,243,2859563146,2866510956
2025-06-18 23:37:46,FAKE,2859563146,244,2859563390,2866511503
2025-06-18 23:37:48,REAL,2859563390,482,2859563872,2866511985
2025-06-18 23:37:50,REAL,2859563872,484,2859564356,2866512469
2025-06-18 23:37:52,REAL,2859564356,477,2859564833,2866512946
2025-06-18 23:37:54,REAL,2859564833,547,2859565380,2866513493
2025-06-18 23:37:56,FAKE,2859565380,238,2859565618,2866513985
2025-06-18 23:37:58,REAL,2859565618,486,2859566104,2866514471
2025-06-18 23:38:00,FAKE,2859566104,244,2859566348,2866514959
2025-06-18 23:38:02,FAKE,2859566348,241,2859566589,2866515442
2025-06-18 23:38:04,FAKE,2859566589,243,2859566832,2866515925
2025-06-18 23:38:06,REAL,2859566832,486,2859567318,2866516411
2025-06-18 23:38:08,REAL,2859567318,485,2859567803,2866516896
2025-06-18 23:38:10,REAL,2859567803,478,2859568281,2866517374
2025-06-18 23:38:12,REAL,2859568281,486,2859568767,2866517860
2025-06-18 23:38:14,REAL,2859568767,483,2859569250,2866518343
2025-06-18 23:38:16,FAKE,2859569250,241,2859569491,2866518827
2025-06-18 23:38:18,REAL,2859569491,484,2859569975,2866519311
2025-06-18 23:38:20,FAKE,2859569975,243,2859570218,2866519797
2025-06-18 23:38:22,REAL,2859570218,483,2859570701,2866520280
2025-06-18 23:38:24,REAL,2859570701,491,2859571192,2866520771
2025-06-18 23:38:26,REAL,2859571192,491,2859571683,2866521262
2025-06-18 23:38:28,FAKE,2859571683,243,2859571926,2866521744
2025-06-18 23:38:30,REAL,2859571926,539,2859572465,2866522283
2025-06-18 23:38:32,FAKE,2859572465,238,2859572703,2866527328
2025-06-18 23:38:34,REAL,2859572703,14609,2859587312,2866541937
2025-06-18 23:38:36,FAKE,2859587312,244,2859587556,2866552193
2025-06-18 23:38:38,REAL,2859587556,10325,2859597881,2866562518
2025-06-18 23:38:40,FAKE,2859597881,238,2859598119,2866572820
2025-06-18 23:38:42,REAL,2859598119,10315,2859608434,2866583135
2025-06-18 23:38:44,FAKE,2859608434,243,2859608677,2866593387
2025-06-18 23:38:46,REAL,2859608677,10252,2859618929,2866603639
2025-06-18 23:38:48,FAKE,2859618929,243,2859619172,2866605245
2025-06-18 23:38:50,FAKE,2859619172,244,2859619416,2866605727
2025-06-18 23:38:52,REAL,2859619416,485,2859619901,2866606212
2025-06-18 23:38:54,FAKE,2859619901,244,2859620145,2866606704
2025-06-18 23:38:56,FAKE,2859620145,243,2859620388,2866607194
2025-06-18 23:38:58,FAKE,2859620388,243,2859620631,2866607674
2025-06-18 23:39:00,REAL,2859620631,486,2859621117,2866608160
2025-06-18 23:39:02,FAKE,2859621117,244,2859621361,2866608637
2025-06-18 23:39:04,REAL,2859621361,5395,2859626756,2866614032
2025-06-18 23:39:06,REAL,2859626756,11246,2859638002,2866625278
2025-06-18 23:39:08,REAL,2859638002,10243,2859648245,2866635521
2025-06-18 23:39:10,REAL,2859648245,10321,2859658566,2866645842
2025-06-18 23:39:12,REAL,2859658566,10249,2859668815,2866656091
2025-06-18 23:39:14,REAL,2859668815,10325,2859679140,2866666416
2025-06-18 23:39:16,REAL,2859679140,10260,2859689400,2866676676
2025-06-18 23:39:18,REAL,2859689400,10256,2859699656,2866686932
2025-06-18 23:39:20,FAKE,2859699656,238,2859699894,2866687943
2025-06-18 23:39:22,REAL,2859699894,484,2859700378,2866688427
2025-06-18 23:39:24,REAL,2859700378,483,2859700861,2866688910
2025-06-18 23:39:26,FAKE,2859700861,243,2859701104,2866689394
2025-06-18 23:39:28,REAL,2859701104,540,2859701644,2866689934
2025-06-18 23:39:30,REAL,2859701644,475,2859702119,2866690409
2025-06-18 23:39:32,REAL,2859702119,491,2859702610,2866690900
2025-06-18 23:39:34,FAKE,2859702610,238,2859702848,2866691383
2025-06-18 23:39:36,REAL,2859702848,484,2859703332,2866691867
2025-06-18 23:39:38,REAL,2859703332,477,2859703809,2866692344
2025-06-18 23:39:40,FAKE,2859703809,244,2859704053,2866692830
2025-06-18 23:39:42,REAL,2859704053,482,2859704535,2866693312
2025-06-18 23:39:44,FAKE,2859704535,244,2859704779,2866693802
2025-06-18 23:39:46,FAKE,2859704779,241,2859705020,2866694286
2025-06-18 23:39:48,REAL,2859705020,489,2859705509,2866694775
2025-06-18 23:39:50,REAL,2859705509,535,2859706044,2866695310
2025-06-18 23:39:52,REAL,2859706044,478,2859706522,2866695788
2025-06-18 23:39:54,REAL,2859706522,487,2859707009,2866696275
2025-06-18 23:39:56,FAKE,2859707009,244,2859707253,2866697026
2025-06-18 23:39:58,REAL,2859707253,11834,2859719087,2866708860
2025-06-18 23:40:00,REAL,2859719087,10317,2859729404,2866719177
2025-06-18 23:40:02,REAL,2859729404,10260,2859739664,2866729437
2025-06-18 23:40:04,REAL,2859739664,10247,2859749911,2866739684
2025-06-18 23:40:06,FAKE,2859749911,238,2859750149,2866749932
2025-06-18 23:40:08,REAL,2859750149,10311,2859760460,2866760243
2025-06-18 23:40:10,REAL,2859760460,10255,2859770715,2866770498
2025-06-18 23:40:12,FAKE,2859770715,238,2859770953,2866775398
2025-06-18 23:40:14,FAKE,2859770953,241,2859771194,2866775882
2025-06-18 23:40:16,FAKE,2859771194,244,2859771438,2866776366
2025-06-18 23:40:18,REAL,2859771438,492,2859771930,2866776858
2025-06-18 23:40:20,REAL,2859771930,488,2859772418,2866777346
2025-06-18 23:40:22,REAL,2859772418,491,2859772909,2866777837
2025-06-18 23:40:24,REAL,2859772909,481,2859773390,2866778318
2025-06-18 23:40:26,REAL,2859773390,544,2859773934,2866778862
2025-06-18 23:40:28,REAL,2859773934,478,2859774412,2866779340
2025-06-18 23:40:30,REAL,2859774412,489,2859774901,2866779829
2025-06-18 23:40:32,REAL,2859774901,477,2859775378,2866780306
2025-06-18 23:40:34,REAL,2859775378,487,2859775865,2866780793
2025-06-18 23:40:36,REAL,2859775865,482,2859776347,2866781275
2025-06-18 23:40:38,FAKE,2859776347,243,2859776590,2866781762
2025-06-18 23:40:40,REAL,2859776590,547,2859777137,2866782309
2025-06-18 23:40:42,REAL,2859777137,487,2859777624,2866782796
2025-06-18 23:40:44,FAKE,2859777624,238,2859777862,2866783288
2025-06-18 23:40:46,FAKE,2859777862,244,2859778106,2866783773
2025-06-18 23:40:48,REAL,2859778106,485,2859778591,2866784258
2025-06-18 23:40:50,REAL,2859778591,484,2859779075,2866784742
2025-06-18 23:40:52,REAL,2859779075,487,2859779562,2866785229
2025-06-18 23:40:54,REAL,2859779562,479,2859780041,2866785708
2025-06-18 23:40:56,REAL,2859780041,490,2859780531,2866786198
2025-06-18 23:40:58,REAL,2859780531,542,2859781073,2866786740
2025-06-18 23:41:00,REAL,2859781073,484,2859781557,2866787224
2025-06-18 23:41:02,REAL,2859781557,486,2859782043,2866787710
2025-06-18 23:41:04,FAKE,2859782043,238,2859782281,2866788194
2025-06-18 23:41:06,REAL,2859782281,484,2859782765,2866788678
2025-06-18 23:41:08,REAL,2859782765,485,2859783250,2866789163
2025-06-18 23:41:10,REAL,2859783250,489,2859783739,2866789652
2025-06-18 23:41:12,REAL,2859783739,489,2859784228,2866790141
2025-06-18 23:41:14,REAL,2859784228,490,2859784718,2866790631
2025-06-18 23:41:16,FAKE,2859784718,241,2859784959,2866791117
2025-06-18 23:41:18,REAL,2859784959,484,2859785443,2866791601
2025-06-18 23:41:20,FAKE,2859785443,244,2859785687,2866792091
2025-06-18 23:41:22,REAL,2859785687,491,2859786178,2866792582
2025-06-18 23:41:24,REAL,2859786178,492,2859786670,2866793074
2025-06-18 23:41:26,FAKE,2859786670,241,2859786911,2866793611
2025-06-18 23:41:28,REAL,2859786911,546,2859787457,2866794157
2025-06-18 23:41:30,REAL,2859787457,484,2859787941,2866794641
2025-06-18 23:41:32,REAL,2859787941,481,2859788422,2866795122
2025-06-18 23:41:34,FAKE,2859788422,241,2859788663,2866795603
2025-06-18 23:41:36,REAL,2859788663,480,2859789143,2866796083
2025-06-18 23:41:38,REAL,2859789143,483,2859789626,2866796566
2025-06-18 23:41:40,REAL,2859789626,482,2859790108,2866797048
2025-06-18 23:41:42,FAKE,2859790108,238,2859790346,2866797532
2025-06-18 23:41:44,FAKE,2859790346,243,2859790589,2866798011
2025-06-18 23:41:46,REAL,2859790589,493,2859791082,2866798504
2025-06-18 23:41:48,REAL,2859791082,3928,2859795010,2866802432
2025-06-18 23:41:50,FAKE,2859795010,244,2859795254,2866813803
2025-06-18 23:41:52,REAL,2859795254,10323,2859805577,2866824126
2025-06-18 23:41:54,FAKE,2859805577,241,2859805818,2866834368
2025-06-18 23:41:56,REAL,2859805818,10304,2859816122,2866844672
2025-06-18 23:41:58,REAL,2859816122,10253,2859826375,2866854925
2025-06-18 23:42:00,FAKE,2859826375,244,2859826619,2866865177
2025-06-18 23:42:02,REAL,2859826619,10248,2859836867,2866875425
2025-06-18 23:42:04,REAL,2859836867,2726,2859839593,2866878151
2025-06-18 23:42:06,REAL,2859839593,484,2859840077,2866878635
2025-06-18 23:42:08,REAL,2859840077,484,2859840561,2866879119
2025-06-18 23:42:10,REAL,2859840561,488,2859841049,2866879607
2025-06-18 23:42:12,REAL,2859841049,494,2859841543,2866880101
2025-06-18 23:42:14,REAL,2859841543,482,2859842025,2866880583
2025-06-18 23:42:16,FAKE,2859842025,243,2859842268,2866881070
2025-06-18 23:42:18,REAL,2859842268,486,2859842754,2866881556
2025-06-18 23:42:20,REAL,2859842754,4589,2859847343,2866886145
2025-06-18 23:42:22,FAKE,2859847343,244,2859847587,2866897316
2025-06-18 23:42:24,FAKE,2859847587,238,2859847825,2866907573
2025-06-18 23:42:26,FAKE,2859847825,244,2859848069,2866917890
2025-06-18 23:42:28,REAL,2859848069,10310,2859858379,2866928200
2025-06-18 23:42:30,FAKE,2859858379,243,2859858622,2866938446
2025-06-18 23:42:32,REAL,2859858622,10245,2859868867,2866948691
2025-06-18 23:42:34,REAL,2859868867,10314,2859879181,2866959005
2025-06-18 23:42:36,FAKE,2859879181,238,2859879419,2866961001
2025-06-18 23:42:38,FAKE,2859879419,244,2859879663,2866961486
2025-06-18 23:42:40,REAL,2859879663,476,2859880139,2866961962
2025-06-18 23:42:42,REAL,2859880139,484,2859880623,2866962446
2025-06-18 23:42:44,REAL,2859880623,485,2859881108,2866962931
2025-06-18 23:42:46,REAL,2859881108,488,2859881596,2866963419
2025-06-18 23:42:48,REAL,2859881596,490,2859882086,2866963909
2025-06-18 23:42:50,REAL,2859882086,489,2859882575,2866964398
2025-06-18 23:42:52,FAKE,2859882575,243,2859882818,2866964892
2025-06-18 23:42:54,REAL,2859882818,483,2859883301,2866965375
2025-06-18 23:42:56,REAL,2859883301,483,2859883784,2866965858
2025-06-18 23:42:58,REAL,2859883784,544,2859884328,2866966402
2025-06-18 23:43:00,FAKE,2859884328,244,2859884572,2866966892
2025-06-18 23:43:02,FAKE,2859884572,244,2859884816,2866967377
2025-06-18 23:43:04,REAL,2859884816,481,2859885297,2866967858
2025-06-18 23:43:06,REAL,2859885297,534,2859885831,2866968392
2025-06-18 23:43:08,REAL,2859885831,479,2859886310,2866968871
2025-06-18 23:43:10,REAL,2859886310,482,2859886792,2866969353
2025-06-18 23:43:12,REAL,2859886792,492,2859887284,2866969845
2025-06-18 23:43:14,FAKE,2859887284,243,2859887527,2866970332
2025-06-18 23:43:16,REAL,2859887527,485,2859888012,2866970817
2025-06-18 23:43:18,FAKE,2859888012,243,2859888255,2866971302
2025-06-18 23:43:20,REAL,2859888255,479,2859888734,2866971781
2025-06-18 23:43:22,REAL,2859888734,483,2859889217,2866972264
2025-06-18 23:43:24,REAL,2859889217,6310,2859895527,2866978574
2025-06-18 23:43:26,REAL,2859895527,10898,2859906425,2866989472
2025-06-18 23:43:28,FAKE,2859906425,243,2859906668,2866999792
2025-06-18 23:43:30,REAL,2859906668,10246,2859916914,2867010038
2025-06-18 23:43:32,FAKE,2859916914,241,2859917155,2867020549
2025-06-18 23:43:34,REAL,2859917155,10045,2859927200,2867030594
2025-06-18 23:43:36,REAL,2859927200,10252,2859937452,2867040846
2025-06-18 23:43:38,REAL,2859937452,10260,2859947712,2867051106
2025-06-18 23:43:40,FAKE,2859947712,244,2859947956,2867051988
2025-06-18 23:43:42,FAKE,2859947956,241,2859948197,2867052478
2025-06-18 23:43:44,REAL,2859948197,490,2859948687,2867052968
2025-06-18 23:43:46,REAL,2859948687,537,2859949224,2867053505
2025-06-18 23:43:48,REAL,2859949224,486,2859949710,2867053991
2025-06-18 23:43:50,REAL,2859949710,481,2859950191,2867054472
2025-06-18 23:43:52,FAKE,2859950191,238,2859950429,2867054954
2025-06-18 23:43:54,REAL,2859950429,482,2859950911,2867055436
2025-06-18 23:43:56,REAL,2859950911,6238,2859957149,2867061674
2025-06-18 23:43:58,REAL,2859957149,11034,2859968183,2867072708
2025-06-18 23:44:00,FAKE,2859968183,238,2859968421,2867083026
2025-06-18 23:44:02,REAL,2859968421,10248,2859978669,2867093274
2025-06-18 23:44:04,FAKE,2859978669,238,2859978907,2867103590
2025-06-18 23:44:06,REAL,2859978907,10245,2859989152,2867113835
2025-06-18 23:44:08,FAKE,2859989152,244,2859989396,2867124151
2025-06-18 23:44:10,REAL,2859989396,9985,2859999381,2867134136
2025-06-18 23:44:12,FAKE,2859999381,244,2859999625,2867134624
2025-06-18 23:44:14,REAL,2859999625,493,2860000118,2867135117
2025-06-18 23:44:16,FAKE,2860000118,241,2860000359,2867135607
2025-06-18 23:44:18,REAL,2860000359,543,2860000902,2867136150
2025-06-18 23:44:20,FAKE,2860000902,241,2860001143,2867136637
2025-06-18 23:44:22,REAL,2860001143,483,2860001626,2867137120
2025-06-18 23:44:24,FAKE,2860001626,241,2860001867,2867137606
2025-06-18 23:44:26,REAL,2860001867,491,2860002358,2867138097
2025-06-18 23:44:28,REAL,2860002358,7283,2860009641,2867145380
2025-06-18 23:44:30,FAKE,2860009641,244,2860009885,2867156431
2025-06-18 23:44:32,FAKE,2860009885,243,2860010128,2867166744
2025-06-18 23:44:34,REAL,2860010128,10257,2860020385,2867177001
2025-06-18 23:44:36,REAL,2860020385,10255,2860030640,2867187256
2025-06-18 23:44:38,FAKE,2860030640,243,2860030883,2867197579
2025-06-18 23:44:40,REAL,2860030883,10253,2860041136,2867207832
2025-06-18 23:44:42,REAL,2860041136,9330,2860050466,2867217162
2025-06-18 23:44:44,REAL,2860050466,486,2860050952,2867217648
2025-06-18 23:44:46,REAL,2860050952,475,2860051427,2867218123
2025-06-18 23:44:48,REAL,2860051427,477,2860051904,2867218600
2025-06-18 23:44:50,REAL,2860051904,542,2860052446,2867219142
2025-06-18 23:44:52,REAL,2860052446,487,2860052933,2867219629
2025-06-18 23:44:54,REAL,2860052933,486,2860053419,2867220115
2025-06-18 23:44:56,REAL,2860053419,485,2860053904,2867220600
2025-06-18 23:44:58,REAL,2860053904,542,2860054446,2867221142
2025-06-18 23:45:00,FAKE,2860054446,238,2860054684,2867221628
2025-06-18 23:45:02,FAKE,2860054684,238,2860054922,2867222114
2025-06-18 23:45:04,REAL,2860054922,478,2860055400,2867222592
2025-06-18 23:45:06,FAKE,2860055400,238,2860055638,2867223076
2025-06-18 23:45:08,REAL,2860055638,484,2860056122,2867223560
2025-06-18 23:45:10,REAL,2860056122,481,2860056603,2867224041
2025-06-18 23:45:12,FAKE,2860056603,243,2860056846,2867224584
2025-06-18 23:45:14,FAKE,2860056846,241,2860057087,2867225060
2025-06-18 23:45:16,FAKE,2860057087,241,2860057328,2867225546
2025-06-18 23:45:18,REAL,2860057328,483,2860057811,2867226029
2025-06-18 23:45:20,REAL,2860057811,483,2860058294,2867226512
2025-06-18 23:45:22,FAKE,2860058294,238,2860058532,2867227002
2025-06-18 23:45:24,REAL,2860058532,487,2860059019,2867227489
2025-06-18 23:45:26,REAL,2860059019,488,2860059507,2867227977
2025-06-18 23:45:28,REAL,2860059507,481,2860059988,2867228458
2025-06-18 23:45:30,REAL,2860059988,545,2860060533,2867229003
2025-06-18 23:45:32,REAL,2860060533,8937,2860069470,2867237940
2025-06-18 23:45:34,REAL,2860069470,10518,2860079988,2867248458
2025-06-18 23:45:36,REAL,2860079988,10327,2860090315,2867258785
2025-06-18 23:45:38,FAKE,2860090315,244,2860090559,2867269038
2025-06-18 23:45:40,REAL,2860090559,10311,2860100870,2867279349
2025-06-18 23:45:42,FAKE,2860100870,243,2860101113,2867289594
2025-06-18 23:45:44,REAL,2860101113,10255,2860111368,2867299849
2025-06-18 23:45:46,REAL,2860111368,8132,2860119500,2867307981
2025-06-18 23:45:48,REAL,2860119500,489,2860119989,2867308470
2025-06-18 23:45:50,FAKE,2860119989,243,2860120232,2867308960
2025-06-18 23:45:52,REAL,2860120232,482,2860120714,2867309442
2025-06-18 23:45:54,REAL,2860120714,543,2860121257,2867309985
2025-06-18 23:45:56,REAL,2860121257,478,2860121735,2867310463
2025-06-18 23:45:58,REAL,2860121735,490,2860122225,2867310953
2025-06-18 23:46:00,FAKE,2860122225,241,2860122466,2867311499
2025-06-18 23:46:02,FAKE,2860122466,243,2860122709,2867311983
2025-06-18 23:46:04,REAL,2860122709,10456,2860133165,2867322439
2025-06-18 23:46:06,REAL,2860133165,10515,2860143680,2867332954
2025-06-18 23:46:08,REAL,2860143680,10253,2860153933,2867343207
2025-06-18 23:46:10,REAL,2860153933,10323,2860164256,2867353530
2025-06-18 23:46:12,REAL,2860164256,10249,2860174505,2867363779
2025-06-18 23:46:14,FAKE,2860174505,243,2860174748,2867374031
2025-06-18 23:46:16,REAL,2860174748,10253,2860185001,2867384284
2025-06-18 23:46:18,REAL,2860185001,7487,2860192488,2867391771
2025-06-18 23:46:20,FAKE,2860192488,244,2860192732,2867392257
2025-06-18 23:46:22,REAL,2860192732,485,2860193217,2867392742
2025-06-18 23:46:24,FAKE,2860193217,238,2860193455,2867393282
2025-06-18 23:46:26,REAL,2860193455,485,2860193940,2867393767
2025-06-18 23:46:28,FAKE,2860193940,241,2860194181,2867394247
2025-06-18 23:46:30,REAL,2860194181,493,2860194674,2867394740
2025-06-18 23:46:32,REAL,2860194674,536,2860195210,2867395276
2025-06-18 23:46:34,REAL,2860195210,485,2860195695,2867395761
2025-06-18 23:46:36,REAL,2860195695,10072,2860205767,2867405833
2025-06-18 23:46:38,FAKE,2860205767,241,2860206008,2867416424
2025-06-18 23:46:40,REAL,2860206008,10311,2860216319,2867426735
2025-06-18 23:46:42,REAL,2860216319,10245,2860226564,2867436980
2025-06-18 23:46:44,FAKE,2860226564,241,2860226805,2867447235
2025-06-18 23:46:46,REAL,2860226805,10319,2860237124,2867457554
2025-06-18 23:46:48,REAL,2860237124,10249,2860247373,2867467803
2025-06-18 23:46:50,REAL,2860247373,6891,2860254264,2867474694
2025-06-18 23:46:52,REAL,2860254264,488,2860254752,2867475182
2025-06-18 23:46:54,FAKE,2860254752,238,2860254990,2867475669
2025-06-18 23:46:56,REAL,2860254990,547,2860255537,2867476216
2025-06-18 23:46:58,REAL,2860255537,493,2860256030,2867476709
2025-06-18 23:47:00,REAL,2860256030,485,2860256515,2867477194
2025-06-18 23:47:02,FAKE,2860256515,241,2860256756,2867477671
2025-06-18 23:47:04,REAL,2860256756,545,2860257301,2867478216
2025-06-18 23:47:06,FAKE,2860257301,244,2860257545,2867478706
2025-06-18 23:47:08,REAL,2860257545,11259,2860268804,2867489965
2025-06-18 23:47:10,FAKE,2860268804,244,2860269048,2867500282
2025-06-18 23:47:12,REAL,2860269048,10253,2860279301,2867510535
2025-06-18 23:47:14,REAL,2860279301,10249,2860289550,2867520784
2025-06-18 23:47:16,FAKE,2860289550,244,2860289794,2867531044
2025-06-18 23:47:18,REAL,2860289794,10257,2860300051,2867541301
2025-06-18 23:47:20,REAL,2860300051,10316,2860310367,2867551617
2025-06-18 23:47:22,REAL,2860310367,6167,2860316534,2867557784
2025-06-18 23:47:24,REAL,2860316534,476,2860317010,2867558260
2025-06-18 23:47:26,REAL,2860317010,482,2860317492,2867558742
2025-06-18 23:47:28,REAL,2860317492,537,2860318029,2867559279
2025-06-18 23:47:30,REAL,2860318029,489,2860318518,2867559768
2025-06-18 23:47:32,REAL,2860318518,489,2860319007,2867560257
2025-06-18 23:47:34,FAKE,2860319007,241,2860319248,2867560801
2025-06-18 23:47:36,REAL,2860319248,488,2860319736,2867561289
2025-06-18 23:47:38,REAL,2860319736,480,2860320216,2867561769
2025-06-18 23:47:40,REAL,2860320216,11852,2860332068,2867573621
2025-06-18 23:47:42,FAKE,2860332068,241,2860332309,2867583877
2025-06-18 23:47:44,REAL,2860332309,10255,2860342564,2867594132
2025-06-18 23:47:46,REAL,2860342564,10310,2860352874,2867604442
2025-06-18 23:47:48,REAL,2860352874,10250,2860363124,2867614692
2025-06-18 23:47:50,REAL,2860363124,10322,2860373446,2867625014
2025-06-18 23:47:52,FAKE,2860373446,244,2860373690,2867635264
2025-06-18 23:47:54,FAKE,2860373690,244,2860373934,2867640825
2025-06-18 23:47:56,REAL,2860373934,482,2860374416,2867641307
2025-06-18 23:47:58,REAL,2860374416,480,2860374896,2867641787
2025-06-18 23:48:00,REAL,2860374896,488,2860375384,2867642275
2025-06-18 23:48:02,REAL,2860375384,539,2860375923,2867642814
2025-06-18 23:48:04,REAL,2860375923,487,2860376410,2867643301
2025-06-18 23:48:06,REAL,2860376410,543,2860376953,2867643844
2025-06-18 23:48:08,REAL,2860376953,486,2860377439,2867644330
2025-06-18 23:48:10,REAL,2860377439,487,2860377926,2867644817
2025-06-18 23:48:12,REAL,2860377926,479,2860378405,2867645296
2025-06-18 23:48:14,REAL,2860378405,486,2860378891,2867645782
2025-06-18 23:48:16,REAL,2860378891,488,2860379379,2867646270
2025-06-18 23:48:18,FAKE,2860379379,243,2860379622,2867646761
2025-06-18 23:48:20,REAL,2860379622,482,2860380104,2867647243
2025-06-18 23:48:22,FAKE,2860380104,238,2860380342,2867647736
2025-06-18 23:48:24,REAL,2860380342,477,2860380819,2867648213
2025-06-18 23:48:26,REAL,2860380819,487,2860381306,2867648700
2025-06-18 23:48:28,FAKE,2860381306,241,2860381547,2867649189
2025-06-18 23:48:30,REAL,2860381547,486,2860382033,2867649675
2025-06-18 23:48:32,FAKE,2860382033,243,2860382276,2867650163
2025-06-18 23:48:34,REAL,2860382276,481,2860382757,2867650644
2025-06-18 23:48:36,FAKE,2860382757,241,2860382998,2867651181
2025-06-18 23:48:38,REAL,2860382998,482,2860383480,2867651663
2025-06-18 23:48:40,REAL,2860383480,480,2860383960,2867652143
2025-06-18 23:48:42,FAKE,2860383960,244,2860384204,2867652680
2025-06-18 23:48:44,FAKE,2860384204,243,2860384447,2867653157
2025-06-18 23:48:46,FAKE,2860384447,241,2860384688,2867653640
2025-06-18 23:48:48,REAL,2860384688,488,2860385176,2867654128
2025-06-18 23:48:50,REAL,2860385176,483,2860385659,2867654611
2025-06-18 23:48:52,FAKE,2860385659,241,2860385900,2867655095
2025-06-18 23:48:54,REAL,2860385900,484,2860386384,2867655579
2025-06-18 23:48:56,REAL,2860386384,489,2860386873,2867656068
2025-06-18 23:48:58,FAKE,2860386873,243,2860387116,2867658210
2025-06-18 23:49:00,FAKE,2860387116,243,2860387359,2867670108
2025-06-18 23:49:02,FAKE,2860387359,238,2860387597,2867680419
2025-06-18 23:49:04,REAL,2860387597,10712,2860398309,2867691131
2025-06-18 23:49:06,REAL,2860398309,9860,2860408169,2867700991
2025-06-18 23:49:08,REAL,2860408169,10379,2860418548,2867711370
2025-06-18 23:49:10,REAL,2860418548,10317,2860428865,2867721687
2025-06-18 23:49:12,REAL,2860428865,10252,2860439117,2867731939
2025-06-18 23:49:14,REAL,2860439117,4047,2860443164,2867735986
2025-06-18 23:49:16,REAL,2860443164,477,2860443641,2867736463
2025-06-18 23:49:18,REAL,2860443641,486,2860444127,2867736949
2025-06-18 23:49:20,REAL,2860444127,491,2860444618,2867737440
2025-06-18 23:49:22,REAL,2860444618,479,2860445097,2867737919
2025-06-18 23:49:24,REAL,2860445097,487,2860445584,2867738406
2025-06-18 23:49:26,REAL,2860445584,489,2860446073,2867738895
2025-06-18 23:49:28,REAL,2860446073,492,2860446565,2867739387
2025-06-18 23:49:30,REAL,2860446565,483,2860447048,2867739870
2025-06-18 23:49:32,REAL,2860447048,491,2860447539,2867740361
2025-06-18 23:49:34,FAKE,2860447539,238,2860447777,2867740848
2025-06-18 23:49:36,REAL,2860447777,559,2860448336,2867741407
2025-06-18 23:49:38,REAL,2860448336,493,2860448829,2867741900
2025-06-18 23:49:40,REAL,2860448829,482,2860449311,2867742382
2025-06-18 23:49:42,REAL,2860449311,541,2860449852,2867742923
2025-06-18 23:49:44,FAKE,2860449852,244,2860450096,2867743408
2025-06-18 23:49:46,REAL,2860450096,488,2860450584,2867743896
2025-06-18 23:49:48,FAKE,2860450584,244,2860450828,2867744436
2025-06-18 23:49:50,REAL,2860450828,490,2860451318,2867744926
2025-06-18 23:49:52,FAKE,2860451318,244,2860451562,2867745411
2025-06-18 23:49:54,REAL,2860451562,477,2860452039,2867745888
2025-06-18 23:49:56,REAL,2860452039,491,2860452530,2867746379
2025-06-18 23:49:58,REAL,2860452530,482,2860453012,2867746861
2025-06-18 23:50:00,REAL,2860453012,492,2860453504,2867747353
2025-06-18 23:50:02,REAL,2860453504,3790,2860457294,2867751143
2025-06-18 23:50:04,REAL,2860457294,11705,2860468999,2867762848
2025-06-18 23:50:06,FAKE,2860468999,244,2860469243,2867773092
2025-06-18 23:50:08,REAL,2860469243,10258,2860479501,2867783350
2025-06-18 23:50:10,FAKE,2860479501,243,2860479744,2867793668
2025-06-18 23:50:12,FAKE,2860479744,238,2860479982,2867803986
2025-06-18 23:50:14,REAL,2860479982,10248,2860490230,2867814234
2025-06-18 23:50:16,REAL,2860490230,10318,2860500548,2867824552
2025-06-18 23:50:18,REAL,2860500548,2794,2860503342,2867827346
2025-06-18 23:50:20,REAL,2860503342,490,2860503832,2867827836
2025-06-18 23:50:22,REAL,2860503832,486,2860504318,2867828322
2025-06-18 23:50:24,REAL,2860504318,479,2860504797,2867828801
2025-06-18 23:50:26,REAL,2860504797,485,2860505282,2867829286
2025-06-18 23:50:28,REAL,2860505282,485,2860505767,2867829771
2025-06-18 23:50:30,REAL,2860505767,479,2860506246,2867830250
2025-06-18 23:50:32,FAKE,2860506246,238,2860506484,2867830796
2025-06-18 23:50:34,REAL,2860506484,485,2860506969,2867831281
2025-06-18 23:50:36,FAKE,2860506969,241,2860507210,2867831769
2025-06-18 23:50:38,REAL,2860507210,481,2860507691,2867832250
2025-06-18 23:50:40,FAKE,2860507691,238,2860507929,2867842400
2025-06-18 23:50:42,REAL,2860507929,10580,2860518509,2867852980
2025-06-18 23:50:44,REAL,2860518509,10253,2860528762,2867863233
2025-06-18 23:50:46,REAL,2860528762,10320,2860539082,2867873553
2025-06-18 23:50:48,REAL,2860539082,10247,2860549329,2867883800
2025-06-18 23:50:50,FAKE,2860549329,241,2860549570,2867893810
2025-06-18 23:50:52,REAL,2860549570,10326,2860559896,2867904136
2025-06-18 23:50:54,FAKE,2860559896,241,2860560137,2867911149
2025-06-18 23:50:56,REAL,2860560137,486,2860560623,2867911635
2025-06-18 23:50:58,REAL,2860560623,482,2860561105,2867912117
2025-06-18 23:51:00,REAL,2860561105,475,2860561580,2867912592
2025-06-18 23:51:02,FAKE,2860561580,244,2860561824,2867913075
2025-06-18 23:51:04,REAL,2860561824,481,2860562305,2867913556
2025-06-18 23:51:06,FAKE,2860562305,241,2860562546,2867914037
2025-06-18 23:51:08,REAL,2860562546,487,2860563033,2867914524
2025-06-18 23:51:10,FAKE,2860563033,241,2860563274,2867915004
2025-06-18 23:51:12,REAL,2860563274,478,2860563752,2867915482
2025-06-18 23:51:14,REAL,2860563752,537,2860564289,2867916019
2025-06-18 23:51:16,REAL,2860564289,484,2860564773,2867916503
2025-06-18 23:51:18,FAKE,2860564773,241,2860565014,2867916984
2025-06-18 23:51:20,REAL,2860565014,482,2860565496,2867917466
2025-06-18 23:51:22,FAKE,2860565496,241,2860565737,2867918003
2025-06-18 23:51:24,REAL,2860565737,485,2860566222,2867918488
2025-06-18 23:51:26,REAL,2860566222,482,2860566704,2867918970
2025-06-18 23:51:28,FAKE,2860566704,244,2860566948,2867919451
2025-06-18 23:51:30,REAL,2860566948,480,2860567428,2867919931
2025-06-18 23:51:32,FAKE,2860567428,241,2860567669,2867920416
2025-06-18 23:51:34,REAL,2860567669,479,2860568148,2867920895
2025-06-18 23:51:36,REAL,2860568148,488,2860568636,2867921383
2025-06-18 23:51:38,REAL,2860568636,490,2860569126,2867921873
2025-06-18 23:51:40,REAL,2860569126,487,2860569613,2867922360
2025-06-18 23:51:42,REAL,2860569613,485,2860570098,2867922845
2025-06-18 23:51:44,REAL,2860570098,15010,2860585108,2867937855
2025-06-18 23:51:46,FAKE,2860585108,238,2860585346,2867948108
2025-06-18 23:51:48,REAL,2860585346,10257,2860595603,2867958365
2025-06-18 23:51:50,FAKE,2860595603,238,2860595841,2867968679
2025-06-18 23:51:52,REAL,2860595841,10252,2860606093,2867978931
2025-06-18 23:51:54,FAKE,2860606093,243,2860606336,2867989252
2025-06-18 23:51:56,REAL,2860606336,10250,2860616586,2867999502
2025-06-18 23:51:58,REAL,2860616586,5827,2860622413,2868005329
2025-06-18 23:52:00,REAL,2860622413,477,2860622890,2868005806
2025-06-18 23:52:02,REAL,2860622890,486,2860623376,2868006292
2025-06-18 23:52:04,REAL,2860623376,485,2860623861,2868006777
2025-06-18 23:52:06,REAL,2860623861,484,2860624345,2868007261
2025-06-18 23:52:08,REAL,2860624345,491,2860624836,2868007752
2025-06-18 23:52:10,REAL,2860624836,487,2860625323,2868008239
2025-06-18 23:52:12,FAKE,2860625323,244,2860625567,2868008717
2025-06-18 23:52:14,FAKE,2860625567,238,2860625805,2868009205
2025-06-18 23:52:16,FAKE,2860625805,243,2860626048,2868020981
2025-06-18 23:52:18,FAKE,2860626048,243,2860626291,2868031233
2025-06-18 23:52:20,FAKE,2860626291,243,2860626534,2868041491
2025-06-18 23:52:22,REAL,2860626534,10311,2860636845,2868051802
2025-06-18 23:52:24,REAL,2860636845,10256,2860647101,2868062058
2025-06-18 23:52:26,REAL,2860647101,10248,2860657349,2868072306
2025-06-18 23:52:28,FAKE,2860657349,243,2860657592,2868082557
2025-06-18 23:52:30,REAL,2860657592,5163,2860662755,2868087720
2025-06-18 23:52:32,REAL,2860662755,479,2860663234,2868088199
2025-06-18 23:52:34,FAKE,2860663234,241,2860663475,2868088687
2025-06-18 23:52:36,FAKE,2860663475,241,2860663716,2868089174
2025-06-18 23:52:38,FAKE,2860663716,243,2860663959,2868089666
2025-06-18 23:52:40,FAKE,2860663959,243,2860664202,2868090208
2025-06-18 23:52:42,FAKE,2860664202,243,2860664445,2868090692
2025-06-18 23:52:44,REAL,2860664445,486,2860664931,2868091178
2025-06-18 23:52:46,FAKE,2860664931,241,2860665172,2868092534
2025-06-18 23:52:48,REAL,2860665172,11768,2860676940,2868104302
2025-06-18 23:52:50,REAL,2860676940,10326,2860687266,2868114628
2025-06-18 23:52:52,FAKE,2860687266,238,2860687504,2868124887
2025-06-18 23:52:54,FAKE,2860687504,238,2860687742,2868135199
2025-06-18 23:52:56,REAL,2860687742,10255,2860697997,2868145454
2025-06-18 23:52:58,FAKE,2860697997,238,2860698235,2868155710
2025-06-18 23:53:00,REAL,2860698235,10319,2860708554,2868166029
2025-06-18 23:53:02,FAKE,2860708554,238,2860708792,2868170482
2025-06-18 23:53:04,FAKE,2860708792,238,2860709030,2868170969
2025-06-18 23:53:06,REAL,2860709030,482,2860709512,2868171451
2025-06-18 23:53:08,FAKE,2860709512,241,2860709753,2868171930
2025-06-18 23:53:10,FAKE,2860709753,243,2860709996,2868172408
2025-06-18 23:53:12,FAKE,2860709996,241,2860710237,2868172889
2025-06-18 23:53:14,REAL,2860710237,489,2860710726,2868173378
2025-06-18 23:53:16,REAL,2860710726,483,2860711209,2868173861
2025-06-18 23:53:18,FAKE,2860711209,244,2860711453,2868174338
2025-06-18 23:53:20,REAL,2860711453,540,2860711993,2868174878
2025-06-18 23:53:22,FAKE,2860711993,244,2860712237,2868175361
2025-06-18 23:53:24,FAKE,2860712237,241,2860712478,2868175840
2025-06-18 23:53:26,REAL,2860712478,475,2860712953,2868176315
2025-06-18 23:53:28,REAL,2860712953,536,2860713489,2868176851
2025-06-18 23:53:30,REAL,2860713489,488,2860713977,2868177339
2025-06-18 23:53:32,REAL,2860713977,480,2860714457,2868177819
2025-06-18 23:53:34,REAL,2860714457,483,2860714940,2868178302
2025-06-18 23:53:36,REAL,2860714940,484,2860715424,2868178786
2025-06-18 23:53:38,REAL,2860715424,481,2860715905,2868179267
2025-06-18 23:53:40,FAKE,2860715905,238,2860716143,2868179746
2025-06-18 23:53:42,REAL,2860716143,478,2860716621,2868180224
2025-06-18 23:53:44,REAL,2860716621,489,2860717110,2868180713
2025-06-18 23:53:46,FAKE,2860717110,243,2860717353,2868181189
2025-06-18 23:53:48,FAKE,2860717353,244,2860717597,2868181674
2025-06-18 23:53:50,REAL,2860717597,2807,2860720404,2868184481
2025-06-18 23:53:52,REAL,2860720404,11567,2860731971,2868196048
2025-06-18 23:53:54,FAKE,2860731971,243,2860732214,2868206308
2025-06-18 23:53:56,REAL,2860732214,10309,2860742523,2868216617
2025-06-18 23:53:58,FAKE,2860742523,241,2860742764,2868226862
2025-06-18 23:54:00,REAL,2860742764,10251,2860753015,2868237113
2025-06-18 23:54:02,REAL,2860753015,10303,2860763318,2868247416
2025-06-18 23:54:04,FAKE,2860763318,244,2860763562,2868257738
2025-06-18 23:54:06,FAKE,2860763562,238,2860763800,2868260992
2025-06-18 23:54:08,FAKE,2860763800,243,2860764043,2868261473
2025-06-18 23:54:10,REAL,2860764043,485,2860764528,2868261958
2025-06-18 23:54:12,REAL,2860764528,477,2860765005,2868262435
2025-06-18 23:54:14,FAKE,2860765005,241,2860765246,2868262919
2025-06-18 23:54:16,FAKE,2860765246,243,2860765489,2868263401
2025-06-18 23:54:18,REAL,2860765489,475,2860765964,2868263876
2025-06-18 23:54:20,FAKE,2860765964,243,2860766207,2868264359
2025-06-18 23:54:22,FAKE,2860766207,238,2860766445,2868267953
2025-06-18 23:54:24,FAKE,2860766445,241,2860766686,2868279196
2025-06-18 23:54:26,REAL,2860766686,10253,2860776939,2868289449
2025-06-18 23:54:28,REAL,2860776939,10252,2860787191,2868299701
2025-06-18 23:54:30,REAL,2860787191,10252,2860797443,2868309953
2025-06-18 23:54:32,REAL,2860797443,10322,2860807765,2868320275
2025-06-18 23:54:34,REAL,2860807765,10251,2860818016,2868330526
2025-06-18 23:54:36,REAL,2860818016,10257,2860828273,2868340783
2025-06-18 23:54:38,FAKE,2860828273,238,2860828511,2868343370
2025-06-18 23:54:40,REAL,2860828511,487,2860828998,2868343857
2025-06-18 23:54:42,REAL,2860828998,533,2860829531,2868344390
2025-06-18 23:54:44,REAL,2860829531,486,2860830017,2868344876
2025-06-18 23:54:46,FAKE,2860830017,244,2860830261,2868345366
2025-06-18 23:54:48,REAL,2860830261,494,2860830755,2868345860
2025-06-18 23:54:50,REAL,2860830755,487,2860831242,2868346347
2025-06-18 23:54:52,REAL,2860831242,484,2860831726,2868346831
2025-06-18 23:54:54,REAL,2860831726,4188,2860835914,2868351019
2025-06-18 23:54:56,REAL,2860835914,11237,2860847151,2868362256
2025-06-18 23:54:58,FAKE,2860847151,244,2860847395,2868372567
2025-06-18 23:55:00,REAL,2860847395,10254,2860857649,2868382821
2025-06-18 23:55:02,REAL,2860857649,10254,2860867903,2868393075
2025-06-18 23:55:04,FAKE,2860867903,244,2860868147,2868403327
2025-06-18 23:55:06,FAKE,2860868147,238,2860868385,2868413581
2025-06-18 23:55:08,FAKE,2860868385,238,2860868623,2868423904
2025-06-18 23:55:10,REAL,2860868623,1939,2860870562,2868425843
2025-06-18 23:55:12,REAL,2860870562,480,2860871042,2868426323
2025-06-18 23:55:14,REAL,2860871042,482,2860871524,2868426805
2025-06-18 23:55:16,FAKE,2860871524,244,2860871768,2868427341
2025-06-18 23:55:18,FAKE,2860871768,244,2860872012,2868427830
2025-06-18 23:55:20,REAL,2860872012,483,2860872495,2868428313
2025-06-18 23:55:22,REAL,2860872495,477,2860872972,2868428790
2025-06-18 23:55:24,REAL,2860872972,486,2860873458,2868429276
2025-06-18 23:55:26,REAL,2860873458,480,2860873938,2868429756
2025-06-18 23:55:28,FAKE,2860873938,238,2860874176,2868430241
2025-06-18 23:55:30,FAKE,2860874176,243,2860874419,2868430730
2025-06-18 23:55:32,REAL,2860874419,479,2860874898,2868431209
2025-06-18 23:55:34,FAKE,2860874898,241,2860875139,2868431695
2025-06-18 23:55:36,FAKE,2860875139,244,2860875383,2868432176
2025-06-18 23:55:38,REAL,2860875383,536,2860875919,2868432712
2025-06-18 23:55:40,REAL,2860875919,484,2860876403,2868433196
2025-06-18 23:55:42,FAKE,2860876403,244,2860876647,2868433677
2025-06-18 23:55:44,REAL,2860876647,486,2860877133,2868434163
2025-06-18 23:55:46,REAL,2860877133,483,2860877616,2868434646
2025-06-18 23:55:48,REAL,2860877616,544,2860878160,2868435190
2025-06-18 23:55:50,REAL,2860878160,486,2860878646,2868435676
2025-06-18 23:55:52,REAL,2860878646,484,2860879130,2868436160
2025-06-18 23:55:54,FAKE,2860879130,241,2860879371,2868436638
2025-06-18 23:55:56,REAL,2860879371,486,2860879857,2868437124
2025-06-18 23:55:58,REAL,2860879857,486,2860880343,2868437610
2025-06-18 23:56:00,FAKE,2860880343,241,2860880584,2868438096
2025-06-18 23:56:02,FAKE,2860880584,243,2860880827,2868438585
2025-06-18 23:56:04,REAL,2860880827,11769,2860892596,2868450354
2025-06-18 23:56:06,REAL,2860892596,10248,2860902844,2868460602
2025-06-18 23:56:08,REAL,2860902844,10255,2860913099,2868470857
2025-06-18 23:56:10,FAKE,2860913099,238,2860913337,2868481105
2025-06-18 23:56:12,REAL,2860913337,10253,2860923590,2868491358
2025-06-18 23:56:14,FAKE,2860923590,241,2860923831,2868501611
2025-06-18 23:56:16,REAL,2860923831,10318,2860934149,2868511929
2025-06-18 23:56:18,REAL,2860934149,5558,2860939707,2868517487
2025-06-18 23:56:20,REAL,2860939707,537,2860940244,2868518024
2025-06-18 23:56:22,FAKE,2860940244,243,2860940487,2868518509
2025-06-18 23:56:24,REAL,2860940487,482,2860940969,2868518991
2025-06-18 23:56:26,FAKE,2860940969,241,2860941210,2868519482
2025-06-18 23:56:28,REAL,2860941210,486,2860941696,2868519968
2025-06-18 23:56:30,REAL,2860941696,485,2860942181,2868520453
2025-06-18 23:56:32,REAL,2860942181,487,2860942668,2868520940
2025-06-18 23:56:34,REAL,2860942668,626,2860943294,2868521566
2025-06-18 23:56:36,REAL,2860943294,12294,2860955588,2868533860
2025-06-18 23:56:38,REAL,2860955588,10314,2860965902,2868544174
2025-06-18 23:56:40,REAL,2860965902,10248,2860976150,2868554422
2025-06-18 23:56:42,REAL,2860976150,10259,2860986409,2868564681
2025-06-18 23:56:44,FAKE,2860986409,238,2860986647,2868574933
2025-06-18 23:56:46,REAL,2860986647,10246,2860996893,2868585179
2025-06-18 23:56:48,FAKE,2860996893,241,2860997134,2868595496
2025-06-18 23:56:50,REAL,2860997134,4903,2861002037,2868600399
2025-06-18 23:56:52,FAKE,2861002037,244,2861002281,2868600880
2025-06-18 23:56:54,FAKE,2861002281,243,2861002524,2868601424
2025-06-18 23:56:56,REAL,2861002524,7162,2861009686,2868608586
2025-06-18 23:56:58,REAL,2861009686,11263,2861020949,2868619849
2025-06-18 23:57:00,REAL,2861020949,10255,2861031204,2868630104
2025-06-18 23:57:02,REAL,2861031204,10252,2861041456,2868640356
2025-06-18 23:57:04,REAL,2861041456,10314,2861051770,2868650670
2025-06-18 23:57:06,REAL,2861051770,10249,2861062019,2868660919
2025-06-18 23:57:08,REAL,2861062019,10248,2861072267,2868671167
2025-06-18 23:57:10,REAL,2861072267,9519,2861081786,2868680686
2025-06-18 23:57:12,FAKE,2861081786,238,2861082024,2868681170
2025-06-18 23:57:14,FAKE,2861082024,244,2861082268,2868681651
2025-06-18 23:57:16,FAKE,2861082268,238,2861082506,2868683326
2025-06-18 23:57:18,REAL,2861082506,12172,2861094678,2868695498
2025-06-18 23:57:20,FAKE,2861094678,241,2861094919,2868705742
2025-06-18 23:57:22,REAL,2861094919,10247,2861105166,2868715989
2025-06-18 23:57:24,REAL,2861105166,10259,2861115425,2868726248
2025-06-18 23:57:26,REAL,2861115425,10302,2861125727,2868736550
2025-06-18 23:57:28,REAL,2861125727,10308,2861136035,2868746858
2025-06-18 23:57:30,FAKE,2861136035,241,2861136276,2868757107
2025-06-18 23:57:32,REAL,2861136276,4244,2861140520,2868761351
2025-06-18 23:57:34,REAL,2861140520,484,2861141004,2868761835
2025-06-18 23:57:36,REAL,2861141004,479,2861141483,2868762314
2025-06-18 23:57:38,REAL,2861141483,492,2861141975,2868762806
2025-06-18 23:57:40,REAL,2861141975,479,2861142454,2868763285
2025-06-18 23:57:42,REAL,2861142454,484,2861142938,2868763769
2025-06-18 23:57:44,REAL,2861142938,474,2861143412,2868764243
2025-06-18 23:57:46,FAKE,2861143412,244,2861143656,2868764736
2025-06-18 23:57:48,FAKE,2861143656,238,2861143894,2868767265
2025-06-18 23:57:50,REAL,2861143894,11761,2861155655,2868779026
2025-06-18 23:57:52,REAL,2861155655,10319,2861165974,2868789345
2025-06-18 23:57:54,REAL,2861165974,10254,2861176228,2868799599
2025-06-18 23:57:56,REAL,2861176228,10256,2861186484,2868809855
2025-06-18 23:57:58,REAL,2861186484,10252,2861196736,2868820107
2025-06-18 23:58:00,REAL,2861196736,10311,2861207047,2868830418
2025-06-18 23:58:02,FAKE,2861207047,243,2861207290,2868840737
2025-06-18 23:58:04,REAL,2861207290,3588,2861210878,2868844325
2025-06-18 23:58:06,REAL,2861210878,485,2861211363,2868844810
2025-06-18 23:58:08,REAL,2861211363,480,2861211843,2868845290
2025-06-18 23:58:10,FAKE,2861211843,241,2861212084,2868845768
2025-06-18 23:58:12,REAL,2861212084,487,2861212571,2868846255
2025-06-18 23:58:14,REAL,2861212571,485,2861213056,2868846740
2025-06-18 23:58:16,REAL,2861213056,482,2861213538,2868847222
2025-06-18 23:58:18,REAL,2861213538,489,2861214027,2868847711
2025-06-18 23:58:20,FAKE,2861214027,238,2861214265,2868848198
2025-06-18 23:58:22,REAL,2861214265,480,2861214745,2868848678
2025-06-18 23:58:24,REAL,2861214745,476,2861215221,2868849154
2025-06-18 23:58:26,FAKE,2861215221,244,2861215465,2868849637
2025-06-18 23:58:28,REAL,2861215465,483,2861215948,2868850120
2025-06-18 23:58:30,REAL,2861215948,488,2861216436,2868850608
2025-06-18 23:58:32,REAL,2861216436,595,2861217031,2868851203
2025-06-18 23:58:34,FAKE,2861217031,243,2861217274,2868851687
2025-06-18 23:58:36,FAKE,2861217274,238,2861217512,2868852171
2025-06-18 23:58:38,FAKE,2861217512,243,2861217755,2868852653
2025-06-18 23:58:40,REAL,2861217755,484,2861218239,2868853137
2025-06-18 23:58:42,REAL,2861218239,484,2861218723,2868853621
2025-06-18 23:58:44,REAL,2861218723,482,2861219205,2868854103
2025-06-18 23:58:46,FAKE,2861219205,243,2861219448,2868854591
2025-06-18 23:58:48,REAL,2861219448,479,2861219927,2868855070
2025-06-18 23:58:50,FAKE,2861219927,244,2861220171,2868855559
2025-06-18 23:58:52,REAL,2861220171,482,2861220653,2868856041
2025-06-18 23:58:54,FAKE,2861220653,243,2861220896,2868856527
2025-06-18 23:58:56,REAL,2861220896,482,2861221378,2868857009
2025-06-18 23:58:58,REAL,2861221378,484,2861221862,2868857493
2025-06-18 23:59:00,REAL,2861221862,480,2861222342,2868857973
2025-06-18 23:59:02,FAKE,2861222342,243,2861222585,2868858455
2025-06-18 23:59:04,FAKE,2861222585,238,2861222823,2868858996
2025-06-18 23:59:06,FAKE,2861222823,244,2861223067,2868859483
2025-06-18 23:59:08,FAKE,2861223067,238,2861223305,2868863795
2025-06-18 23:59:10,REAL,2861223305,11718,2861235023,2868875513
2025-06-18 23:59:12,REAL,2861235023,10246,2861245269,2868885759
2025-06-18 23:59:14,REAL,2861245269,10251,2861255520,2868896010
2025-06-18 23:59:16,REAL,2861255520,10256,2861265776,2868906266
2025-06-18 23:59:18,FAKE,2861265776,243,2861266019,2868916592
2025-06-18 23:59:20,REAL,2861266019,10256,2861276275,2868926848
2025-06-18 23:59:22,REAL,2861276275,10321,2861286596,2868937169
2025-06-18 23:59:24,REAL,2861286596,1999,2861288595,2868939168
2025-06-18 23:59:26,REAL,2861288595,475,2861289070,2868939643
2025-06-18 23:59:28,FAKE,2861289070,244,2861289314,2868940128
2025-06-18 23:59:30,REAL,2861289314,10592,2861299906,2868950720
2025-06-18 23:59:32,REAL,2861299906,10386,2861310292,2868961106
2025-06-18 23:59:34,REAL,2861310292,10247,2861320539,2868971353
2025-06-18 23:59:36,FAKE,2861320539,241,2861320780,2868981596
2025-06-18 23:59:38,FAKE,2861320780,244,2861321024,2868992111
2025-06-18 23:59:40,REAL,2861321024,10052,2861331076,2869002163
2025-06-18 23:59:42,REAL,2861331076,10250,2861341326,2869012413
2025-06-18 23:59:44,FAKE,2861341326,244,2861341570,2869019036
2025-06-18 23:59:46,REAL,2861341570,478,2861342048,2869019514
2025-06-18 23:59:48,REAL,2861342048,490,2861342538,2869020004
2025-06-18 23:59:50,REAL,2861342538,548,2861343086,2869020552
2025-06-18 23:59:52,REAL,2861343086,484,2861343570,2869021036
2025-06-18 23:59:54,REAL,2861343570,489,2861344059,2869021525
2025-06-18 23:59:56,REAL,2861344059,478,2861344537,2869022003
2025-06-18 23:59:58,REAL,2861344537,487,2861345024,2869022490
2025-06-19 00:00:00,FAKE,2861345024,243,2861345267,2869022972
2025-06-19 00:00:02,REAL,2861345267,476,2861345743,2869023448
2025-06-19 00:00:04,REAL,2861345743,480,2861346223,2869023928
2025-06-19 00:00:06,FAKE,2861346223,244,2861346467,2869024408
2025-06-19 00:00:08,REAL,2861346467,490,2861346957,2869024898
2025-06-19 00:00:10,FAKE,2861346957,241,2861347198,2869025383
2025-06-19 00:00:12,REAL,2861347198,480,2861347678,2869025863
2025-06-19 00:00:14,REAL,2861347678,542,2861348220,2869026405
2025-06-19 00:00:16,REAL,2861348220,486,2861348706,2869026891
2025-06-19 00:00:18,REAL,2861348706,487,2861349193,2869027378
2025-06-19 00:00:20,REAL,2861349193,492,2861349685,2869027870
2025-06-19 00:00:22,REAL,2861349685,486,2861350171,2869028356
2025-06-19 00:00:24,REAL,2861350171,475,2861350646,2869028831
2025-06-19 00:00:26,REAL,2861350646,488,2861351134,2869029319
2025-06-19 00:00:28,REAL,2861351134,485,2861351619,2869029804
2025-06-19 00:00:30,REAL,2861351619,486,2861352105,2869030290
2025-06-19 00:00:32,REAL,2861352105,479,2861352584,2869030769
2025-06-19 00:00:34,REAL,2861352584,548,2861353132,2869031317
2025-06-19 00:00:36,REAL,2861353132,481,2861353613,2869031798
2025-06-19 00:00:38,REAL,2861353613,484,2861354097,2869032282
2025-06-19 00:00:40,REAL,2861354097,485,2861354582,2869032767
2025-06-19 00:00:42,REAL,2861354582,487,2861355069,2869033254
2025-06-19 00:00:44,FAKE,2861355069,243,2861355312,2869033741
2025-06-19 00:00:46,REAL,2861355312,488,2861355800,2869034229
2025-06-19 00:00:48,FAKE,2861355800,243,2861356043,2869034711
2025-06-19 00:00:50,FAKE,2861356043,244,2861356287,2869035200
2025-06-19 00:00:52,FAKE,2861356287,241,2861356528,2869035685
2025-06-19 00:00:54,FAKE,2861356528,244,2861356772,2869042247
2025-06-19 00:00:56,REAL,2861356772,11049,2861367821,2869053296
2025-06-19 00:00:58,FAKE,2861367821,238,2861368059,2869063611
2025-06-19 00:01:00,REAL,2861368059,10249,2861378308,2869073860
2025-06-19 00:01:02,FAKE,2861378308,241,2861378549,2869084117
2025-06-19 00:01:04,REAL,2861378549,10244,2861388793,2869094361
2025-06-19 00:01:06,FAKE,2861388793,238,2861389031,2869104616
2025-06-19 00:01:08,REAL,2861389031,9913,2861398944,2869114529
2025-06-19 00:01:10,FAKE,2861398944,243,2861399187,2869115009
2025-06-19 00:01:12,REAL,2861399187,476,2861399663,2869115485
2025-06-19 00:01:14,FAKE,2861399663,244,2861399907,2869115965
2025-06-19 00:01:16,REAL,2861399907,479,2861400386,2869116444
2025-06-19 00:01:18,REAL,2861400386,487,2861400873,2869116931
2025-06-19 00:01:20,REAL,2861400873,533,2861401406,2869117464
2025-06-19 00:01:22,REAL,2861401406,484,2861401890,2869117948
2025-06-19 00:01:24,REAL,2861401890,479,2861402369,2869118427
2025-06-19 00:01:26,REAL,2861402369,491,2861402860,2869118918
2025-06-19 00:01:28,REAL,2861402860,488,2861403348,2869119406
2025-06-19 00:01:30,REAL,2861403348,485,2861403833,2869119891
2025-06-19 00:01:32,FAKE,2861403833,238,2861404071,2869120376
2025-06-19 00:01:34,FAKE,2861404071,244,2861404315,2869120860
2025-06-19 00:01:36,REAL,2861404315,479,2861404794,2869121339
2025-06-19 00:01:38,FAKE,2861404794,243,2861405037,2869121875
2025-06-19 00:01:40,REAL,2861405037,487,2861405524,2869122362
2025-06-19 00:01:42,REAL,2861405524,482,2861406006,2869122844
2025-06-19 00:01:44,REAL,2861406006,475,2861406481,2869123319
2025-06-19 00:01:46,REAL,2861406481,487,2861406968,2869123806
2025-06-19 00:01:48,REAL,2861406968,484,2861407452,2869124290
2025-06-19 00:01:50,REAL,2861407452,485,2861407937,2869124775
2025-06-19 00:01:52,FAKE,2861407937,241,2861408178,2869125265
2025-06-19 00:01:54,REAL,2861408178,488,2861408666,2869125753
2025-06-19 00:01:56,REAL,2861408666,479,2861409145,2869126232
2025-06-19 00:01:58,REAL,2861409145,484,2861409629,2869126716
2025-06-19 00:02:00,REAL,2861409629,476,2861410105,2869127192
2025-06-19 00:02:02,REAL,2861410105,492,2861410597,2869127684
2025-06-19 00:02:04,REAL,2861410597,539,2861411136,2869128223
2025-06-19 00:02:06,REAL,2861411136,486,2861411622,2869128709
2025-06-19 00:02:08,FAKE,2861411622,241,2861411863,2869129191
2025-06-19 00:02:10,REAL,2861411863,484,2861412347,2869129675
2025-06-19 00:02:12,FAKE,2861412347,243,2861412590,2869130157
2025-06-19 00:02:14,REAL,2861412590,484,2861413074,2869130641
2025-06-19 00:02:16,REAL,2861413074,483,2861413557,2869131124
2025-06-19 00:02:18,REAL,2861413557,490,2861414047,2869131614
2025-06-19 00:02:20,REAL,2861414047,482,2861414529,2869132096
2025-06-19 00:02:22,REAL,2861414529,539,2861415068,2869132635
2025-06-19 00:02:24,FAKE,2861415068,241,2861415309,2869133113
2025-06-19 00:02:26,REAL,2861415309,479,2861415788,2869133592
2025-06-19 00:02:28,REAL,2861415788,486,2861416274,2869134078
2025-06-19 00:02:30,REAL,2861416274,8682,2861424956,2869142760
2025-06-19 00:02:32,REAL,2861424956,10580,2861435536,2869153340
2025-06-19 00:02:34,REAL,2861435536,10252,2861445788,2869163592
2025-06-19 00:02:36,REAL,2861445788,10260,2861456048,2869173852
2025-06-19 00:02:38,REAL,2861456048,10251,2861466299,2869184103
2025-06-19 00:02:40,FAKE,2861466299,241,2861466540,2869194346
2025-06-19 00:02:42,FAKE,2861466540,241,2861466781,2869204668
2025-06-19 00:02:44,REAL,2861466781,7938,2861474719,2869212606
2025-06-19 00:02:46,REAL,2861474719,491,2861475210,2869213097
2025-06-19 00:02:48,FAKE,2861475210,244,2861475454,2869213574
2025-06-19 00:02:50,REAL,2861475454,543,2861475997,2869214117
2025-06-19 00:02:52,FAKE,2861475997,238,2861476235,2869214600
2025-06-19 00:02:54,REAL,2861476235,487,2861476722,2869215087
2025-06-19 00:02:56,REAL,2861476722,483,2861477205,2869215570
2025-06-19 00:02:58,FAKE,2861477205,238,2861477443,2869216057
2025-06-19 00:03:00,REAL,2861477443,486,2861477929,2869216543
2025-06-19 00:03:02,REAL,2861477929,10064,2861487993,2869226607
2025-06-19 00:03:04,REAL,2861487993,10454,2861498447,2869237061
2025-06-19 00:03:06,REAL,2861498447,10254,2861508701,2869247315
2025-06-19 00:03:08,REAL,2861508701,10245,2861518946,2869257560
2025-06-19 00:03:10,REAL,2861518946,10261,2861529207,2869267821
2025-06-19 00:03:12,REAL,2861529207,10254,2861539461,2869278075
2025-06-19 00:03:14,REAL,2861539461,10262,2861549723,2869288337
2025-06-19 00:03:16,FAKE,2861549723,238,2861549961,2869295757
2025-06-19 00:03:18,REAL,2861549961,482,2861550443,2869296239
2025-06-19 00:03:20,REAL,2861550443,489,2861550932,2869296728
2025-06-19 00:03:22,REAL,2861550932,494,2861551426,2869297222
2025-06-19 00:03:24,REAL,2861551426,482,2861551908,2869297704
2025-06-19 00:03:26,REAL,2861551908,485,2861552393,2869298189
2025-06-19 00:03:28,REAL,2861552393,475,2861552868,2869298664
2025-06-19 00:03:30,REAL,2861552868,483,2861553351,2869299147
2025-06-19 00:03:32,REAL,2861553351,488,2861553839,2869299635
2025-06-19 00:03:34,REAL,2861553839,11304,2861565143,2869310939
2025-06-19 00:03:36,FAKE,2861565143,238,2861565381,2869321469
2025-06-19 00:03:38,REAL,2861565381,10256,2861575637,2869331725
2025-06-19 00:03:40,REAL,2861575637,10314,2861585951,2869342039
2025-06-19 00:03:42,REAL,2861585951,10259,2861596210,2869352298
2025-06-19 00:03:44,REAL,2861596210,10250,2861606460,2869362548
2025-06-19 00:03:46,REAL,2861606460,10326,2861616786,2869372874
2025-06-19 00:03:48,REAL,2861616786,6747,2861623533,2869379621
2025-06-19 00:03:50,FAKE,2861623533,238,2861623771,2869380105
2025-06-19 00:03:52,REAL,2861623771,485,2861624256,2869380590
2025-06-19 00:03:54,REAL,2861624256,485,2861624741,2869381075
2025-06-19 00:03:56,REAL,2861624741,482,2861625223,2869381557
2025-06-19 00:03:58,REAL,2861625223,480,2861625703,2869382037
2025-06-19 00:04:00,REAL,2861625703,486,2861626189,2869382523
2025-06-19 00:04:02,REAL,2861626189,484,2861626673,2869383007
2025-06-19 00:04:04,REAL,2861626673,482,2861627155,2869383489
2025-06-19 00:04:06,REAL,2861627155,492,2861627647,2869383981
2025-06-19 00:04:08,FAKE,2861627647,243,2861627890,2869384464
2025-06-19 00:04:10,REAL,2861627890,481,2861628371,2869384945
2025-06-19 00:04:12,REAL,2861628371,486,2861628857,2869385431
2025-06-19 00:04:14,FAKE,2861628857,241,2861629098,2869385912
2025-06-19 00:04:16,FAKE,2861629098,241,2861629339,2869386390
2025-06-19 00:04:18,REAL,2861629339,488,2861629827,2869386878
2025-06-19 00:04:20,REAL,2861629827,545,2861630372,2869387423
2025-06-19 00:04:22,REAL,2861630372,537,2861630909,2869387960
2025-06-19 00:04:24,REAL,2861630909,482,2861631391,2869388442
2025-06-19 00:04:26,REAL,2861631391,478,2861631869,2869388920
2025-06-19 00:04:28,REAL,2861631869,483,2861632352,2869389403
2025-06-19 00:04:30,REAL,2861632352,489,2861632841,2869389892
2025-06-19 00:04:32,REAL,2861632841,489,2861633330,2869390381
2025-06-19 00:04:34,REAL,2861633330,485,2861633815,2869390866
2025-06-19 00:04:36,FAKE,2861633815,243,2861634058,2869391347
2025-06-19 00:04:38,FAKE,2861634058,243,2861634301,2869403537
2025-06-19 00:04:40,REAL,2861634301,10389,2861644690,2869413926
2025-06-19 00:04:42,REAL,2861644690,10185,2861654875,2869424111
2025-06-19 00:04:44,FAKE,2861654875,243,2861655118,2869434360
2025-06-19 00:04:46,REAL,2861655118,10316,2861665434,2869444676
2025-06-19 00:04:48,REAL,2861665434,10250,2861675684,2869454926
2025-06-19 00:04:50,REAL,2861675684,10327,2861686011,2869465253
2025-06-19 00:04:52,REAL,2861686011,5496,2861691507,2869470749
2025-06-19 00:04:54,REAL,2861691507,491,2861691998,2869471240
2025-06-19 00:04:56,REAL,2861691998,485,2861692483,2869471725
2025-06-19 00:04:58,FAKE,2861692483,241,2861692724,2869472217
2025-06-19 00:05:00,FAKE,2861692724,238,2861692962,2869472697
2025-06-19 00:05:02,FAKE,2861692962,243,2861693205,2869473180
2025-06-19 00:05:04,REAL,2861693205,541,2861693746,2869473721
2025-06-19 00:05:06,FAKE,2861693746,238,2861693984,2869474206
2025-06-19 00:05:08,REAL,2861693984,490,2861694474,2869474696
2025-06-19 00:05:10,FAKE,2861694474,241,2861694715,2869475188
2025-06-19 00:05:12,FAKE,2861694715,244,2861694959,2869475675
2025-06-19 00:05:14,REAL,2861694959,478,2861695437,2869476153
2025-06-19 00:05:16,REAL,2861695437,478,2861695915,2869476631
2025-06-19 00:05:18,REAL,2861695915,492,2861696407,2869477123
2025-06-19 00:05:20,REAL,2861696407,480,2861696887,2869477603
2025-06-19 00:05:22,FAKE,2861696887,241,2861697128,2869478087
2025-06-19 00:05:24,REAL,2861697128,490,2861697618,2869478577
2025-06-19 00:05:26,REAL,2861697618,539,2861698157,2869479116
2025-06-19 00:05:28,REAL,2861698157,478,2861698635,2869479594
2025-06-19 00:05:30,REAL,2861698635,481,2861699116,2869480075
2025-06-19 00:05:32,REAL,2861699116,475,2861699591,2869480550
2025-06-19 00:05:34,REAL,2861699591,482,2861700073,2869481032
2025-06-19 00:05:36,REAL,2861700073,483,2861700556,2869481515
2025-06-19 00:05:38,REAL,2861700556,480,2861701036,2869481995
2025-06-19 00:05:40,REAL,2861701036,490,2861701526,2869482485
2025-06-19 00:05:42,FAKE,2861701526,244,2861701770,2869482976
2025-06-19 00:05:44,FAKE,2861701770,241,2861702011,2869483507
2025-06-19 00:05:46,REAL,2861702011,488,2861702499,2869483995
2025-06-19 00:05:48,REAL,2861702499,477,2861702976,2869484472
2025-06-19 00:05:50,FAKE,2861702976,243,2861703219,2869484957
2025-06-19 00:05:52,FAKE,2861703219,241,2861703460,2869485439
2025-06-19 00:05:54,FAKE,2861703460,241,2861703701,2869485920
2025-06-19 00:05:56,REAL,2861703701,2018,2861705719,2869487938
2025-06-19 00:05:58,REAL,2861705719,12758,2861718477,2869500696
2025-06-19 00:06:00,REAL,2861718477,10250,2861728727,2869510946
2025-06-19 00:06:02,REAL,2861728727,10252,2861738979,2869521198
2025-06-19 00:06:04,REAL,2861738979,10318,2861749297,2869531516
2025-06-19 00:06:06,REAL,2861749297,10255,2861759552,2869541771
2025-06-19 00:06:08,REAL,2861759552,10250,2861769802,2869552021
2025-06-19 00:06:10,FAKE,2861769802,243,2861770045,2869562336
2025-06-19 00:06:12,REAL,2861770045,3984,2861774029,2869566320
2025-06-19 00:06:14,REAL,2861774029,475,2861774504,2869566795
2025-06-19 00:06:16,FAKE,2861774504,241,2861774745,2869567282
2025-06-19 00:06:18,REAL,2861774745,487,2861775232,2869567769
2025-06-19 00:06:20,REAL,2861775232,484,2861775716,2869568253
2025-06-19 00:06:22,REAL,2861775716,482,2861776198,2869568735
2025-06-19 00:06:24,FAKE,2861776198,241,2861776439,2869569271
2025-06-19 00:06:26,FAKE,2861776439,238,2861776677,2869569760
2025-06-19 00:06:28,REAL,2861776677,2746,2861779423,2869572506
2025-06-19 00:06:30,REAL,2861779423,11172,2861790595,2869583678
2025-06-19 00:06:32,FAKE,2861790595,244,2861790839,2869593993
2025-06-19 00:06:34,REAL,2861790839,10248,2861801087,2869604241
2025-06-19 00:06:36,REAL,2861801087,10322,2861811409,2869614563
2025-06-19 00:06:38,REAL,2861811409,10254,2861821663,2869624817
2025-06-19 00:06:40,REAL,2861821663,10250,2861831913,2869635067
2025-06-19 00:06:42,REAL,2861831913,10325,2861842238,2869645392
2025-06-19 00:06:44,REAL,2861842238,3250,2861845488,2869648642
2025-06-19 00:06:46,REAL,2861845488,489,2861845977,2869649131
2025-06-19 00:06:48,REAL,2861845977,488,2861846465,2869649619
2025-06-19 00:06:50,FAKE,2861846465,241,2861846706,2869650100
2025-06-19 00:06:52,REAL,2861846706,488,2861847194,2869650588
2025-06-19 00:06:54,REAL,2861847194,487,2861847681,2869651075
2025-06-19 00:06:56,FAKE,2861847681,244,2861847925,2869651554
2025-06-19 00:06:58,REAL,2861847925,484,2861848409,2869652038
2025-06-19 00:07:00,FAKE,2861848409,238,2861848647,2869655557
2025-06-19 00:07:02,FAKE,2861848647,243,2861848890,2869669437
2025-06-19 00:07:04,REAL,2861848890,10250,2861859140,2869679687
2025-06-19 00:07:06,REAL,2861859140,10310,2861869450,2869689997
2025-06-19 00:07:08,FAKE,2861869450,241,2861869691,2869700246
2025-06-19 00:07:10,REAL,2861869691,10314,2861880005,2869710560
2025-06-19 00:07:12,REAL,2861880005,10250,2861890255,2869720810
2025-06-19 00:07:14,REAL,2861890255,10253,2861900508,2869731063
2025-06-19 00:07:16,FAKE,2861900508,244,2861900752,2869733722
2025-06-19 00:07:18,FAKE,2861900752,243,2861900995,2869734209
2025-06-19 00:07:20,REAL,2861900995,483,2861901478,2869734692
2025-06-19 00:07:22,REAL,2861901478,9607,2861911085,2869744299
2025-06-19 00:07:24,REAL,2861911085,10453,2861921538,2869754752
2025-06-19 00:07:26,FAKE,2861921538,238,2861921776,2869765005
2025-06-19 00:07:28,REAL,2861921776,10320,2861932096,2869775325
2025-06-19 00:07:30,REAL,2861932096,10257,2861942353,2869785582
2025-06-19 00:07:32,REAL,2861942353,10256,2861952609,2869795838
2025-06-19 00:07:34,REAL,2861952609,10317,2861962926,2869806155
2025-06-19 00:07:36,REAL,2861962926,7211,2861970137,2869813366
2025-06-19 00:07:38,FAKE,2861970137,241,2861970378,2869813856
2025-06-19 00:07:40,FAKE,2861970378,244,2861970622,2869814335
2025-06-19 00:07:42,REAL,2861970622,535,2861971157,2869814870
2025-06-19 00:07:44,REAL,2861971157,490,2861971647,2869815360
2025-06-19 00:07:46,REAL,2861971647,475,2861972122,2869815835
2025-06-19 00:07:48,REAL,2861972122,481,2861972603,2869816316
2025-06-19 00:07:50,REAL,2861972603,241,2861972844,2869816557
2025-06-19 00:07:52,FAKE,2861972844,244,2861973088,2869817046
2025-06-19 00:07:54,FAKE,2861973088,241,2861973329,2869829879
2025-06-19 00:07:56,REAL,2861973329,10520,2861983849,2869840399
2025-06-19 00:07:58,FAKE,2861983849,244,2861984093,2869850725
2025-06-19 00:08:00,REAL,2861984093,10316,2861994409,2869861041
2025-06-19 00:08:02,FAKE,2861994409,243,2861994652,2869871294
2025-06-19 00:08:04,REAL,2861994652,10260,2862004912,2869881554
2025-06-19 00:08:06,REAL,2862004912,10319,2862015231,2869891873
2025-06-19 00:08:08,FAKE,2862015231,244,2862015475,2869898428
2025-06-19 00:08:10,REAL,2862015475,480,2862015955,2869898908
2025-06-19 00:08:12,FAKE,2862015955,238,2862016193,2869899392
2025-06-19 00:08:14,REAL,2862016193,489,2862016682,2869899881
2025-06-19 00:08:16,REAL,2862016682,488,2862017170,2869900369
2025-06-19 00:08:18,REAL,2862017170,481,2862017651,2869900850
2025-06-19 00:08:20,REAL,2862017651,547,2862018198,2869901397
2025-06-19 00:08:22,REAL,2862018198,480,2862018678,2869901877
2025-06-19 00:08:24,REAL,2862018678,485,2862019163,2869902362
2025-06-19 00:08:26,REAL,2862019163,15074,2862034237,2869917436
2025-06-19 00:08:28,REAL,2862034237,10386,2862044623,2869927822
2025-06-19 00:08:30,FAKE,2862044623,241,2862044864,2869938084
2025-06-19 00:08:32,FAKE,2862044864,238,2862045102,2869948396
2025-06-19 00:08:34,REAL,2862045102,10254,2862055356,2869958650
2025-06-19 00:08:36,REAL,2862055356,10319,2862065675,2869968969
2025-06-19 00:08:38,REAL,2862065675,10251,2862075926,2869979220
2025-06-19 00:08:40,REAL,2862075926,5963,2862081889,2869985183
2025-06-19 00:08:42,REAL,2862081889,486,2862082375,2869985669
2025-06-19 00:08:44,REAL,2862082375,493,2862082868,2869986162
2025-06-19 00:08:46,REAL,2862082868,492,2862083360,2869986654
2025-06-19 00:08:48,REAL,2862083360,489,2862083849,2869987143
2025-06-19 00:08:50,FAKE,2862083849,244,2862084093,2869987624
2025-06-19 00:08:52,FAKE,2862084093,241,2862084334,2869988106
2025-06-19 00:08:54,FAKE,2862084334,243,2862084577,2869988599
2025-06-19 00:08:56,FAKE,2862084577,238,2862084815,2869989139
2025-06-19 00:08:58,REAL,2862084815,12097,2862096912,2870001236
2025-06-19 00:09:00,REAL,2862096912,10318,2862107230,2870011554
2025-06-19 00:09:02,REAL,2862107230,10245,2862117475,2870021799
2025-06-19 00:09:04,FAKE,2862117475,244,2862117719,2870032049
2025-06-19 00:09:06,REAL,2862117719,10243,2862127962,2870042292
2025-06-19 00:09:08,REAL,2862127962,10247,2862138209,2870052539
2025-06-19 00:09:10,FAKE,2862138209,238,2862138447,2870062795
2025-06-19 00:09:12,FAKE,2862138447,244,2862138691,2870068166
2025-06-19 00:09:14,REAL,2862138691,489,2862139180,2870068655
2025-06-19 00:09:16,REAL,2862139180,485,2862139665,2870069140
2025-06-19 00:09:18,FAKE,2862139665,243,2862139908,2870069621
2025-06-19 00:09:20,REAL,2862139908,484,2862140392,2870070105
2025-06-19 00:09:22,REAL,2862140392,485,2862140877,2870070590
2025-06-19 00:09:24,REAL,2862140877,483,2862141360,2870071073
2025-06-19 00:09:26,REAL,2862141360,533,2862141893,2870071606
2025-06-19 00:09:28,FAKE,2862141893,241,2862142134,2870072089
2025-06-19 00:09:30,REAL,2862142134,483,2862142617,2870072572
2025-06-19 00:09:32,FAKE,2862142617,241,2862142858,2870073053
2025-06-19 00:09:34,REAL,2862142858,486,2862143344,2870073539
2025-06-19 00:09:36,REAL,2862143344,536,2862143880,2870074075
2025-06-19 00:09:38,REAL,2862143880,482,2862144362,2870074557
2025-06-19 00:09:40,REAL,2862144362,486,2862144848,2870075043
2025-06-19 00:09:42,FAKE,2862144848,244,2862145092,2870075526
2025-06-19 00:09:44,REAL,2862145092,488,2862145580,2870076014
2025-06-19 00:09:46,FAKE,2862145580,244,2862145824,2870076491
2025-06-19 00:09:48,REAL,2862145824,481,2862146305,2870076972
2025-06-19 00:09:50,REAL,2862146305,490,2862146795,2870077462
2025-06-19 00:09:52,REAL,2862146795,480,2862147275,2870077942
2025-06-19 00:09:54,REAL,2862147275,488,2862147763,2870078430
2025-06-19 00:09:56,REAL,2862147763,485,2862148248,2870078915
2025-06-19 00:09:58,REAL,2862148248,539,2862148787,2870079454
2025-06-19 00:10:00,FAKE,2862148787,243,2862149030,2870081326
2025-06-19 00:10:02,FAKE,2862149030,238,2862149268,2870093021
2025-06-19 00:10:04,REAL,2862149268,10322,2862159590,2870103343
2025-06-19 00:10:06,FAKE,2862159590,238,2862159828,2870113596
2025-06-19 00:10:08,FAKE,2862159828,238,2862160066,2870123910
2025-06-19 00:10:10,REAL,2862160066,10323,2862170389,2870134233
2025-06-19 00:10:12,REAL,2862170389,10252,2862180641,2870144485
2025-06-19 00:10:14,FAKE,2862180641,243,2862180884,2870154738
2025-06-19 00:10:16,FAKE,2862180884,238,2862181122,2870158788
2025-06-19 00:10:18,REAL,2862181122,486,2862181608,2870159274
2025-06-19 00:10:20,REAL,2862181608,487,2862182095,2870159761
2025-06-19 00:10:22,REAL,2862182095,480,2862182575,2870160241
2025-06-19 00:10:24,REAL,2862182575,489,2862183064,2870160730
2025-06-19 00:10:26,REAL,2862183064,480,2862183544,2870161210
2025-06-19 00:10:28,REAL,2862183544,485,2862184029,2870161695
2025-06-19 00:10:30,REAL,2862184029,546,2862184575,2870162241
2025-06-19 00:10:32,REAL,2862184575,481,2862185056,2870162722
2025-06-19 00:10:34,FAKE,2862185056,238,2862185294,2870163204
2025-06-19 00:10:36,REAL,2862185294,484,2862185778,2870163688
2025-06-19 00:10:38,FAKE,2862185778,244,2862186022,2870164170
2025-06-19 00:10:40,REAL,2862186022,494,2862186516,2870164664
2025-06-19 00:10:42,REAL,2862186516,785,2862187301,2870165449
2025-06-19 00:10:44,FAKE,2862187301,241,2862187542,2870165696
2025-06-19 00:10:46,REAL,2862187542,481,2862188023,2870166177
2025-06-19 00:10:48,FAKE,2862188023,243,2862188266,2870166665
2025-06-19 00:10:50,REAL,2862188266,485,2862188751,2870167150
2025-06-19 00:10:52,REAL,2862188751,489,2862189240,2870167639
2025-06-19 00:10:54,REAL,2862189240,493,2862189733,2870168132
2025-06-19 00:10:56,REAL,2862189733,488,2862190221,2870168620
2025-06-19 00:10:58,REAL,2862190221,493,2862190714,2870169113
2025-06-19 00:11:00,FAKE,2862190714,243,2862190957,2870169600
2025-06-19 00:11:02,FAKE,2862190957,238,2862191195,2870170141
2025-06-19 00:11:04,REAL,2862191195,3392,2862194587,2870173533
2025-06-19 00:11:06,REAL,2862194587,11439,2862206026,2870184972
2025-06-19 00:11:08,REAL,2862206026,10316,2862216342,2870195288
2025-06-19 00:11:10,REAL,2862216342,10248,2862226590,2870205536
2025-06-19 00:11:12,FAKE,2862226590,241,2862226831,2870215783
2025-06-19 00:11:14,FAKE,2862226831,238,2862227069,2870226089
2025-06-19 00:11:16,REAL,2862227069,10245,2862237314,2870236334
2025-06-19 00:11:18,REAL,2862237314,10311,2862247625,2870246645
2025-06-19 00:11:20,FAKE,2862247625,243,2862247868,2870249441
2025-06-19 00:11:22,REAL,2862247868,492,2862248360,2870249933
2025-06-19 00:11:24,REAL,2862248360,485,2862248845,2870250418
2025-06-19 00:11:26,FAKE,2862248845,244,2862249089,2870250900
2025-06-19 00:11:28,REAL,2862249089,485,2862249574,2870251385
2025-06-19 00:11:30,FAKE,2862249574,244,2862249818,2870251872
2025-06-19 00:11:32,REAL,2862249818,483,2862250301,2870252355
2025-06-19 00:11:34,FAKE,2862250301,241,2862250542,2870252892
2025-06-19 00:11:36,FAKE,2862250542,238,2862250780,2870253372
2025-06-19 00:11:38,FAKE,2862250780,241,2862251021,2870253859
2025-06-19 00:11:40,REAL,2862251021,486,2862251507,2870254345
2025-06-19 00:11:42,FAKE,2862251507,241,2862251748,2870264010
2025-06-19 00:11:44,REAL,2862251748,10448,2862262196,2870274458
2025-06-19 00:11:46,REAL,2862262196,10309,2862272505,2870284767
2025-06-19 00:11:48,FAKE,2862272505,243,2862272748,2870295023
2025-06-19 00:11:50,REAL,2862272748,10318,2862283066,2870305341
2025-06-19 00:11:52,REAL,2862283066,10256,2862293322,2870315597
2025-06-19 00:11:54,FAKE,2862293322,243,2862293565,2870325853
2025-06-19 00:11:56,FAKE,2862293565,241,2862293806,2870332871
2025-06-19 00:11:58,REAL,2862293806,484,2862294290,2870333355
2025-06-19 00:12:00,FAKE,2862294290,241,2862294531,2870333847
2025-06-19 00:12:02,REAL,2862294531,483,2862295014,2870334330
2025-06-19 00:12:04,FAKE,2862295014,238,2862295252,2870334824
2025-06-19 00:12:06,FAKE,2862295252,243,2862295495,2870335308
2025-06-19 00:12:08,REAL,2862295495,482,2862295977,2870335790
2025-06-19 00:12:10,FAKE,2862295977,243,2862296220,2870336336
2025-06-19 00:12:12,REAL,2862296220,491,2862296711,2870336827
2025-06-19 00:12:14,REAL,2862296711,13760,2862310471,2870350587
2025-06-19 00:12:16,REAL,2862310471,10642,2862321113,2870361229
2025-06-19 00:12:18,REAL,2862321113,10250,2862331363,2870371479
2025-06-19 00:12:20,FAKE,2862331363,241,2862331604,2870381785
2025-06-19 00:12:22,REAL,2862331604,10315,2862341919,2870392100
2025-06-19 00:12:24,REAL,2862341919,10254,2862352173,2870402354
2025-06-19 00:12:26,REAL,2862352173,10248,2862362421,2870412602
2025-06-19 00:12:28,FAKE,2862362421,241,2862362662,2870419020
2025-06-19 00:12:30,REAL,2862362662,486,2862363148,2870419506
2025-06-19 00:12:32,FAKE,2862363148,241,2862363389,2870419986
2025-06-19 00:12:34,REAL,2862363389,486,2862363875,2870420472
2025-06-19 00:12:36,FAKE,2862363875,243,2862364118,2870420960
2025-06-19 00:12:38,FAKE,2862364118,244,2862364362,2870421440
2025-06-19 00:12:40,REAL,2862364362,484,2862364846,2870421924
2025-06-19 00:12:42,REAL,2862364846,540,2862365386,2870422464
2025-06-19 00:12:44,FAKE,2862365386,244,2862365630,2870422940
2025-06-19 00:12:46,REAL,2862365630,489,2862366119,2870423429
2025-06-19 00:12:48,REAL,2862366119,477,2862366596,2870423906
2025-06-19 00:12:50,REAL,2862366596,486,2862367082,2870424392
2025-06-19 00:12:52,REAL,2862367082,543,2862367625,2870424935
2025-06-19 00:12:54,REAL,2862367625,492,2862368117,2870425427
2025-06-19 00:12:56,REAL,2862368117,485,2862368602,2870425912
2025-06-19 00:12:58,REAL,2862368602,490,2862369092,2870426402
2025-06-19 00:13:00,REAL,2862369092,482,2862369574,2870426884
2025-06-19 00:13:02,REAL,2862369574,476,2862370050,2870427360
2025-06-19 00:13:04,FAKE,2862370050,241,2862370291,2870427840
2025-06-19 00:13:06,REAL,2862370291,482,2862370773,2870428322
2025-06-19 00:13:08,FAKE,2862370773,243,2862371016,2870428815
2025-06-19 00:13:10,REAL,2862371016,476,2862371492,2870429291
2025-06-19 00:13:12,REAL,2862371492,545,2862372037,2870429836
2025-06-19 00:13:14,REAL,2862372037,485,2862372522,2870430321
2025-06-19 00:13:16,FAKE,2862372522,238,2862372760,2870430807
2025-06-19 00:13:18,REAL,2862372760,492,2862373252,2870431299
2025-06-19 00:13:20,REAL,2862373252,488,2862373740,2870431787
2025-06-19 00:13:22,FAKE,2862373740,243,2862373983,2870432270
2025-06-19 00:13:24,FAKE,2862373983,238,2862374221,2870432814
2025-06-19 00:13:26,REAL,2862374221,480,2862374701,2870433294
2025-06-19 00:13:28,REAL,2862374701,488,2862375189,2870433782
2025-06-19 00:13:30,REAL,2862375189,476,2862375665,2870434258
2025-06-19 00:13:32,REAL,2862375665,485,2862376150,2870434743
2025-06-19 00:13:34,REAL,2862376150,475,2862376625,2870435218
2025-06-19 00:13:36,REAL,2862376625,480,2862377105,2870435698
2025-06-19 00:13:38,FAKE,2862377105,241,2862377346,2870436180
2025-06-19 00:13:40,REAL,2862377346,481,2862377827,2870436661
2025-06-19 00:13:42,REAL,2862377827,545,2862378372,2870437206
2025-06-19 00:13:44,REAL,2862378372,485,2862378857,2870437691
2025-06-19 00:13:46,REAL,2862378857,481,2862379338,2870438172
2025-06-19 00:13:48,REAL,2862379338,474,2862379812,2870438646
2025-06-19 00:13:50,FAKE,2862379812,244,2862380056,2870439135
2025-06-19 00:13:52,REAL,2862380056,486,2862380542,2870439621
2025-06-19 00:13:54,REAL,2862380542,482,2862381024,2870440103
2025-06-19 00:13:56,REAL,2862381024,494,2862381518,2870440597
2025-06-19 00:13:58,REAL,2862381518,535,2862382053,2870441132
2025-06-19 00:14:00,FAKE,2862382053,241,2862382294,2870441611
2025-06-19 00:14:02,FAKE,2862382294,243,2862382537,2870442092
2025-06-19 00:14:04,FAKE,2862382537,243,2862382780,2870443835
2025-06-19 00:14:06,FAKE,2862382780,244,2862383024,2870455957
2025-06-19 00:14:08,REAL,2862383024,10252,2862393276,2870466209
2025-06-19 00:14:10,REAL,2862393276,10253,2862403529,2870476462
2025-06-19 00:14:12,REAL,2862403529,10247,2862413776,2870486709
2025-06-19 00:14:14,REAL,2862413776,10246,2862424022,2870496955
2025-06-19 00:14:16,REAL,2862424022,10252,2862434274,2870507207
2025-06-19 00:14:18,REAL,2862434274,10319,2862444593,2870517526
2025-06-19 00:14:20,FAKE,2862444593,244,2862444837,2870521702
2025-06-19 00:14:22,FAKE,2862444837,243,2862445080,2870522193
2025-06-19 00:14:24,REAL,2862445080,486,2862445566,2870522679
2025-06-19 00:14:26,FAKE,2862445566,243,2862445809,2870523162
2025-06-19 00:14:28,REAL,2862445809,491,2862446300,2870523653
2025-06-19 00:14:30,REAL,2862446300,541,2862446841,2870524194
2025-06-19 00:14:32,REAL,2862446841,550,2862447391,2870524744
2025-06-19 00:14:34,REAL,2862447391,484,2862447875,2870525228
2025-06-19 00:14:36,REAL,2862447875,480,2862448355,2870525708
2025-06-19 00:14:38,REAL,2862448355,486,2862448841,2870526194
2025-06-19 00:14:40,REAL,2862448841,478,2862449319,2870526672
2025-06-19 00:14:42,REAL,2862449319,481,2862449800,2870527153
2025-06-19 00:14:44,FAKE,2862449800,243,2862450043,2870527631
2025-06-19 00:14:46,REAL,2862450043,483,2862450526,2870528114
2025-06-19 00:14:48,REAL,2862450526,486,2862451012,2870528600
2025-06-19 00:14:50,REAL,2862451012,483,2862451495,2870529083
2025-06-19 00:14:52,REAL,2862451495,479,2862451974,2870529562
2025-06-19 00:14:54,FAKE,2862451974,238,2862452212,2870530101
2025-06-19 00:14:56,REAL,2862452212,485,2862452697,2870530586
2025-06-19 00:14:58,FAKE,2862452697,241,2862452938,2870531120
2025-06-19 00:15:00,REAL,2862452938,483,2862453421,2870531603
2025-06-19 00:15:02,REAL,2862453421,482,2862453903,2870532085
2025-06-19 00:15:04,REAL,2862453903,475,2862454378,2870532560
2025-06-19 00:15:06,REAL,2862454378,479,2862454857,2870533039
2025-06-19 00:15:08,FAKE,2862454857,243,2862455100,2870536302
2025-06-19 00:15:10,REAL,2862455100,14798,2862469898,2870551100
2025-06-19 00:15:12,REAL,2862469898,10319,2862480217,2870561419
2025-06-19 00:15:14,REAL,2862480217,10244,2862490461,2870571663
2025-06-19 00:15:16,FAKE,2862490461,243,2862490704,2870581914
2025-06-19 00:15:18,REAL,2862490704,10320,2862501024,2870592234
2025-06-19 00:15:20,FAKE,2862501024,243,2862501267,2870602539
2025-06-19 00:15:22,REAL,2862501267,10249,2862511516,2870612788
2025-06-19 00:15:24,REAL,2862511516,2994,2862514510,2870615782
2025-06-19 00:15:26,REAL,2862514510,479,2862514989,2870616261
2025-06-19 00:15:28,REAL,2862514989,493,2862515482,2870616754
2025-06-19 00:15:30,REAL,2862515482,483,2862515965,2870617237
2025-06-19 00:15:32,REAL,2862515965,489,2862516454,2870617726
2025-06-19 00:15:34,REAL,2862516454,541,2862516995,2870618267
2025-06-19 00:15:36,REAL,2862516995,486,2862517481,2870618753
2025-06-19 00:15:38,REAL,2862517481,483,2862517964,2870619236
2025-06-19 00:15:40,FAKE,2862517964,244,2862518208,2870619721
2025-06-19 00:15:42,REAL,2862518208,480,2862518688,2870620201
2025-06-19 00:15:44,FAKE,2862518688,241,2862518929,2870620745
2025-06-19 00:15:46,REAL,2862518929,489,2862519418,2870621234
2025-06-19 00:15:48,FAKE,2862519418,243,2862519661,2870621719
2025-06-19 00:15:50,REAL,2862519661,490,2862520151,2870622209
2025-06-19 00:15:52,REAL,2862520151,475,2862520626,2870622684
2025-06-19 00:15:54,REAL,2862520626,483,2862521109,2870623167
2025-06-19 00:15:56,FAKE,2862521109,241,2862521350,2870623649
2025-06-19 00:15:58,REAL,2862521350,488,2862521838,2870624137
2025-06-19 00:16:00,FAKE,2862521838,243,2862522081,2870624623
2025-06-19 00:16:02,REAL,2862522081,540,2862522621,2870625163
2025-06-19 00:16:04,REAL,2862522621,483,2862523104,2870625646
2025-06-19 00:16:06,REAL,2862523104,481,2862523585,2870626127
2025-06-19 00:16:08,REAL,2862523585,488,2862524073,2870626615
2025-06-19 00:16:10,FAKE,2862524073,238,2862524311,2870627157
2025-06-19 00:16:12,REAL,2862524311,483,2862524794,2870627640
2025-06-19 00:16:14,REAL,2862524794,490,2862525284,2870628130
2025-06-19 00:16:16,REAL,2862525284,490,2862525774,2870628620
2025-06-19 00:16:18,REAL,2862525774,485,2862526259,2870629105
2025-06-19 00:16:20,FAKE,2862526259,238,2862526497,2870629591
2025-06-19 00:16:22,REAL,2862526497,485,2862526982,2870630076
2025-06-19 00:16:24,REAL,2862526982,484,2862527466,2870630560
2025-06-19 00:16:26,REAL,2862527466,484,2862527950,2870631044
2025-06-19 00:16:28,FAKE,2862527950,244,2862528194,2870631583
2025-06-19 00:16:30,REAL,2862528194,481,2862528675,2870632064
2025-06-19 00:16:32,FAKE,2862528675,238,2862528913,2870632548
2025-06-19 00:16:34,REAL,2862528913,486,2862529399,2870633034
2025-06-19 00:16:36,REAL,2862529399,549,2862529948,2870633583
2025-06-19 00:16:38,REAL,2862529948,480,2862530428,2870634063
2025-06-19 00:16:40,REAL,2862530428,479,2862530907,2870634542
2025-06-19 00:16:42,FAKE,2862530907,244,2862531151,2870635028
2025-06-19 00:16:44,REAL,2862531151,486,2862531637,2870635514
2025-06-19 00:16:46,FAKE,2862531637,243,2862531880,2870636002
2025-06-19 00:16:48,REAL,2862531880,478,2862532358,2870636480
2025-06-19 00:16:50,REAL,2862532358,11046,2862543404,2870647526
2025-06-19 00:16:52,REAL,2862543404,10315,2862553719,2870657841
2025-06-19 00:16:54,FAKE,2862553719,238,2862553957,2870668155
2025-06-19 00:16:56,FAKE,2862553957,243,2862554200,2870678480
2025-06-19 00:16:58,REAL,2862554200,10254,2862564454,2870688734
2025-06-19 00:17:00,REAL,2862564454,10378,2862574832,2870699112
2025-06-19 00:17:02,FAKE,2862574832,238,2862575070,2870709367
2025-06-19 00:17:04,REAL,2862575070,6160,2862581230,2870715527
2025-06-19 00:17:06,REAL,2862581230,484,2862581714,2870716011
2025-06-19 00:17:08,REAL,2862581714,478,2862582192,2870716489
2025-06-19 00:17:10,FAKE,2862582192,238,2862582430,2870716979
2025-06-19 00:17:12,REAL,2862582430,488,2862582918,2870717467
2025-06-19 00:17:14,REAL,2862582918,485,2862583403,2870717952
2025-06-19 00:17:16,FAKE,2862583403,238,2862583641,2870718489
2025-06-19 00:17:18,FAKE,2862583641,244,2862583885,2870718968
2025-06-19 00:17:20,REAL,2862583885,480,2862584365,2870719448
2025-06-19 00:17:22,FAKE,2862584365,244,2862584609,2870734474
2025-06-19 00:17:24,FAKE,2862584609,244,2862584853,2870744779
2025-06-19 00:17:26,REAL,2862584853,10320,2862595173,2870755099
2025-06-19 00:17:28,REAL,2862595173,10242,2862605415,2870765341
2025-06-19 00:17:30,FAKE,2862605415,241,2862605656,2870775656
2025-06-19 00:17:32,REAL,2862605656,10254,2862615910,2870785910
2025-06-19 00:17:34,FAKE,2862615910,244,2862616154,2870796231
2025-06-19 00:17:36,REAL,2862616154,5431,2862621585,2870801662
2025-06-19 00:17:38,REAL,2862621585,485,2862622070,2870802147
2025-06-19 00:17:40,FAKE,2862622070,243,2862622313,2870802629
2025-06-19 00:17:42,REAL,2862622313,487,2862622800,2870803116
2025-06-19 00:17:44,REAL,2862622800,484,2862623284,2870803600
2025-06-19 00:17:46,REAL,2862623284,533,2862623817,2870804133
2025-06-19 00:17:48,REAL,2862623817,544,2862624361,2870804677
2025-06-19 00:17:50,FAKE,2862624361,243,2862624604,2870805163
2025-06-19 00:17:52,REAL,2862624604,491,2862625095,2870805654
2025-06-19 00:17:54,REAL,2862625095,477,2862625572,2870806131
2025-06-19 00:17:56,REAL,2862625572,485,2862626057,2870806616
2025-06-19 00:17:58,FAKE,2862626057,241,2862626298,2870807096
2025-06-19 00:18:00,REAL,2862626298,477,2862626775,2870807573
2025-06-19 00:18:02,REAL,2862626775,485,2862627260,2870808058
2025-06-19 00:18:04,REAL,2862627260,479,2862627739,2870808537
2025-06-19 00:18:06,FAKE,2862627739,241,2862627980,2870809026
2025-06-19 00:18:08,FAKE,2862627980,243,2862628223,2870809518
2025-06-19 00:18:10,FAKE,2862628223,238,2862628461,2870809995
2025-06-19 00:18:12,FAKE,2862628461,238,2862628699,2870810542
2025-06-19 00:18:14,FAKE,2862628699,241,2862628940,2870811086
2025-06-19 00:18:16,REAL,2862628940,487,2862629427,2870811573
2025-06-19 00:18:18,REAL,2862629427,487,2862629914,2870812060
2025-06-19 00:18:20,FAKE,2862629914,243,2862630157,2870812538
2025-06-19 00:18:22,FAKE,2862630157,244,2862630401,2870813021
2025-06-19 00:18:24,FAKE,2862630401,244,2862630645,2870813505
2025-06-19 00:18:26,FAKE,2862630645,244,2862630889,2870813983
2025-06-19 00:18:28,FAKE,2862630889,241,2862631130,2870814465
2025-06-19 00:18:30,REAL,2862631130,489,2862631619,2870814954
2025-06-19 00:18:32,FAKE,2862631619,244,2862631863,2870815447
2025-06-19 00:18:34,REAL,2862631863,485,2862632348,2870815932
2025-06-19 00:18:36,FAKE,2862632348,241,2862632589,2870816423
2025-06-19 00:18:38,FAKE,2862632589,238,2862632827,2870816963
2025-06-19 00:18:40,REAL,2862632827,537,2862633364,2870817500
2025-06-19 00:18:42,FAKE,2862633364,238,2862633602,2870817978
2025-06-19 00:18:44,REAL,2862633602,478,2862634080,2870818456
2025-06-19 00:18:46,REAL,2862634080,9801,2862643881,2870828257
2025-06-19 00:18:48,FAKE,2862643881,244,2862644125,2870840296
2025-06-19 00:18:50,REAL,2862644125,10323,2862654448,2870850619
2025-06-19 00:18:52,REAL,2862654448,10244,2862664692,2870860863
2025-06-19 00:18:54,REAL,2862664692,10254,2862674946,2870871117
2025-06-19 00:18:56,REAL,2862674946,10253,2862685199,2870881370
2025-06-19 00:18:58,FAKE,2862685199,241,2862685440,2870891685
2025-06-19 00:19:00,FAKE,2862685440,238,2862685678,2870900421
2025-06-19 00:19:02,FAKE,2862685678,244,2862685922,2870900951
2025-06-19 00:19:04,REAL,2862685922,481,2862686403,2870901432
2025-06-19 00:19:06,FAKE,2862686403,243,2862686646,2870901909
2025-06-19 00:19:08,FAKE,2862686646,243,2862686889,2870902384
2025-06-19 00:19:10,REAL,2862686889,493,2862687382,2870902877
2025-06-19 00:19:12,REAL,2862687382,481,2862687863,2870903358
2025-06-19 00:19:14,REAL,2862687863,539,2862688402,2870903897
2025-06-19 00:19:16,FAKE,2862688402,238,2862688640,2870904375
2025-06-19 00:19:18,FAKE,2862688640,238,2862688878,2870904868
2025-06-19 00:19:20,REAL,2862688878,483,2862689361,2870905351
2025-06-19 00:19:22,REAL,2862689361,479,2862689840,2870905830
2025-06-19 00:19:24,REAL,2862689840,482,2862690322,2870906312
2025-06-19 00:19:26,REAL,2862690322,480,2862690802,2870906792
2025-06-19 00:19:28,REAL,2862690802,539,2862691341,2870907331
2025-06-19 00:19:30,REAL,2862691341,487,2862691828,2870907818
2025-06-19 00:19:32,REAL,2862691828,480,2862692308,2870908298
2025-06-19 00:19:34,REAL,2862692308,483,2862692791,2870908781
2025-06-19 00:19:36,REAL,2862692791,490,2862693281,2870909271
2025-06-19 00:19:38,FAKE,2862693281,244,2862693525,2870909755
2025-06-19 00:19:40,REAL,2862693525,485,2862694010,2870910240
2025-06-19 00:19:42,REAL,2862694010,539,2862694549,2870910779
2025-06-19 00:19:44,REAL,2862694549,478,2862695027,2870911257
2025-06-19 00:19:46,REAL,2862695027,488,2862695515,2870911745
2025-06-19 00:19:48,FAKE,2862695515,241,2862695756,2870912227
2025-06-19 00:19:50,REAL,2862695756,481,2862696237,2870912708
2025-06-19 00:19:52,FAKE,2862696237,243,2862696480,2870913194
2025-06-19 00:19:54,FAKE,2862696480,244,2862696724,2870913731
2025-06-19 00:19:56,REAL,2862696724,480,2862697204,2870914211
2025-06-19 00:19:58,REAL,2862697204,486,2862697690,2870914697
2025-06-19 00:20:00,REAL,2862697690,485,2862698175,2870915182
2025-06-19 00:20:02,FAKE,2862698175,241,2862698416,2870915667
2025-06-19 00:20:04,FAKE,2862698416,241,2862698657,2870916155
2025-06-19 00:20:06,FAKE,2862698657,238,2862698895,2870928131
2025-06-19 00:20:08,FAKE,2862698895,241,2862699136,2870939373
2025-06-19 00:20:10,REAL,2862699136,10254,2862709390,2870949627
2025-06-19 00:20:12,REAL,2862709390,10245,2862719635,2870959872
2025-06-19 00:20:14,REAL,2862719635,10317,2862729952,2870970189
2025-06-19 00:20:16,FAKE,2862729952,241,2862730193,2870980447
2025-06-19 00:20:18,REAL,2862730193,10307,2862740500,2870990754
2025-06-19 00:20:20,REAL,2862740500,7153,2862747653,2870997907
2025-06-19 00:20:22,REAL,2862747653,486,2862748139,2870998393
2025-06-19 00:20:24,REAL,2862748139,479,2862748618,2870998872
2025-06-19 00:20:26,FAKE,2862748618,244,2862748862,2870999346
2025-06-19 00:20:28,REAL,2862748862,479,2862749341,2870999825
2025-06-19 00:20:30,FAKE,2862749341,243,2862749584,2871000300
2025-06-19 00:20:32,REAL,2862749584,488,2862750072,2871000788
2025-06-19 00:20:34,FAKE,2862750072,238,2862750310,2871001335
2025-06-19 00:20:36,REAL,2862750310,484,2862750794,2871001819
2025-06-19 00:20:38,REAL,2862750794,11192,2862761986,2871013011
2025-06-19 00:20:40,REAL,2862761986,10320,2862772306,2871023331
2025-06-19 00:20:42,FAKE,2862772306,238,2862772544,2871033706
2025-06-19 00:20:44,REAL,2862772544,10260,2862782804,2871043966
2025-06-19 00:20:46,FAKE,2862782804,238,2862783042,2871054215
2025-06-19 00:20:48,FAKE,2862783042,243,2862783285,2871064475
2025-06-19 00:20:50,REAL,2862783285,10248,2862793533,2871074723
2025-06-19 00:20:52,REAL,2862793533,6559,2862800092,2871081282
2025-06-19 00:20:54,FAKE,2862800092,243,2862800335,2871081767
2025-06-19 00:20:56,REAL,2862800335,488,2862800823,2871082255
2025-06-19 00:20:58,REAL,2862800823,478,2862801301,2871082733
2025-06-19 00:21:00,FAKE,2862801301,241,2862801542,2871083218
2025-06-19 00:21:02,REAL,2862801542,482,2862802024,2871083700
2025-06-19 00:21:04,REAL,2862802024,541,2862802565,2871084241
2025-06-19 00:21:06,REAL,2862802565,490,2862803055,2871084731
2025-06-19 00:21:08,REAL,2862803055,541,2862803596,2871085272
2025-06-19 00:21:10,FAKE,2862803596,243,2862803839,2871096665
2025-06-19 00:21:12,REAL,2862803839,10252,2862814091,2871106917
2025-06-19 00:21:14,REAL,2862814091,10248,2862824339,2871117165
2025-06-19 00:21:16,REAL,2862824339,10243,2862834582,2871127408
2025-06-19 00:21:18,REAL,2862834582,10255,2862844837,2871137663
2025-06-19 00:21:20,REAL,2862844837,10251,2862855088,2871147914
2025-06-19 00:21:22,FAKE,2862855088,244,2862855332,2871158169
2025-06-19 00:21:24,REAL,2862855332,5962,2862861294,2871164131
2025-06-19 00:21:26,REAL,2862861294,494,2862861788,2871164625
2025-06-19 00:21:28,FAKE,2862861788,238,2862862026,2871165115
2025-06-19 00:21:30,REAL,2862862026,482,2862862508,2871165597
2025-06-19 00:21:32,REAL,2862862508,547,2862863055,2871166144
2025-06-19 00:21:34,REAL,2862863055,490,2862863545,2871166634
2025-06-19 00:21:36,REAL,2862863545,538,2862864083,2871167172
2025-06-19 00:21:38,REAL,2862864083,488,2862864571,2871167660
2025-06-19 00:21:40,REAL,2862864571,491,2862865062,2871168151
2025-06-19 00:21:42,REAL,2862865062,485,2862865547,2871168636
2025-06-19 00:21:44,REAL,2862865547,491,2862866038,2871169127
2025-06-19 00:21:46,REAL,2862866038,485,2862866523,2871169612
2025-06-19 00:21:48,REAL,2862866523,487,2862867010,2871170099
2025-06-19 00:21:50,REAL,2862867010,490,2862867500,2871170589
2025-06-19 00:21:52,REAL,2862867500,489,2862867989,2871171078
2025-06-19 00:21:54,REAL,2862867989,477,2862868466,2871171555
2025-06-19 00:21:56,FAKE,2862868466,244,2862868710,2871172097
2025-06-19 00:21:58,REAL,2862868710,483,2862869193,2871172580
2025-06-19 00:22:00,REAL,2862869193,481,2862869674,2871173061
2025-06-19 00:22:02,REAL,2862869674,482,2862870156,2871173543
2025-06-19 00:22:04,REAL,2862870156,536,2862870692,2871174079
2025-06-19 00:22:06,REAL,2862870692,485,2862871177,2871174564
2025-06-19 00:22:08,REAL,2862871177,488,2862871665,2871175052
2025-06-19 00:22:10,REAL,2862871665,486,2862872151,2871175538
2025-06-19 00:22:12,REAL,2862872151,485,2862872636,2871176023
2025-06-19 00:22:14,FAKE,2862872636,238,2862872874,2871176500
2025-06-19 00:22:16,REAL,2862872874,482,2862873356,2871176982
2025-06-19 00:22:18,REAL,2862873356,489,2862873845,2871177471
2025-06-19 00:22:20,FAKE,2862873845,244,2862874089,2871178013
2025-06-19 00:22:22,REAL,2862874089,478,2862874567,2871178491
2025-06-19 00:22:24,FAKE,2862874567,238,2862874805,2871178968
2025-06-19 00:22:26,REAL,2862874805,477,2862875282,2871179445
2025-06-19 00:22:28,REAL,2862875282,1545,2862876827,2871180990
2025-06-19 00:22:30,REAL,2862876827,14808,2862891635,2871195798
2025-06-19 00:22:32,REAL,2862891635,10313,2862901948,2871206111
2025-06-19 00:22:34,REAL,2862901948,10262,2862912210,2871216373
2025-06-19 00:22:36,REAL,2862912210,10327,2862922537,2871226700
2025-06-19 00:22:38,REAL,2862922537,10243,2862932780,2871236943
2025-06-19 00:22:40,REAL,2862932780,10247,2862943027,2871247190
2025-06-19 00:22:42,REAL,2862943027,10324,2862953351,2871257514
2025-06-19 00:22:44,FAKE,2862953351,241,2862953592,2871261895
2025-06-19 00:22:46,REAL,2862953592,547,2862954139,2871262442
2025-06-19 00:22:48,FAKE,2862954139,238,2862954377,2871262927
2025-06-19 00:22:50,FAKE,2862954377,241,2862954618,2871263417
2025-06-19 00:22:52,REAL,2862954618,487,2862955105,2871263904
2025-06-19 00:22:54,FAKE,2862955105,238,2862955343,2871264387
2025-06-19 00:22:56,REAL,2862955343,485,2862955828,2871264872
2025-06-19 00:22:58,REAL,2862955828,536,2862956364,2871265408
2025-06-19 00:23:00,REAL,2862956364,2275,2862958639,2871267683
2025-06-19 00:23:02,REAL,2862958639,11830,2862970469,2871279513
2025-06-19 00:23:04,REAL,2862970469,10251,2862980720,2871289764
2025-06-19 00:23:06,REAL,2862980720,10259,2862990979,2871300023
2025-06-19 00:23:08,REAL,2862990979,10323,2863001302,2871310346
2025-06-19 00:23:10,REAL,2863001302,10249,2863011551,2871320595
2025-06-19 00:23:12,REAL,2863011551,10307,2863021858,2871330902
2025-06-19 00:23:14,REAL,2863021858,10246,2863032104,2871341148
2025-06-19 00:23:16,REAL,2863032104,3721,2863035825,2871344869
2025-06-19 00:23:18,REAL,2863035825,484,2863036309,2871345353
2025-06-19 00:23:20,FAKE,2863036309,241,2863036550,2871345834
2025-06-19 00:23:22,REAL,2863036550,488,2863037038,2871346322
2025-06-19 00:23:24,REAL,2863037038,479,2863037517,2871346801
2025-06-19 00:23:26,REAL,2863037517,479,2863037996,2871347280
2025-06-19 00:23:28,REAL,2863037996,544,2863038540,2871347824
2025-06-19 00:23:30,REAL,2863038540,492,2863039032,2871348316
2025-06-19 00:23:32,FAKE,2863039032,244,2863039276,2871351383
2025-06-19 00:23:34,REAL,2863039276,14332,2863053608,2871365715
2025-06-19 00:23:36,REAL,2863053608,10312,2863063920,2871376027
2025-06-19 00:23:38,FAKE,2863063920,243,2863064163,2871386274
2025-06-19 00:23:40,REAL,2863064163,10256,2863074419,2871396530
2025-06-19 00:23:42,FAKE,2863074419,244,2863074663,2871406853
2025-06-19 00:23:44,FAKE,2863074663,243,2863074906,2871417103
2025-06-19 00:23:46,REAL,2863074906,10256,2863085162,2871427359
2025-06-19 00:23:48,REAL,2863085162,3120,2863088282,2871430479
2025-06-19 00:23:50,FAKE,2863088282,243,2863088525,2871430966
2025-06-19 00:23:52,REAL,2863088525,485,2863089010,2871431451
2025-06-19 00:23:54,REAL,2863089010,490,2863089500,2871431941
2025-06-19 00:23:56,REAL,2863089500,485,2863089985,2871432426
2025-06-19 00:23:58,REAL,2863089985,482,2863090467,2871432908
2025-06-19 00:24:00,REAL,2863090467,541,2863091008,2871433449
2025-06-19 00:24:02,REAL,2863091008,539,2863091547,2871433988
2025-06-19 00:24:04,REAL,2863091547,478,2863092025,2871434466
2025-06-19 00:24:06,REAL,2863092025,487,2863092512,2871434953
2025-06-19 00:24:08,REAL,2863092512,485,2863092997,2871435438
2025-06-19 00:24:10,FAKE,2863092997,238,2863093235,2871435926
2025-06-19 00:24:12,REAL,2863093235,476,2863093711,2871436402
2025-06-19 00:24:14,REAL,2863093711,485,2863094196,2871436887
2025-06-19 00:24:16,REAL,2863094196,492,2863094688,2871437379
2025-06-19 00:24:18,FAKE,2863094688,238,2863094926,2871437862
2025-06-19 00:24:20,REAL,2863094926,488,2863095414,2871438350
2025-06-19 00:24:22,REAL,2863095414,481,2863095895,2871438831
2025-06-19 00:24:24,REAL,2863095895,541,2863096436,2871439372
2025-06-19 00:24:26,REAL,2863096436,10325,2863106761,2871449697
2025-06-19 00:24:28,REAL,2863106761,10389,2863117150,2871460086
2025-06-19 00:24:30,REAL,2863117150,10250,2863127400,2871470336
2025-06-19 00:24:32,FAKE,2863127400,238,2863127638,2871480656
2025-06-19 00:24:34,FAKE,2863127638,241,2863127879,2871490904
2025-06-19 00:24:36,REAL,2863127879,10257,2863138136,2871501161
2025-06-19 00:24:38,REAL,2863138136,10253,2863148389,2871511414
2025-06-19 00:24:40,REAL,2863148389,7217,2863155606,2871518631
2025-06-19 00:24:42,FAKE,2863155606,238,2863155844,2871519112
2025-06-19 00:24:44,REAL,2863155844,484,2863156328,2871519596
2025-06-19 00:24:46,REAL,2863156328,482,2863156810,2871520078
2025-06-19 00:24:48,REAL,2863156810,489,2863157299,2871520567
2025-06-19 00:24:50,REAL,2863157299,237,2863157536,2871520804
2025-06-19 00:24:52,FAKE,2863157536,243,2863157779,2871521285
2025-06-19 00:24:54,REAL,2863157779,483,2863158262,2871521768
2025-06-19 00:24:56,FAKE,2863158262,244,2863158506,2871522371
2025-06-19 00:24:58,FAKE,2863158506,243,2863158749,2871522861
2025-06-19 00:25:00,REAL,2863158749,490,2863159239,2871523351
2025-06-19 00:25:02,REAL,2863159239,485,2863159724,2871523836
2025-06-19 00:25:04,FAKE,2863159724,243,2863159967,2871524322
2025-06-19 00:25:06,REAL,2863159967,481,2863160448,2871524803
2025-06-19 00:25:08,REAL,2863160448,488,2863160936,2871525291
2025-06-19 00:25:10,REAL,2863160936,478,2863161414,2871525769
2025-06-19 00:25:12,REAL,2863161414,485,2863161899,2871526254
2025-06-19 00:25:14,REAL,2863161899,483,2863162382,2871526737
2025-06-19 00:25:16,FAKE,2863162382,238,2863162620,2871527221
2025-06-19 00:25:18,REAL,2863162620,483,2863163103,2871527704
2025-06-19 00:25:20,FAKE,2863163103,243,2863163346,2871528193
2025-06-19 00:25:22,REAL,2863163346,485,2863163831,2871528678
2025-06-19 00:25:24,REAL,2863163831,488,2863164319,2871529166
2025-06-19 00:25:26,REAL,2863164319,477,2863164796,2871529643
2025-06-19 00:25:28,FAKE,2863164796,241,2863165037,2871530247
2025-06-19 00:25:30,REAL,2863165037,483,2863165520,2871530730
2025-06-19 00:25:32,FAKE,2863165520,244,2863165764,2871531220
2025-06-19 00:25:34,REAL,2863165764,482,2863166246,2871531702
2025-06-19 00:25:36,REAL,2863166246,490,2863166736,2871532192
2025-06-19 00:25:38,REAL,2863166736,480,2863167216,2871532672
2025-06-19 00:25:40,REAL,2863167216,480,2863167696,2871533152
2025-06-19 00:25:42,FAKE,2863167696,244,2863167940,2871533638
2025-06-19 00:25:44,REAL,2863167940,486,2863168426,2871534124
2025-06-19 00:25:46,REAL,2863168426,14348,2863182774,2871548472
2025-06-19 00:25:48,REAL,2863182774,10321,2863193095,2871558793
2025-06-19 00:25:50,REAL,2863193095,10253,2863203348,2871569046
2025-06-19 00:25:52,FAKE,2863203348,238,2863203586,2871579297
2025-06-19 00:25:54,REAL,2863203586,10251,2863213837,2871589548
2025-06-19 00:25:56,REAL,2863213837,10313,2863224150,2871599861
2025-06-19 00:25:58,FAKE,2863224150,243,2863224393,2871610108
2025-06-19 00:26:00,REAL,2863224393,5686,2863230079,2871615794
2025-06-19 00:26:02,FAKE,2863230079,241,2863230320,2871616276
2025-06-19 00:26:04,REAL,2863230320,481,2863230801,2871616757
2025-06-19 00:26:06,REAL,2863230801,487,2863231288,2871617244
2025-06-19 00:26:08,REAL,2863231288,493,2863231781,2871617737
2025-06-19 00:26:10,REAL,2863231781,488,2863232269,2871618225
2025-06-19 00:26:12,REAL,2863232269,490,2863232759,2871618715
2025-06-19 00:26:14,FAKE,2863232759,241,2863233000,2871619199
2025-06-19 00:26:16,REAL,2863233000,534,2863233534,2871619733
2025-06-19 00:26:18,FAKE,2863233534,238,2863233772,2871620216
2025-06-19 00:26:20,REAL,2863233772,486,2863234258,2871620702
2025-06-19 00:26:22,REAL,2863234258,478,2863234736,2871621180
2025-06-19 00:26:24,REAL,2863234736,486,2863235222,2871621666
2025-06-19 00:26:26,REAL,2863235222,484,2863235706,2871622150
2025-06-19 00:26:28,REAL,2863235706,488,2863236194,2871622638
2025-06-19 00:26:30,REAL,2863236194,475,2863236669,2871623113
2025-06-19 00:26:32,REAL,2863236669,480,2863237149,2871623593
2025-06-19 00:26:34,FAKE,2863237149,241,2863237390,2871624133
2025-06-19 00:26:36,REAL,2863237390,491,2863237881,2871624624
2025-06-19 00:26:38,FAKE,2863237881,243,2863238124,2871625106
2025-06-19 00:26:40,REAL,2863238124,484,2863238608,2871625590
2025-06-19 00:26:42,REAL,2863238608,476,2863239084,2871626066
2025-06-19 00:26:44,REAL,2863239084,487,2863239571,2871626553
2025-06-19 00:26:46,FAKE,2863239571,238,2863239809,2871627032
2025-06-19 00:26:48,REAL,2863239809,544,2863240353,2871627576
2025-06-19 00:26:50,FAKE,2863240353,238,2863240591,2871628056
2025-06-19 00:26:52,REAL,2863240591,484,2863241075,2871628540
2025-06-19 00:26:54,REAL,2863241075,480,2863241555,2871629020
2025-06-19 00:26:56,REAL,2863241555,483,2863242038,2871629503
2025-06-19 00:26:58,REAL,2863242038,483,2863242521,2871629986
2025-06-19 00:27:00,FAKE,2863242521,244,2863242765,2871630470
2025-06-19 00:27:02,FAKE,2863242765,244,2863243009,2871630960
2025-06-19 00:27:04,REAL,2863243009,1938,2863244947,2871632898
2025-06-19 00:27:06,FAKE,2863244947,243,2863245190,2871644458
2025-06-19 00:27:08,REAL,2863245190,10253,2863255443,2871654711
2025-06-19 00:27:10,FAKE,2863255443,244,2863255687,2871664962
2025-06-19 00:27:12,REAL,2863255687,10255,2863265942,2871675217
2025-06-19 00:27:14,REAL,2863265942,10253,2863276195,2871685470
2025-06-19 00:27:16,REAL,2863276195,10255,2863286450,2871695725
2025-06-19 00:27:18,REAL,2863286450,10256,2863296706,2871705981
2025-06-19 00:27:20,REAL,2863296706,4040,2863300746,2871710021
2025-06-19 00:27:22,REAL,2863300746,486,2863301232,2871710507
2025-06-19 00:27:24,FAKE,2863301232,243,2863301475,2871710999
2025-06-19 00:27:26,FAKE,2863301475,244,2863301719,2871711485
2025-06-19 00:27:28,REAL,2863301719,484,2863302203,2871711969
2025-06-19 00:27:30,REAL,2863302203,486,2863302689,2871712455
2025-06-19 00:27:32,REAL,2863302689,478,2863303167,2871712933
2025-06-19 00:27:34,FAKE,2863303167,243,2863303410,2871713415
2025-06-19 00:27:36,REAL,2863303410,2919,2863306329,2871716334
2025-06-19 00:27:38,REAL,2863306329,11190,2863317519,2871727524
2025-06-19 00:27:40,FAKE,2863317519,244,2863317763,2871737893
2025-06-19 00:27:42,FAKE,2863317763,244,2863318007,2871748144
2025-06-19 00:27:44,REAL,2863318007,10252,2863328259,2871758396
2025-06-19 00:27:46,REAL,2863328259,10253,2863338512,2871768649
2025-06-19 00:27:48,REAL,2863338512,10452,2863348964,2871779101
2025-06-19 00:27:50,REAL,2863348964,10123,2863359087,2871789224
2025-06-19 00:27:52,REAL,2863359087,3396,2863362483,2871792620
2025-06-19 00:27:54,REAL,2863362483,489,2863362972,2871793109
2025-06-19 00:27:56,REAL,2863362972,484,2863363456,2871793593
2025-06-19 00:27:58,REAL,2863363456,489,2863363945,2871794082
2025-06-19 00:28:00,REAL,2863363945,476,2863364421,2871794558
2025-06-19 00:28:02,FAKE,2863364421,241,2863364662,2871795040
2025-06-19 00:28:04,REAL,2863364662,479,2863365141,2871795519
2025-06-19 00:28:06,REAL,2863365141,487,2863365628,2871796006
2025-06-19 00:28:08,FAKE,2863365628,241,2863365869,2871799798
2025-06-19 00:28:10,FAKE,2863365869,238,2863366107,2871811645
2025-06-19 00:28:12,REAL,2863366107,10377,2863376484,2871822022
2025-06-19 00:28:14,REAL,2863376484,10251,2863386735,2871832273
2025-06-19 00:28:16,FAKE,2863386735,238,2863386973,2871842529
2025-06-19 00:28:18,REAL,2863386973,10311,2863397284,2871852840
2025-06-19 00:28:20,FAKE,2863397284,238,2863397522,2871863091
2025-06-19 00:28:22,REAL,2863397522,10251,2863407773,2871873342
2025-06-19 00:28:24,REAL,2863407773,2796,2863410569,2871876138
2025-06-19 00:28:26,FAKE,2863410569,243,2863410812,2871876626
2025-06-19 00:28:28,REAL,2863410812,488,2863411300,2871877114
2025-06-19 00:28:30,FAKE,2863411300,238,2863411538,2871888948
2025-06-19 00:28:32,REAL,2863411538,11500,2863423038,2871900448
2025-06-19 00:28:34,REAL,2863423038,10260,2863433298,2871910708
2025-06-19 00:28:36,REAL,2863433298,10248,2863443546,2871920956
2025-06-19 00:28:38,REAL,2863443546,10246,2863453792,2871931202
2025-06-19 00:28:40,REAL,2863453792,10319,2863464111,2871941521
2025-06-19 00:28:42,REAL,2863464111,10187,2863474298,2871951708
2025-06-19 00:28:44,REAL,2863474298,7407,2863481705,2871959115
2025-06-19 00:28:46,REAL,2863481705,481,2863482186,2871959596
2025-06-19 00:28:48,REAL,2863482186,479,2863482665,2871960075
2025-06-19 00:28:50,REAL,2863482665,485,2863483150,2871960560
2025-06-19 00:28:52,FAKE,2863483150,241,2863483391,2871961041
2025-06-19 00:28:54,REAL,2863483391,482,2863483873,2871961523
2025-06-19 00:28:56,REAL,2863483873,484,2863484357,2871962007
2025-06-19 00:28:58,REAL,2863484357,484,2863484841,2871962491
2025-06-19 00:29:00,REAL,2863484841,542,2863485383,2871963033
2025-06-19 00:29:02,REAL,2863485383,487,2863485870,2871963520
2025-06-19 00:29:04,REAL,2863485870,487,2863486357,2871964007
2025-06-19 00:29:06,REAL,2863486357,488,2863486845,2871964495
2025-06-19 00:29:08,FAKE,2863486845,244,2863487089,2871964978
2025-06-19 00:29:10,REAL,2863487089,481,2863487570,2871965459
2025-06-19 00:29:12,REAL,2863487570,484,2863488054,2871965943
2025-06-19 00:29:14,REAL,2863488054,484,2863488538,2871966427
2025-06-19 00:29:16,FAKE,2863488538,241,2863488779,2871966906
2025-06-19 00:29:18,FAKE,2863488779,241,2863489020,2871967455
2025-06-19 00:29:20,FAKE,2863489020,244,2863489264,2871967941
2025-06-19 00:29:22,REAL,2863489264,482,2863489746,2871968423
2025-06-19 00:29:24,REAL,2863489746,488,2863490234,2871968911
2025-06-19 00:29:26,REAL,2863490234,483,2863490717,2871969394
2025-06-19 00:29:28,REAL,2863490717,488,2863491205,2871969882
2025-06-19 00:29:30,FAKE,2863491205,241,2863491446,2871970363
2025-06-19 00:29:32,REAL,2863491446,482,2863491928,2871970845
2025-06-19 00:29:34,REAL,2863491928,10784,2863502712,2871981629
2025-06-19 00:29:36,REAL,2863502712,10252,2863512964,2871991881
2025-06-19 00:29:38,REAL,2863512964,10255,2863523219,2872002136
2025-06-19 00:29:40,REAL,2863523219,10255,2863533474,2872012391
2025-06-19 00:29:42,FAKE,2863533474,243,2863533717,2872022647
2025-06-19 00:29:44,REAL,2863533717,10257,2863543974,2872032904
2025-06-19 00:29:46,REAL,2863543974,10313,2863554287,2872043217
2025-06-19 00:29:48,FAKE,2863554287,238,2863554525,2872049244
2025-06-19 00:29:50,REAL,2863554525,491,2863555016,2872049735
2025-06-19 00:29:52,REAL,2863555016,489,2863555505,2872050224
2025-06-19 00:29:54,REAL,2863555505,485,2863555990,2872050709
2025-06-19 00:29:56,FAKE,2863555990,238,2863556228,2872051249
2025-06-19 00:29:58,FAKE,2863556228,238,2863556466,2872051735
2025-06-19 00:30:00,REAL,2863556466,488,2863556954,2872052223
2025-06-19 00:30:02,FAKE,2863556954,241,2863557195,2872052699
2025-06-19 00:30:04,REAL,2863557195,479,2863557674,2872053178
2025-06-19 00:30:06,REAL,2863557674,547,2863558221,2872053725
2025-06-19 00:30:08,FAKE,2863558221,244,2863558465,2872054209
2025-06-19 00:30:10,REAL,2863558465,483,2863558948,2872054692
2025-06-19 00:30:12,FAKE,2863558948,244,2863559192,2872055172
2025-06-19 00:30:14,REAL,2863559192,482,2863559674,2872055654
2025-06-19 00:30:16,REAL,2863559674,485,2863560159,2872056139
2025-06-19 00:30:18,REAL,2863560159,484,2863560643,2872056623
2025-06-19 00:30:20,REAL,2863560643,490,2863561133,2872057113
2025-06-19 00:30:22,REAL,2863561133,477,2863561610,2872057590
2025-06-19 00:30:24,REAL,2863561610,484,2863562094,2872058074
2025-06-19 00:30:26,REAL,2863562094,8089,2863570183,2872066163
2025-06-19 00:30:28,REAL,2863570183,13421,2863583604,2872079584
2025-06-19 00:30:30,REAL,2863583604,10252,2863593856,2872089836
2025-06-19 00:30:32,REAL,2863593856,10249,2863604105,2872100085
2025-06-19 00:30:34,REAL,2863604105,10255,2863614360,2872110340
2025-06-19 00:30:36,FAKE,2863614360,241,2863614601,2872120600
2025-06-19 00:30:38,FAKE,2863614601,244,2863614845,2872130915
2025-06-19 00:30:40,REAL,2863614845,9984,2863624829,2872140899
2025-06-19 00:30:42,FAKE,2863624829,241,2863625070,2872141385
2025-06-19 00:30:44,REAL,2863625070,487,2863625557,2872141872
2025-06-19 00:30:46,FAKE,2863625557,244,2863625801,2872142366
2025-06-19 00:30:48,REAL,2863625801,491,2863626292,2872142857
2025-06-19 00:30:50,REAL,2863626292,476,2863626768,2872143333
2025-06-19 00:30:52,REAL,2863626768,486,2863627254,2872143819
2025-06-19 00:30:54,REAL,2863627254,484,2863627738,2872144303
2025-06-19 00:30:56,REAL,2863627738,484,2863628222,2872144787
2025-06-19 00:30:58,FAKE,2863628222,243,2863628465,2872151816
2025-06-19 00:31:00,REAL,2863628465,11176,2863639641,2872162992
2025-06-19 00:31:02,REAL,2863639641,10250,2863649891,2872173242
2025-06-19 00:31:04,FAKE,2863649891,241,2863650132,2872183491
2025-06-19 00:31:06,REAL,2863650132,10262,2863660394,2872193753
2025-06-19 00:31:08,FAKE,2863660394,241,2863660635,2872204006
2025-06-19 00:31:10,REAL,2863660635,10254,2863670889,2872214260
2025-06-19 00:31:12,REAL,2863670889,9336,2863680225,2872223596
2025-06-19 00:31:14,FAKE,2863680225,241,2863680466,2872224087
2025-06-19 00:31:16,REAL,2863680466,475,2863680941,2872224562
2025-06-19 00:31:18,REAL,2863680941,540,2863681481,2872225102
2025-06-19 00:31:20,FAKE,2863681481,243,2863681724,2872225582
2025-06-19 00:31:22,FAKE,2863681724,243,2863681967,2872226065
2025-06-19 00:31:24,REAL,2863681967,479,2863682446,2872226544
2025-06-19 00:31:26,REAL,2863682446,481,2863682927,2872227025
2025-06-19 00:31:28,FAKE,2863682927,243,2863683170,2872227510
2025-06-19 00:31:30,REAL,2863683170,7946,2863691116,2872235456
2025-06-19 00:31:32,REAL,2863691116,10841,2863701957,2872246297
2025-06-19 00:31:34,FAKE,2863701957,238,2863702195,2872256613
2025-06-19 00:31:36,REAL,2863702195,10253,2863712448,2872266866
2025-06-19 00:31:38,REAL,2863712448,10244,2863722692,2872277110
2025-06-19 00:31:40,REAL,2863722692,10319,2863733011,2872287429
2025-06-19 00:31:42,REAL,2863733011,10248,2863743259,2872297677
2025-06-19 00:31:44,FAKE,2863743259,243,2863743502,2872306414
2025-06-19 00:31:46,REAL,2863743502,478,2863743980,2872306892
2025-06-19 00:31:48,FAKE,2863743980,243,2863744223,2872307381
2025-06-19 00:31:50,REAL,2863744223,488,2863744711,2872307869
2025-06-19 00:31:52,REAL,2863744711,476,2863745187,2872308345
2025-06-19 00:31:54,FAKE,2863745187,241,2863745428,2872308826
2025-06-19 00:31:56,REAL,2863745428,481,2863745909,2872309307
2025-06-19 00:31:58,FAKE,2863745909,243,2863746152,2872309843
2025-06-19 00:32:00,REAL,2863746152,539,2863746691,2872310382
2025-06-19 00:32:02,REAL,2863746691,8672,2863755363,2872319054
2025-06-19 00:32:04,REAL,2863755363,10581,2863765944,2872329635
2025-06-19 00:32:06,FAKE,2863765944,241,2863766185,2872339885
2025-06-19 00:32:08,FAKE,2863766185,241,2863766426,2872350193
2025-06-19 00:32:10,FAKE,2863766426,238,2863766664,2872360381
2025-06-19 00:32:12,REAL,2863766664,10258,2863776922,2872370639
2025-06-19 00:32:14,REAL,2863776922,10320,2863787242,2872380959
2025-06-19 00:32:16,REAL,2863787242,8074,2863795316,2872389033
2025-06-19 00:32:18,REAL,2863795316,486,2863795802,2872389519
2025-06-19 00:32:20,REAL,2863795802,477,2863796279,2872389996
2025-06-19 00:32:22,FAKE,2863796279,244,2863796523,2872390479
2025-06-19 00:32:24,REAL,2863796523,480,2863797003,2872390959
2025-06-19 00:32:26,REAL,2863797003,485,2863797488,2872391444
2025-06-19 00:32:28,FAKE,2863797488,241,2863797729,2872391934
2025-06-19 00:32:30,REAL,2863797729,491,2863798220,2872392425
2025-06-19 00:32:32,REAL,2863798220,484,2863798704,2872392909
2025-06-19 00:32:34,REAL,2863798704,543,2863799247,2872393452
2025-06-19 00:32:36,REAL,2863799247,486,2863799733,2872393938
2025-06-19 00:32:38,REAL,2863799733,534,2863800267,2872394472
2025-06-19 00:32:40,FAKE,2863800267,241,2863800508,2872394963
2025-06-19 00:32:42,REAL,2863800508,489,2863800997,2872395452
2025-06-19 00:32:44,REAL,2863800997,485,2863801482,2872395937
2025-06-19 00:32:46,REAL,2863801482,483,2863801965,2872396420
2025-06-19 00:32:48,REAL,2863801965,492,2863802457,2872396912
2025-06-19 00:32:50,REAL,2863802457,474,2863802931,2872397386
2025-06-19 00:32:52,FAKE,2863802931,241,2863803172,2872397872
2025-06-19 00:32:54,REAL,2863803172,481,2863803653,2872398353
2025-06-19 00:32:56,FAKE,2863803653,238,2863803891,2872398837
2025-06-19 00:32:58,FAKE,2863803891,243,2863804134,2872399322
2025-06-19 00:33:00,REAL,2863804134,481,2863804615,2872399803
2025-06-19 00:33:02,FAKE,2863804615,243,2863804858,2872400290
2025-06-19 00:33:04,FAKE,2863804858,241,2863805099,2872400766
2025-06-19 00:33:06,REAL,2863805099,9995,2863815094,2872410761
2025-06-19 00:33:08,FAKE,2863815094,238,2863815332,2872421213
2025-06-19 00:33:10,REAL,2863815332,10321,2863825653,2872431534
2025-06-19 00:33:12,FAKE,2863825653,244,2863825897,2872441785
2025-06-19 00:33:14,FAKE,2863825897,243,2863826140,2872452038
2025-06-19 00:33:16,REAL,2863826140,10306,2863836446,2872462344
2025-06-19 00:33:18,REAL,2863836446,10250,2863846696,2872472594
2025-06-19 00:33:20,REAL,2863846696,6876,2863853572,2872479470
2025-06-19 00:33:22,REAL,2863853572,490,2863854062,2872479960
2025-06-19 00:33:24,REAL,2863854062,483,2863854545,2872480443
2025-06-19 00:33:26,FAKE,2863854545,238,2863854783,2872480932
2025-06-19 00:33:28,REAL,2863854783,483,2863855266,2872481415
2025-06-19 00:33:30,REAL,2863855266,475,2863855741,2872481890
2025-06-19 00:33:32,REAL,2863855741,481,2863856222,2872482371
2025-06-19 00:33:34,REAL,2863856222,492,2863856714,2872482863
2025-06-19 00:33:36,FAKE,2863856714,238,2863856952,2872483397
2025-06-19 00:33:38,REAL,2863856952,482,2863857434,2872483879
2025-06-19 00:33:40,REAL,2863857434,486,2863857920,2872484365
2025-06-19 00:33:42,REAL,2863857920,485,2863858405,2872484850
2025-06-19 00:33:44,FAKE,2863858405,241,2863858646,2872485339
2025-06-19 00:33:46,REAL,2863858646,482,2863859128,2872485821
2025-06-19 00:33:48,FAKE,2863859128,243,2863859371,2872486308
2025-06-19 00:33:50,FAKE,2863859371,244,2863859615,2872486799
2025-06-19 00:33:52,FAKE,2863859615,238,2863859853,2872487284
2025-06-19 00:33:54,FAKE,2863859853,238,2863860091,2872487770
2025-06-19 00:33:56,FAKE,2863860091,243,2863860334,2872488301
2025-06-19 00:33:58,REAL,2863860334,488,2863860822,2872488789
2025-06-19 00:34:00,REAL,2863860822,491,2863861313,2872489280
2025-06-19 00:34:02,REAL,2863861313,489,2863861802,2872489769
2025-06-19 00:34:04,FAKE,2863861802,244,2863862046,2872490248
2025-06-19 00:34:06,FAKE,2863862046,238,2863862284,2872490731
2025-06-19 00:34:08,REAL,2863862284,482,2863862766,2872491213
2025-06-19 00:34:10,REAL,2863862766,11512,2863874278,2872502725
2025-06-19 00:34:12,REAL,2863874278,10256,2863884534,2872512981
2025-06-19 00:34:14,FAKE,2863884534,243,2863884777,2872523233
2025-06-19 00:34:16,REAL,2863884777,10247,2863895024,2872533480
2025-06-19 00:34:18,REAL,2863895024,10256,2863905280,2872543736
2025-06-19 00:34:20,REAL,2863905280,10250,2863915530,2872553986
2025-06-19 00:34:22,REAL,2863915530,10309,2863925839,2872564295
2025-06-19 00:34:24,REAL,2863925839,5574,2863931413,2872569869
2025-06-19 00:34:26,REAL,2863931413,480,2863931893,2872570349
2025-06-19 00:34:28,REAL,2863931893,485,2863932378,2872570834
2025-06-19 00:34:30,REAL,2863932378,484,2863932862,2872571318
2025-06-19 00:34:32,REAL,2863932862,491,2863933353,2872571809
2025-06-19 00:34:34,REAL,2863933353,493,2863933846,2872572302
2025-06-19 00:34:36,REAL,2863933846,537,2863934383,2872572839
2025-06-19 00:34:38,REAL,2863934383,481,2863934864,2872573320
2025-06-19 00:34:40,REAL,2863934864,623,2863935487,2872573943
2025-06-19 00:34:42,FAKE,2863935487,244,2863935731,2872586178
2025-06-19 00:34:44,FAKE,2863935731,243,2863935974,2872596425
2025-06-19 00:34:46,REAL,2863935974,10248,2863946222,2872606673
2025-06-19 00:34:48,FAKE,2863946222,243,2863946465,2872616990
2025-06-19 00:34:50,FAKE,2863946465,241,2863946706,2872627239
2025-06-19 00:34:52,REAL,2863946706,10254,2863956960,2872637493
2025-06-19 00:34:54,REAL,2863956960,10253,2863967213,2872647746
2025-06-19 00:34:56,FAKE,2863967213,243,2863967456,2872652721
2025-06-19 00:34:58,FAKE,2863967456,241,2863967697,2872653210
2025-06-19 00:35:00,REAL,2863967697,486,2863968183,2872653696
2025-06-19 00:35:02,REAL,2863968183,485,2863968668,2872654181
2025-06-19 00:35:04,REAL,2863968668,487,2863969155,2872654668
2025-06-19 00:35:06,REAL,2863969155,484,2863969639,2872655152
2025-06-19 00:35:08,REAL,2863969639,480,2863970119,2872655632
2025-06-19 00:35:10,REAL,2863970119,481,2863970600,2872656113
2025-06-19 00:35:12,REAL,2863970600,1749,2863972349,2872657862
2025-06-19 00:35:14,REAL,2863972349,11705,2863984054,2872669567
2025-06-19 00:35:16,FAKE,2863984054,238,2863984292,2872679878
2025-06-19 00:35:18,REAL,2863984292,10308,2863994600,2872690186
2025-06-19 00:35:20,FAKE,2863994600,241,2863994841,2872700438
2025-06-19 00:35:22,FAKE,2863994841,243,2863995084,2872710696
2025-06-19 00:35:24,REAL,2863995084,10252,2864005336,2872720948
2025-06-19 00:35:26,REAL,2864005336,10316,2864015652,2872731264
2025-06-19 00:35:28,FAKE,2864015652,243,2864015895,2872735579
2025-06-19 00:35:30,REAL,2864015895,484,2864016379,2872736063
2025-06-19 00:35:32,FAKE,2864016379,238,2864016617,2872736553
2025-06-19 00:35:34,REAL,2864016617,490,2864017107,2872737043
2025-06-19 00:35:36,REAL,2864017107,488,2864017595,2872737531
2025-06-19 00:35:38,FAKE,2864017595,244,2864017839,2872738009
2025-06-19 00:35:40,FAKE,2864017839,238,2864018077,2872738489
2025-06-19 00:35:42,REAL,2864018077,476,2864018553,2872738965
2025-06-19 00:35:44,FAKE,2864018553,244,2864018797,2872741176
2025-06-19 00:35:46,REAL,2864018797,14734,2864033531,2872755910
2025-06-19 00:35:48,REAL,2864033531,10253,2864043784,2872766163
2025-06-19 00:35:50,REAL,2864043784,10248,2864054032,2872776411
2025-06-19 00:35:52,REAL,2864054032,10317,2864064349,2872786728
2025-06-19 00:35:54,FAKE,2864064349,241,2864064590,2872796985
2025-06-19 00:35:56,REAL,2864064590,10252,2864074842,2872807237
2025-06-19 00:35:58,FAKE,2864074842,238,2864075080,2872817489
2025-06-19 00:36:00,REAL,2864075080,3774,2864078854,2872821263
2025-06-19 00:36:02,REAL,2864078854,486,2864079340,2872821749
2025-06-19 00:36:04,REAL,2864079340,486,2864079826,2872822235
2025-06-19 00:36:06,REAL,2864079826,479,2864080305,2872822714
2025-06-19 00:36:08,REAL,2864080305,484,2864080789,2872823198
2025-06-19 00:36:10,REAL,2864080789,483,2864081272,2872823681
2025-06-19 00:36:12,FAKE,2864081272,238,2864081510,2872824162
2025-06-19 00:36:14,FAKE,2864081510,244,2864081754,2872824646
2025-06-19 00:36:16,FAKE,2864081754,238,2864081992,2872827788
2025-06-19 00:36:18,REAL,2864081992,14409,2864096401,2872842197
2025-06-19 00:36:20,REAL,2864096401,10247,2864106648,2872852444
2025-06-19 00:36:22,FAKE,2864106648,238,2864106886,2872862766
2025-06-19 00:36:24,FAKE,2864106886,243,2864107129,2872873081
2025-06-19 00:36:26,REAL,2864107129,10250,2864117379,2872883331
2025-06-19 00:36:28,REAL,2864117379,10323,2864127702,2872893654
2025-06-19 00:36:30,REAL,2864127702,10261,2864137963,2872903915
2025-06-19 00:36:32,REAL,2864137963,3130,2864141093,2872907045
2025-06-19 00:36:34,FAKE,2864141093,244,2864141337,2872907525
2025-06-19 00:36:36,FAKE,2864141337,243,2864141580,2872908013
2025-06-19 00:36:38,REAL,2864141580,477,2864142057,2872908490
2025-06-19 00:36:40,REAL,2864142057,483,2864142540,2872908973
2025-06-19 00:36:42,REAL,2864142540,488,2864143028,2872909461
2025-06-19 00:36:44,REAL,2864143028,538,2864143566,2872909999
2025-06-19 00:36:46,FAKE,2864143566,244,2864143810,2872910488
2025-06-19 00:36:48,REAL,2864143810,485,2864144295,2872910973
2025-06-19 00:36:50,REAL,2864144295,479,2864144774,2872911452
2025-06-19 00:36:52,FAKE,2864144774,241,2864145015,2872911944
2025-06-19 00:36:54,REAL,2864145015,490,2864145505,2872912434
2025-06-19 00:36:56,REAL,2864145505,475,2864145980,2872912909
2025-06-19 00:36:58,REAL,2864145980,484,2864146464,2872913393
2025-06-19 00:37:00,REAL,2864146464,482,2864146946,2872913875
2025-06-19 00:37:02,REAL,2864146946,485,2864147431,2872914360
2025-06-19 00:37:04,FAKE,2864147431,244,2864147675,2872914849
2025-06-19 00:37:06,FAKE,2864147675,244,2864147919,2872915382
2025-06-19 00:37:08,REAL,2864147919,482,2864148401,2872915864
2025-06-19 00:37:10,REAL,2864148401,493,2864148894,2872916357
2025-06-19 00:37:12,REAL,2864148894,484,2864149378,2872916841
2025-06-19 00:37:14,REAL,2864149378,475,2864149853,2872917316
2025-06-19 00:37:16,REAL,2864149853,486,2864150339,2872917802
2025-06-19 00:37:18,FAKE,2864150339,238,2864150577,2872918282
2025-06-19 00:37:20,REAL,2864150577,475,2864151052,2872918757
2025-06-19 00:37:22,FAKE,2864151052,241,2864151293,2872919233
2025-06-19 00:37:24,FAKE,2864151293,244,2864151537,2872919717
2025-06-19 00:37:26,FAKE,2864151537,244,2864151781,2872920252
2025-06-19 00:37:28,REAL,2864151781,482,2864152263,2872920734
2025-06-19 00:37:30,REAL,2864152263,481,2864152744,2872921215
2025-06-19 00:37:32,REAL,2864152744,482,2864153226,2872921697
2025-06-19 00:37:34,REAL,2864153226,487,2864153713,2872922184
2025-06-19 00:37:36,FAKE,2864153713,243,2864153956,2872922671
2025-06-19 00:37:38,REAL,2864153956,485,2864154441,2872923156
2025-06-19 00:37:40,REAL,2864154441,485,2864154926,2872923641
2025-06-19 00:37:42,FAKE,2864154926,243,2864155169,2872924129
2025-06-19 00:37:44,FAKE,2864155169,244,2864155413,2872924614
2025-06-19 00:37:46,FAKE,2864155413,241,2864155654,2872925090
2025-06-19 00:37:48,REAL,2864155654,486,2864156140,2872925576
2025-06-19 00:37:50,REAL,2864156140,491,2864156631,2872926067
2025-06-19 00:37:52,FAKE,2864156631,241,2864156872,2872926544
2025-06-19 00:37:54,REAL,2864156872,532,2864157404,2872927076
2025-06-19 00:37:56,REAL,2864157404,479,2864157883,2872927555
2025-06-19 00:37:58,REAL,2864157883,494,2864158377,2872928049
2025-06-19 00:38:00,REAL,2864158377,493,2864158870,2872928542
2025-06-19 00:38:02,REAL,2864158870,479,2864159349,2872929021
2025-06-19 00:38:04,REAL,2864159349,480,2864159829,2872929501
2025-06-19 00:38:06,REAL,2864159829,478,2864160307,2872929979
2025-06-19 00:38:08,FAKE,2864160307,238,2864160545,2872936015
2025-06-19 00:38:10,REAL,2864160545,11237,2864171782,2872947252
2025-06-19 00:38:12,REAL,2864171782,10251,2864182033,2872957503
2025-06-19 00:38:14,REAL,2864182033,10258,2864192291,2872967761
2025-06-19 00:38:16,REAL,2864192291,10243,2864202534,2872978004
2025-06-19 00:38:18,FAKE,2864202534,243,2864202777,2872988253
2025-06-19 00:38:20,FAKE,2864202777,244,2864203021,2872998511
2025-06-19 00:38:22,REAL,2864203021,10249,2864213270,2873008760
2025-06-19 00:38:24,REAL,2864213270,882,2864214152,2873009642
2025-06-19 00:38:26,REAL,2864214152,488,2864214640,2873010130
2025-06-19 00:38:28,REAL,2864214640,491,2864215131,2873010621
2025-06-19 00:38:30,FAKE,2864215131,243,2864215374,2873011110
2025-06-19 00:38:32,REAL,2864215374,494,2864215868,2873011604
2025-06-19 00:38:34,FAKE,2864215868,238,2864216106,2873012094
2025-06-19 00:38:36,REAL,2864216106,494,2864216600,2873012588
2025-06-19 00:38:38,REAL,2864216600,488,2864217088,2873013076
2025-06-19 00:38:40,REAL,2864217088,477,2864217565,2873013553
2025-06-19 00:38:42,REAL,2864217565,479,2864218044,2873014032
2025-06-19 00:38:44,FAKE,2864218044,244,2864218288,2873014510
2025-06-19 00:38:46,FAKE,2864218288,244,2864218532,2873014992
2025-06-19 00:38:48,REAL,2864218532,486,2864219018,2873015478
2025-06-19 00:38:50,REAL,2864219018,488,2864219506,2873015966
2025-06-19 00:38:52,REAL,2864219506,540,2864220046,2873016506
2025-06-19 00:38:54,REAL,2864220046,483,2864220529,2873016989
2025-06-19 00:38:56,REAL,2864220529,548,2864221077,2873017537
2025-06-19 00:38:58,FAKE,2864221077,241,2864221318,2873018019
2025-06-19 00:39:00,REAL,2864221318,489,2864221807,2873018508
2025-06-19 00:39:02,REAL,2864221807,482,2864222289,2873018990
2025-06-19 00:39:04,REAL,2864222289,493,2864222782,2873019483
2025-06-19 00:39:06,REAL,2864222782,474,2864223256,2873019957
2025-06-19 00:39:08,FAKE,2864223256,241,2864223497,2873020438
2025-06-19 00:39:10,REAL,2864223497,481,2864223978,2873020919
2025-06-19 00:39:12,FAKE,2864223978,243,2864224221,2873021398
2025-06-19 00:39:14,REAL,2864224221,483,2864224704,2873021881
2025-06-19 00:39:16,FAKE,2864224704,244,2864224948,2873023037
2025-06-19 00:39:18,REAL,2864224948,12310,2864237258,2873035347
2025-06-19 00:39:20,REAL,2864237258,10251,2864247509,2873045598
2025-06-19 00:39:22,REAL,2864247509,10247,2864257756,2873055845
2025-06-19 00:39:24,REAL,2864257756,10258,2864268014,2873066103
2025-06-19 00:39:26,REAL,2864268014,10249,2864278263,2873076352
2025-06-19 00:39:28,REAL,2864278263,10310,2864288573,2873086662
2025-06-19 00:39:30,REAL,2864288573,10247,2864298820,2873096909
2025-06-19 00:39:32,REAL,2864298820,4635,2864303455,2873101544
2025-06-19 00:39:34,REAL,2864303455,485,2864303940,2873102029
2025-06-19 00:39:36,REAL,2864303940,537,2864304477,2873102566
2025-06-19 00:39:38,REAL,2864304477,543,2864305020,2873103109
2025-06-19 00:39:40,REAL,2864305020,476,2864305496,2873103585
2025-06-19 00:39:42,REAL,2864305496,477,2864305973,2873104062
2025-06-19 00:39:44,REAL,2864305973,486,2864306459,2873104548
2025-06-19 00:39:46,FAKE,2864306459,238,2864306697,2873105030
2025-06-19 00:39:48,FAKE,2864306697,241,2864306938,2873106979
2025-06-19 00:39:50,REAL,2864306938,14216,2864321154,2873121195
2025-06-19 00:39:52,FAKE,2864321154,241,2864321395,2873131442
2025-06-19 00:39:54,REAL,2864321395,10321,2864331716,2873141763
2025-06-19 00:39:56,REAL,2864331716,10313,2864342029,2873152076
2025-06-19 00:39:58,REAL,2864342029,10256,2864352285,2873162332
2025-06-19 00:40:00,REAL,2864352285,10319,2864362604,2873172651
2025-06-19 00:40:02,REAL,2864362604,10253,2864372857,2873182904
2025-06-19 00:40:04,FAKE,2864372857,241,2864373098,2873186946
2025-06-19 00:40:06,REAL,2864373098,485,2864373583,2873187431
2025-06-19 00:40:08,REAL,2864373583,486,2864374069,2873187917
2025-06-19 00:40:10,REAL,2864374069,540,2864374609,2873188457
2025-06-19 00:40:12,FAKE,2864374609,244,2864374853,2873188934
2025-06-19 00:40:14,REAL,2864374853,489,2864375342,2873189423
2025-06-19 00:40:16,REAL,2864375342,479,2864375821,2873189902
2025-06-19 00:40:18,REAL,2864375821,536,2864376357,2873190438
2025-06-19 00:40:20,REAL,2864376357,2602,2864378959,2873193040
2025-06-19 00:40:22,REAL,2864378959,11772,2864390731,2873204812
2025-06-19 00:40:24,FAKE,2864390731,241,2864390972,2873215063
2025-06-19 00:40:26,FAKE,2864390972,241,2864391213,2873225312
2025-06-19 00:40:28,REAL,2864391213,10315,2864401528,2873235627
2025-06-19 00:40:30,FAKE,2864401528,243,2864401771,2873245813
2025-06-19 00:40:32,REAL,2864401771,10319,2864412090,2873256132
2025-06-19 00:40:34,REAL,2864412090,10244,2864422334,2873266376
2025-06-19 00:40:36,REAL,2864422334,3390,2864425724,2873269766
2025-06-19 00:40:38,FAKE,2864425724,244,2864425968,2873270258
2025-06-19 00:40:40,REAL,2864425968,487,2864426455,2873270745
2025-06-19 00:40:42,REAL,2864426455,486,2864426941,2873271231
2025-06-19 00:40:44,FAKE,2864426941,244,2864427185,2873271770
2025-06-19 00:40:46,REAL,2864427185,486,2864427671,2873272256
2025-06-19 00:40:48,REAL,2864427671,476,2864428147,2873272732
2025-06-19 00:40:50,REAL,2864428147,486,2864428633,2873273218
2025-06-19 00:40:52,FAKE,2864428633,241,2864428874,2873276809
2025-06-19 00:40:54,REAL,2864428874,11638,2864440512,2873288447
2025-06-19 00:40:56,REAL,2864440512,10369,2864450881,2873298816
2025-06-19 00:40:58,REAL,2864450881,10253,2864461134,2873309069
2025-06-19 00:41:00,REAL,2864461134,10260,2864471394,2873319329
2025-06-19 00:41:02,FAKE,2864471394,238,2864471632,2873329642
2025-06-19 00:41:04,FAKE,2864471632,241,2864471873,2873339887
2025-06-19 00:41:06,REAL,2864471873,10254,2864482127,2873350141
2025-06-19 00:41:08,REAL,2864482127,2795,2864484922,2873352936
2025-06-19 00:41:10,FAKE,2864484922,241,2864485163,2873353411
2025-06-19 00:41:12,REAL,2864485163,487,2864485650,2873353898
2025-06-19 00:41:14,REAL,2864485650,487,2864486137,2873354385
2025-06-19 00:41:16,REAL,2864486137,533,2864486670,2873354918
2025-06-19 00:41:18,FAKE,2864486670,241,2864486911,2873355405
2025-06-19 00:41:20,REAL,2864486911,488,2864487399,2873355893
2025-06-19 00:41:22,REAL,2864487399,489,2864487888,2873356382
2025-06-19 00:41:24,REAL,2864487888,483,2864488371,2873356865
2025-06-19 00:41:26,REAL,2864488371,487,2864488858,2873357352
2025-06-19 00:41:28,REAL,2864488858,487,2864489345,2873357839
2025-06-19 00:41:30,FAKE,2864489345,244,2864489589,2873358326
2025-06-19 00:41:32,FAKE,2864489589,238,2864489827,2873358863
2025-06-19 00:41:34,REAL,2864489827,480,2864490307,2873359343
2025-06-19 00:41:36,REAL,2864490307,480,2864490787,2873359823
2025-06-19 00:41:38,REAL,2864490787,540,2864491327,2873360363
2025-06-19 00:41:40,FAKE,2864491327,244,2864491571,2873360851
2025-06-19 00:41:42,FAKE,2864491571,243,2864491814,2873361090
2025-06-19 00:41:44,REAL,2864491814,487,2864492301,2873361577
2025-06-19 00:41:46,REAL,2864492301,490,2864492791,2873362067
2025-06-19 00:41:48,REAL,2864492791,484,2864493275,2873362551
2025-06-19 00:41:50,REAL,2864493275,485,2864493760,2873363036
2025-06-19 00:41:52,REAL,2864493760,483,2864494243,2873363519
2025-06-19 00:41:54,REAL,2864494243,488,2864494731,2873364007
2025-06-19 00:41:56,REAL,2864494731,485,2864495216,2873364492
2025-06-19 00:41:58,REAL,2864495216,492,2864495708,2873364984
2025-06-19 00:42:00,REAL,2864495708,541,2864496249,2873365525
2025-06-19 00:42:02,FAKE,2864496249,238,2864496487,2873366006
2025-06-19 00:42:04,REAL,2864496487,478,2864496965,2873366484
2025-06-19 00:42:06,FAKE,2864496965,244,2864497209,2873366961
2025-06-19 00:42:08,FAKE,2864497209,244,2864497453,2873367436
2025-06-19 00:42:10,FAKE,2864497453,243,2864497696,2873367976
2025-06-19 00:42:12,REAL,2864497696,5302,2864502998,2873373278
2025-06-19 00:42:14,REAL,2864502998,11371,2864514369,2873384649
2025-06-19 00:42:16,REAL,2864514369,10258,2864524627,2873394907
2025-06-19 00:42:18,REAL,2864524627,10253,2864534880,2873405160
2025-06-19 00:42:20,REAL,2864534880,10254,2864545134,2873415414
2025-06-19 00:42:22,REAL,2864545134,10249,2864555383,2873425663
2025-06-19 00:42:24,REAL,2864555383,10245,2864565628,2873435908
2025-06-19 00:42:26,FAKE,2864565628,238,2864565866,2873446160
2025-06-19 00:42:28,FAKE,2864565866,243,2864566109,2873447370
2025-06-19 00:42:30,REAL,2864566109,485,2864566594,2873447855
2025-06-19 00:42:32,REAL,2864566594,484,2864567078,2873448339
2025-06-19 00:42:34,REAL,2864567078,538,2864567616,2873448877
2025-06-19 00:42:36,REAL,2864567616,479,2864568095,2873449356
2025-06-19 00:42:38,FAKE,2864568095,238,2864568333,2873449836
2025-06-19 00:42:40,REAL,2864568333,487,2864568820,2873450323
2025-06-19 00:42:42,REAL,2864568820,487,2864569307,2873450810
2025-06-19 00:42:44,FAKE,2864569307,244,2864569551,2873457301
2025-06-19 00:42:46,REAL,2864569551,11423,2864580974,2873468724
2025-06-19 00:42:48,FAKE,2864580974,241,2864581215,2873478982
2025-06-19 00:42:50,FAKE,2864581215,244,2864581459,2873489235
2025-06-19 00:42:52,REAL,2864581459,10312,2864591771,2873499547
2025-06-19 00:42:54,REAL,2864591771,10244,2864602015,2873509791
2025-06-19 00:42:56,FAKE,2864602015,244,2864602259,2873520046
2025-06-19 00:42:58,FAKE,2864602259,243,2864602502,2873530300
2025-06-19 00:43:00,REAL,2864602502,614,2864603116,2873530914
2025-06-19 00:43:02,REAL,2864603116,491,2864603607,2873531405
2025-06-19 00:43:04,REAL,2864603607,489,2864604096,2873531894
2025-06-19 00:43:06,REAL,2864604096,540,2864604636,2873532434
2025-06-19 00:43:08,REAL,2864604636,491,2864605127,2873532925
2025-06-19 00:43:10,FAKE,2864605127,244,2864605371,2873533415
2025-06-19 00:43:12,FAKE,2864605371,243,2864605614,2873533903
2025-06-19 00:43:14,REAL,2864605614,485,2864606099,2873534388
2025-06-19 00:43:16,REAL,2864606099,6492,2864612591,2873540880
2025-06-19 00:43:18,REAL,2864612591,10848,2864623439,2873551728
2025-06-19 00:43:20,REAL,2864623439,10244,2864633683,2873561972
2025-06-19 00:43:22,REAL,2864633683,10250,2864643933,2873572222
2025-06-19 00:43:24,REAL,2864643933,10309,2864654242,2873582531
2025-06-19 00:43:26,FAKE,2864654242,241,2864654483,2873592788
2025-06-19 00:43:28,REAL,2864654483,10244,2864664727,2873603032
2025-06-19 00:43:30,REAL,2864664727,9721,2864674448,2873612753
2025-06-19 00:43:32,REAL,2864674448,484,2864674932,2873613237
2025-06-19 00:43:34,REAL,2864674932,479,2864675411,2873613716
2025-06-19 00:43:36,FAKE,2864675411,241,2864675652,2873614202
2025-06-19 00:43:38,REAL,2864675652,535,2864676187,2873614737
2025-06-19 00:43:40,REAL,2864676187,483,2864676670,2873615220
2025-06-19 00:43:42,FAKE,2864676670,238,2864676908,2873615707
2025-06-19 00:43:44,REAL,2864676908,491,2864677399,2873616198
2025-06-19 00:43:46,REAL,2864677399,481,2864677880,2873616679
2025-06-19 00:43:48,REAL,2864677880,491,2864678371,2873617170
2025-06-19 00:43:50,REAL,2864678371,482,2864678853,2873617652
2025-06-19 00:43:52,REAL,2864678853,486,2864679339,2873618138
2025-06-19 00:43:54,REAL,2864679339,482,2864679821,2873618620
2025-06-19 00:43:56,REAL,2864679821,481,2864680302,2873619101
2025-06-19 00:43:58,FAKE,2864680302,241,2864680543,2873627315
2025-06-19 00:44:00,REAL,2864680543,10645,2864691188,2873637960
2025-06-19 00:44:02,FAKE,2864691188,238,2864691426,2873648216
2025-06-19 00:44:04,REAL,2864691426,10252,2864701678,2873658468
2025-06-19 00:44:06,REAL,2864701678,10325,2864712003,2873668793
2025-06-19 00:44:08,FAKE,2864712003,243,2864712246,2873679044
2025-06-19 00:44:10,FAKE,2864712246,241,2864712487,2873689297
2025-06-19 00:44:12,FAKE,2864712487,243,2864712730,2873698356
2025-06-19 00:44:14,REAL,2864712730,481,2864713211,2873698837
2025-06-19 00:44:16,FAKE,2864713211,241,2864713452,2873699320
2025-06-19 00:44:18,FAKE,2864713452,243,2864713695,2873699801
2025-06-19 00:44:20,REAL,2864713695,483,2864714178,2873700284
2025-06-19 00:44:22,FAKE,2864714178,244,2864714422,2873700768
2025-06-19 00:44:24,REAL,2864714422,487,2864714909,2873701255
2025-06-19 00:44:26,FAKE,2864714909,243,2864715152,2873701734
2025-06-19 00:44:28,FAKE,2864715152,244,2864715396,2873702218
2025-06-19 00:44:30,REAL,2864715396,8482,2864723878,2873710700
2025-06-19 00:44:32,FAKE,2864723878,241,2864724119,2873721287
2025-06-19 00:44:34,REAL,2864724119,10259,2864734378,2873731546
2025-06-19 00:44:36,REAL,2864734378,10308,2864744686,2873741854
2025-06-19 00:44:38,REAL,2864744686,10246,2864754932,2873752100
2025-06-19 00:44:40,REAL,2864754932,10260,2864765192,2873762360
2025-06-19 00:44:42,FAKE,2864765192,241,2864765433,2873772613
2025-06-19 00:44:44,REAL,2864765433,8401,2864773834,2873781014
2025-06-19 00:44:46,REAL,2864773834,485,2864774319,2873781499
2025-06-19 00:44:48,FAKE,2864774319,244,2864774563,2873781988
2025-06-19 00:44:50,FAKE,2864774563,241,2864774804,2873782469
2025-06-19 00:44:52,REAL,2864774804,486,2864775290,2873782955
2025-06-19 00:44:54,FAKE,2864775290,238,2864775528,2873783443
2025-06-19 00:44:56,REAL,2864775528,477,2864776005,2873783920
2025-06-19 00:44:58,REAL,2864776005,480,2864776485,2873784400
2025-06-19 00:45:00,REAL,2864776485,487,2864776972,2873784887
2025-06-19 00:45:02,REAL,2864776972,8809,2864785781,2873793696
2025-06-19 00:45:04,REAL,2864785781,10779,2864796560,2873804475
2025-06-19 00:45:06,FAKE,2864796560,244,2864796804,2873814735
2025-06-19 00:45:08,REAL,2864796804,10323,2864807127,2873825058
2025-06-19 00:45:10,FAKE,2864807127,241,2864807368,2873835316
2025-06-19 00:45:12,REAL,2864807368,10258,2864817626,2873845574
2025-06-19 00:45:14,REAL,2864817626,10302,2864827928,2873855876
2025-06-19 00:45:16,REAL,2864827928,7813,2864835741,2873863689
2025-06-19 00:45:18,FAKE,2864835741,243,2864835984,2873864178
2025-06-19 00:45:20,REAL,2864835984,486,2864836470,2873864664
2025-06-19 00:45:22,FAKE,2864836470,244,2864836714,2873865153
2025-06-19 00:45:24,REAL,2864836714,478,2864837192,2873865631
2025-06-19 00:45:26,FAKE,2864837192,244,2864837436,2873866121
2025-06-19 00:45:28,REAL,2864837436,485,2864837921,2873866606
2025-06-19 00:45:30,REAL,2864837921,487,2864838408,2873867093
2025-06-19 00:45:32,FAKE,2864838408,244,2864838652,2873867581
2025-06-19 00:45:34,REAL,2864838652,589,2864839241,2873868170
2025-06-19 00:45:36,FAKE,2864839241,243,2864839484,2873868656
2025-06-19 00:45:38,REAL,2864839484,488,2864839972,2873869144
2025-06-19 00:45:40,REAL,2864839972,478,2864840450,2873869622
2025-06-19 00:45:42,FAKE,2864840450,244,2864840694,2873870107
2025-06-19 00:45:44,REAL,2864840694,488,2864841182,2873870595
2025-06-19 00:45:46,FAKE,2864841182,244,2864841426,2873871076
2025-06-19 00:45:48,REAL,2864841426,486,2864841912,2873871562
2025-06-19 00:45:50,REAL,2864841912,492,2864842404,2873872054
2025-06-19 00:45:52,FAKE,2864842404,244,2864842648,2873872539
2025-06-19 00:45:54,FAKE,2864842648,244,2864842892,2873873025
2025-06-19 00:45:56,REAL,2864842892,537,2864843429,2873873562
2025-06-19 00:45:58,FAKE,2864843429,243,2864843672,2873874051
2025-06-19 00:46:00,REAL,2864843672,487,2864844159,2873874538
2025-06-19 00:46:02,REAL,2864844159,491,2864844650,2873875029
2025-06-19 00:46:04,REAL,2864844650,488,2864845138,2873875517
2025-06-19 00:46:06,REAL,2864845138,543,2864845681,2873876060
2025-06-19 00:46:08,REAL,2864845681,475,2864846156,2873876535
2025-06-19 00:46:10,FAKE,2864846156,238,2864846394,2873877025
2025-06-19 00:46:12,FAKE,2864846394,238,2864846632,2873877503
2025-06-19 00:46:14,REAL,2864846632,475,2864847107,2873877978
2025-06-19 00:46:16,REAL,2864847107,547,2864847654,2873878525
2025-06-19 00:46:18,FAKE,2864847654,243,2864847897,2873879012
2025-06-19 00:46:20,REAL,2864847897,487,2864848384,2873879499
2025-06-19 00:46:22,REAL,2864848384,15100,2864863484,2873894599
2025-06-19 00:46:24,REAL,2864863484,10459,2864873943,2873905058
2025-06-19 00:46:26,REAL,2864873943,10246,2864884189,2873915304
2025-06-19 00:46:28,FAKE,2864884189,243,2864884432,2873925548
2025-06-19 00:46:30,FAKE,2864884432,243,2864884675,2873935804
2025-06-19 00:46:32,FAKE,2864884675,238,2864884913,2873946054
2025-06-19 00:46:34,REAL,2864884913,10258,2864895171,2873956312
2025-06-19 00:46:36,FAKE,2864895171,244,2864895415,2873962474
2025-06-19 00:46:38,REAL,2864895415,541,2864895956,2873963015
2025-06-19 00:46:40,REAL,2864895956,480,2864896436,2873963495
2025-06-19 00:46:42,REAL,2864896436,481,2864896917,2873963976
2025-06-19 00:46:44,FAKE,2864896917,244,2864897161,2873964457
2025-06-19 00:46:46,FAKE,2864897161,243,2864897404,2873964941
2025-06-19 00:46:48,REAL,2864897404,482,2864897886,2873965423
2025-06-19 00:46:50,REAL,2864897886,486,2864898372,2873965909
2025-06-19 00:46:52,FAKE,2864898372,244,2864898616,2873966390
2025-06-19 00:46:54,FAKE,2864898616,238,2864898854,2873966936
2025-06-19 00:46:56,FAKE,2864898854,238,2864899092,2873967417
2025-06-19 00:46:58,FAKE,2864899092,241,2864899333,2873967957
2025-06-19 00:47:00,FAKE,2864899333,238,2864899571,2873968434
2025-06-19 00:47:02,REAL,2864899571,488,2864900059,2873968922
2025-06-19 00:47:04,FAKE,2864900059,244,2864900303,2873969414
2025-06-19 00:47:06,REAL,2864900303,483,2864900786,2873969897
2025-06-19 00:47:08,FAKE,2864900786,238,2864901024,2873970382
2025-06-19 00:47:10,REAL,2864901024,486,2864901510,2873970868
2025-06-19 00:47:12,FAKE,2864901510,244,2864901754,2873971349
2025-06-19 00:47:14,FAKE,2864901754,238,2864901992,2873971836
2025-06-19 00:47:16,REAL,2864901992,487,2864902479,2873972323
2025-06-19 00:47:18,REAL,2864902479,487,2864902966,2873972810
2025-06-19 00:47:20,REAL,2864902966,537,2864903503,2873973347
2025-06-19 00:47:22,FAKE,2864903503,244,2864903747,2873973839
2025-06-19 00:47:24,FAKE,2864903747,243,2864903990,2873974321
2025-06-19 00:47:26,REAL,2864903990,541,2864904531,2873974862
2025-06-19 00:47:28,REAL,2864904531,480,2864905011,2873975342
2025-06-19 00:47:30,REAL,2864905011,476,2864905487,2873975818
2025-06-19 00:47:32,REAL,2864905487,487,2864905974,2873976305
2025-06-19 00:47:34,REAL,2864905974,481,2864906455,2873976786
2025-06-19 00:47:36,REAL,2864906455,484,2864906939,2873977270
2025-06-19 00:47:38,REAL,2864906939,480,2864907419,2873977750
2025-06-19 00:47:40,REAL,2864907419,542,2864907961,2873978292
2025-06-19 00:47:42,FAKE,2864907961,241,2864908202,2873978776
2025-06-19 00:47:44,FAKE,2864908202,243,2864908445,2873979259
2025-06-19 00:47:46,FAKE,2864908445,244,2864908689,2873986422
2025-06-19 00:47:48,FAKE,2864908689,238,2864908927,2873997535
2025-06-19 00:47:50,REAL,2864908927,10251,2864919178,2874007786
2025-06-19 00:47:52,REAL,2864919178,10319,2864929497,2874018105
2025-06-19 00:47:54,REAL,2864929497,10252,2864939749,2874028357
2025-06-19 00:47:56,REAL,2864939749,10327,2864950076,2874038684
2025-06-19 00:47:58,REAL,2864950076,10254,2864960330,2874048938
2025-06-19 00:48:00,FAKE,2864960330,238,2864960568,2874058473
2025-06-19 00:48:02,REAL,2864960568,543,2864961111,2874059016
2025-06-19 00:48:04,REAL,2864961111,489,2864961600,2874059505
2025-06-19 00:48:06,REAL,2864961600,479,2864962079,2874059984
2025-06-19 00:48:08,FAKE,2864962079,243,2864962322,2874060472
2025-06-19 00:48:10,FAKE,2864962322,244,2864962566,2874060958
2025-06-19 00:48:12,REAL,2864962566,485,2864963051,2874061443
2025-06-19 00:48:14,REAL,2864963051,481,2864963532,2874061924
2025-06-19 00:48:16,REAL,2864963532,490,2864964022,2874062414
2025-06-19 00:48:18,REAL,2864964022,7842,2864971864,2874070256
2025-06-19 00:48:20,REAL,2864971864,10845,2864982709,2874081101
2025-06-19 00:48:22,REAL,2864982709,10309,2864993018,2874091410
2025-06-19 00:48:24,REAL,2864993018,10326,2865003344,2874101736
2025-06-19 00:48:26,FAKE,2865003344,238,2865003582,2874111998
2025-06-19 00:48:28,REAL,2865003582,10253,2865013835,2874122251
2025-06-19 00:48:30,REAL,2865013835,10259,2865024094,2874132510
2025-06-19 00:48:32,FAKE,2865024094,238,2865024332,2874141381
2025-06-19 00:48:34,REAL,2865024332,492,2865024824,2874141873
2025-06-19 00:48:36,FAKE,2865024824,241,2865025065,2874142357
2025-06-19 00:48:38,REAL,2865025065,490,2865025555,2874142847
2025-06-19 00:48:40,REAL,2865025555,478,2865026033,2874143325
2025-06-19 00:48:42,FAKE,2865026033,244,2865026277,2874143814
2025-06-19 00:48:44,REAL,2865026277,540,2865026817,2874144354
2025-06-19 00:48:46,REAL,2865026817,479,2865027296,2874144833
2025-06-19 00:48:48,FAKE,2865027296,238,2865027534,2874145319
2025-06-19 00:48:50,REAL,2865027534,8550,2865036084,2874153869
2025-06-19 00:48:52,REAL,2865036084,10981,2865047065,2874164850
2025-06-19 00:48:54,REAL,2865047065,10245,2865057310,2874175095
2025-06-19 00:48:56,REAL,2865057310,10260,2865067570,2874185355
2025-06-19 00:48:58,REAL,2865067570,10260,2865077830,2874195615
2025-06-19 00:49:00,FAKE,2865077830,244,2865078074,2874205863
2025-06-19 00:49:02,REAL,2865078074,10255,2865088329,2874216118
2025-06-19 00:49:04,REAL,2865088329,8266,2865096595,2874224384
2025-06-19 00:49:06,REAL,2865096595,479,2865097074,2874224863
2025-06-19 00:49:08,FAKE,2865097074,238,2865097312,2874225339
2025-06-19 00:49:10,FAKE,2865097312,244,2865097556,2874225816
2025-06-19 00:49:12,REAL,2865097556,477,2865098033,2874226293
2025-06-19 00:49:14,FAKE,2865098033,238,2865098271,2874226777
2025-06-19 00:49:16,FAKE,2865098271,243,2865098514,2874227260
2025-06-19 00:49:18,REAL,2865098514,490,2865099004,2874227750
2025-06-19 00:49:20,REAL,2865099004,490,2865099494,2874228240
2025-06-19 00:49:22,REAL,2865099494,547,2865100041,2874228787
2025-06-19 00:49:24,FAKE,2865100041,241,2865100282,2874229270
2025-06-19 00:49:26,FAKE,2865100282,243,2865100525,2874229813
2025-06-19 00:49:28,FAKE,2865100525,238,2865100763,2874230299
2025-06-19 00:49:30,REAL,2865100763,487,2865101250,2874230786
2025-06-19 00:49:32,FAKE,2865101250,244,2865101494,2874231279
2025-06-19 00:49:34,FAKE,2865101494,244,2865101738,2874231763
2025-06-19 00:49:36,REAL,2865101738,489,2865102227,2874232252
2025-06-19 00:49:38,FAKE,2865102227,243,2865102470,2874232732
2025-06-19 00:49:40,FAKE,2865102470,244,2865102714,2874233217
2025-06-19 00:49:42,REAL,2865102714,486,2865103200,2874233703
2025-06-19 00:49:44,FAKE,2865103200,243,2865103443,2874234191
2025-06-19 00:49:46,REAL,2865103443,545,2865103988,2874234736
2025-06-19 00:49:48,REAL,2865103988,535,2865104523,2874235271
2025-06-19 00:49:50,REAL,2865104523,483,2865105006,2874235754
2025-06-19 00:49:52,FAKE,2865105006,244,2865105250,2874236235
2025-06-19 00:49:54,FAKE,2865105250,244,2865105494,2874236716
2025-06-19 00:49:56,FAKE,2865105494,241,2865105735,2874237204
2025-06-19 00:49:58,REAL,2865105735,481,2865106216,2874237685
2025-06-19 00:50:00,FAKE,2865106216,241,2865106457,2874238176
2025-06-19 00:50:02,REAL,2865106457,485,2865106942,2874238661
2025-06-19 00:50:04,REAL,2865106942,493,2865107435,2874239154
2025-06-19 00:50:06,REAL,2865107435,476,2865107911,2874239630
2025-06-19 00:50:08,FAKE,2865107911,238,2865108149,2874240120
2025-06-19 00:50:10,FAKE,2865108149,241,2865108390,2874240606
2025-06-19 00:50:12,REAL,2865108390,535,2865108925,2874241141
2025-06-19 00:50:14,REAL,2865108925,481,2865109406,2874241622
2025-06-19 00:50:16,FAKE,2865109406,238,2865109644,2874242110
2025-06-19 00:50:18,FAKE,2865109644,241,2865109885,2874242604
2025-06-19 00:50:20,FAKE,2865109885,244,2865110129,2874255777
2025-06-19 00:50:22,REAL,2865110129,10637,2865120766,2874266414
2025-06-19 00:50:24,REAL,2865120766,10253,2865131019,2874276667
2025-06-19 00:50:26,REAL,2865131019,10246,2865141265,2874286913
2025-06-19 00:50:28,REAL,2865141265,10255,2865151520,2874297168
2025-06-19 00:50:30,REAL,2865151520,10256,2865161776,2874307424
2025-06-19 00:50:32,REAL,2865161776,10245,2865172021,2874317669
2025-06-19 00:50:34,FAKE,2865172021,238,2865172259,2874324413
2025-06-19 00:50:36,REAL,2865172259,481,2865172740,2874324894
2025-06-19 00:50:38,REAL,2865172740,489,2865173229,2874325383
2025-06-19 00:50:40,REAL,2865173229,488,2865173717,2874325871
2025-06-19 00:50:42,REAL,2865173717,492,2865174209,2874326363
2025-06-19 00:50:44,REAL,2865174209,538,2865174747,2874326901
2025-06-19 00:50:46,REAL,2865174747,549,2865175296,2874327450
2025-06-19 00:50:48,REAL,2865175296,487,2865175783,2874327937
2025-06-19 00:50:50,FAKE,2865175783,238,2865176021,2874328417
2025-06-19 00:50:52,REAL,2865176021,486,2865176507,2874328903
2025-06-19 00:50:54,REAL,2865176507,484,2865176991,2874329387
2025-06-19 00:50:56,FAKE,2865176991,241,2865177232,2874329874
2025-06-19 00:50:58,FAKE,2865177232,238,2865177470,2874330360
2025-06-19 00:51:00,REAL,2865177470,531,2865178001,2874330891
2025-06-19 00:51:02,REAL,2865178001,483,2865178484,2874331374
2025-06-19 00:51:04,REAL,2865178484,476,2865178960,2874331850
2025-06-19 00:51:06,REAL,2865178960,483,2865179443,2874332333
2025-06-19 00:51:08,FAKE,2865179443,244,2865179687,2874332818
2025-06-19 00:51:10,REAL,2865179687,543,2865180230,2874333361
2025-06-19 00:51:12,FAKE,2865180230,241,2865180471,2874338742
2025-06-19 00:51:14,FAKE,2865180471,241,2865180712,2874350119
2025-06-19 00:51:16,FAKE,2865180712,244,2865180956,2874360375
2025-06-19 00:51:18,FAKE,2865180956,238,2865181194,2874370692
2025-06-19 00:51:20,REAL,2865181194,10259,2865191453,2874380951
2025-06-19 00:51:22,FAKE,2865191453,244,2865191697,2874391267
2025-06-19 00:51:24,REAL,2865191697,10258,2865201955,2874401525
2025-06-19 00:51:26,REAL,2865201955,10318,2865212273,2874411843
2025-06-19 00:51:28,REAL,2865212273,1073,2865213346,2874412916
2025-06-19 00:51:30,FAKE,2865213346,241,2865213587,2874413395
2025-06-19 00:51:32,REAL,2865213587,486,2865214073,2874413881
2025-06-19 00:51:34,REAL,2865214073,482,2865214555,2874414363
2025-06-19 00:51:36,FAKE,2865214555,238,2865214793,2874414957
2025-06-19 00:51:38,REAL,2865214793,488,2865215281,2874415445
2025-06-19 00:51:40,REAL,2865215281,490,2865215771,2874415935
2025-06-19 00:51:42,REAL,2865215771,492,2865216263,2874416427
2025-06-19 00:51:44,REAL,2865216263,6247,2865222510,2874422674
2025-06-19 00:51:46,REAL,2865222510,11039,2865233549,2874433713
2025-06-19 00:51:48,REAL,2865233549,10251,2865243800,2874443964
2025-06-19 00:51:50,REAL,2865243800,10316,2865254116,2874454280
2025-06-19 00:51:52,FAKE,2865254116,238,2865254354,2874464540
2025-06-19 00:51:54,REAL,2865254354,10320,2865264674,2874474860
2025-06-19 00:51:56,REAL,2865264674,10254,2865274928,2874485114
2025-06-19 00:51:58,REAL,2865274928,10187,2865285115,2874495301
2025-06-19 00:52:00,FAKE,2865285115,241,2865285356,2874495782
2025-06-19 00:52:02,FAKE,2865285356,238,2865285594,2874496273
2025-06-19 00:52:04,FAKE,2865285594,244,2865285838,2874496756
2025-06-19 00:52:06,REAL,2865285838,477,2865286315,2874497233
2025-06-19 00:52:08,REAL,2865286315,541,2865286856,2874497774
2025-06-19 00:52:10,FAKE,2865286856,238,2865287094,2874498248
2025-06-19 00:52:12,FAKE,2865287094,238,2865287332,2874498724
2025-06-19 00:52:14,FAKE,2865287332,241,2865287573,2874499264
2025-06-19 00:52:16,FAKE,2865287573,241,2865287814,2874506163
2025-06-19 00:52:18,REAL,2865287814,10924,2865298738,2874517087
2025-06-19 00:52:20,REAL,2865298738,10254,2865308992,2874527341
2025-06-19 00:52:22,FAKE,2865308992,243,2865309235,2874537597
2025-06-19 00:52:24,REAL,2865309235,10308,2865319543,2874547905
2025-06-19 00:52:26,REAL,2865319543,10250,2865329793,2874558155
2025-06-19 00:52:28,REAL,2865329793,10245,2865340038,2874568400
2025-06-19 00:52:30,REAL,2865340038,9586,2865349624,2874577986
2025-06-19 00:52:32,REAL,2865349624,479,2865350103,2874578465
2025-06-19 00:52:34,FAKE,2865350103,244,2865350347,2874578948
2025-06-19 00:52:36,REAL,2865350347,481,2865350828,2874579429
2025-06-19 00:52:38,REAL,2865350828,483,2865351311,2874579912
2025-06-19 00:52:40,REAL,2865351311,539,2865351850,2874580451
2025-06-19 00:52:42,REAL,2865351850,486,2865352336,2874580937
2025-06-19 00:52:44,REAL,2865352336,483,2865352819,2874581420
2025-06-19 00:52:46,REAL,2865352819,482,2865353301,2874581902
2025-06-19 00:52:48,REAL,2865353301,480,2865353781,2874582382
2025-06-19 00:52:50,REAL,2865353781,545,2865354326,2874582927
2025-06-19 00:52:52,REAL,2865354326,481,2865354807,2874583408
2025-06-19 00:52:54,FAKE,2865354807,244,2865355051,2874583894
2025-06-19 00:52:56,FAKE,2865355051,244,2865355295,2874584385
2025-06-19 00:52:58,REAL,2865355295,488,2865355783,2874584873
2025-06-19 00:53:00,REAL,2865355783,489,2865356272,2874585362
2025-06-19 00:53:02,FAKE,2865356272,244,2865356516,2874585848
2025-06-19 00:53:04,REAL,2865356516,541,2865357057,2874586389
2025-06-19 00:53:06,REAL,2865357057,487,2865357544,2874586876
2025-06-19 00:53:08,FAKE,2865357544,244,2865357788,2874587366
2025-06-19 00:53:10,FAKE,2865357788,243,2865358031,2874587841
2025-06-19 00:53:12,REAL,2865358031,477,2865358508,2874588318
2025-06-19 00:53:14,FAKE,2865358508,244,2865358752,2874588802
2025-06-19 00:53:16,REAL,2865358752,483,2865359235,2874589285
2025-06-19 00:53:18,FAKE,2865359235,244,2865359479,2874589778
2025-06-19 00:53:20,REAL,2865359479,487,2865359966,2874590265
2025-06-19 00:53:22,REAL,2865359966,476,2865360442,2874590741
2025-06-19 00:53:24,FAKE,2865360442,238,2865360680,2874591226
2025-06-19 00:53:26,REAL,2865360680,544,2865361224,2874591770
2025-06-19 00:53:28,REAL,2865361224,534,2865361758,2874592304
2025-06-19 00:53:30,FAKE,2865361758,238,2865361996,2874592788
2025-06-19 00:53:32,REAL,2865361996,478,2865362474,2874593266
2025-06-19 00:53:34,FAKE,2865362474,243,2865362717,2874593746
2025-06-19 00:53:36,REAL,2865362717,483,2865363200,2874594229
2025-06-19 00:53:38,REAL,2865363200,481,2865363681,2874594710
2025-06-19 00:53:40,REAL,2865363681,478,2865364159,2874595188
2025-06-19 00:53:42,REAL,2865364159,484,2865364643,2874595672
2025-06-19 00:53:44,FAKE,2865364643,241,2865364884,2874596152
2025-06-19 00:53:46,FAKE,2865364884,241,2865365125,2874596637
2025-06-19 00:53:48,REAL,2865365125,476,2865365601,2874597113
2025-06-19 00:53:50,REAL,2865365601,485,2865366086,2874597598
2025-06-19 00:53:52,FAKE,2865366086,244,2865366330,2874598139
2025-06-19 00:53:54,FAKE,2865366330,244,2865366574,2874598626
2025-06-19 00:53:56,FAKE,2865366574,243,2865366817,2874602219
2025-06-19 00:53:58,REAL,2865366817,11761,2865378578,2874613980
2025-06-19 00:54:00,REAL,2865378578,10254,2865388832,2874624234
2025-06-19 00:54:02,FAKE,2865388832,238,2865389070,2874634549
2025-06-19 00:54:04,FAKE,2865389070,243,2865389313,2874644858
2025-06-19 00:54:06,FAKE,2865389313,241,2865389554,2874655117
2025-06-19 00:54:08,FAKE,2865389554,243,2865389797,2874665431
2025-06-19 00:54:10,FAKE,2865389797,238,2865390035,2874675681
2025-06-19 00:54:12,REAL,2865390035,2800,2865392835,2874678481
2025-06-19 00:54:14,REAL,2865392835,488,2865393323,2874678969
2025-06-19 00:54:16,FAKE,2865393323,244,2865393567,2874679461
2025-06-19 00:54:18,REAL,2865393567,478,2865394045,2874679939
2025-06-19 00:54:20,FAKE,2865394045,243,2865394288,2874680417
2025-06-19 00:54:22,REAL,2865394288,490,2865394778,2874680907
2025-06-19 00:54:24,REAL,2865394778,485,2865395263,2874681392
2025-06-19 00:54:26,FAKE,2865395263,244,2865395507,2874681881
2025-06-19 00:54:28,REAL,2865395507,482,2865395989,2874682363
2025-06-19 00:54:30,REAL,2865395989,479,2865396468,2874682842
2025-06-19 00:54:32,REAL,2865396468,480,2865396948,2874683322
2025-06-19 00:54:34,REAL,2865396948,483,2865397431,2874683805
2025-06-19 00:54:36,FAKE,2865397431,241,2865397672,2874684293
2025-06-19 00:54:38,REAL,2865397672,543,2865398215,2874684836
2025-06-19 00:54:40,REAL,2865398215,539,2865398754,2874685375
2025-06-19 00:54:42,REAL,2865398754,488,2865399242,2874685863
2025-06-19 00:54:44,REAL,2865399242,484,2865399726,2874686347
2025-06-19 00:54:46,REAL,2865399726,485,2865400211,2874686832
2025-06-19 00:54:48,REAL,2865400211,482,2865400693,2874687314
2025-06-19 00:54:50,FAKE,2865400693,238,2865400931,2874687799
2025-06-19 00:54:52,REAL,2865400931,488,2865401419,2874688287
2025-06-19 00:54:54,REAL,2865401419,485,2865401904,2874688772
2025-06-19 00:54:56,REAL,2865401904,489,2865402393,2874689261
2025-06-19 00:54:58,FAKE,2865402393,244,2865402637,2874689735
2025-06-19 00:55:00,REAL,2865402637,484,2865403121,2874690219
2025-06-19 00:55:02,REAL,2865403121,485,2865403606,2874690704
2025-06-19 00:55:04,FAKE,2865403606,244,2865403850,2874691190
2025-06-19 00:55:06,REAL,2865403850,492,2865404342,2874691682
2025-06-19 00:55:08,REAL,2865404342,485,2865404827,2874692167
2025-06-19 00:55:10,REAL,2865404827,486,2865405313,2874692653
2025-06-19 00:55:12,REAL,2865405313,480,2865405793,2874693133
2025-06-19 00:55:14,REAL,2865405793,486,2865406279,2874693619
2025-06-19 00:55:16,REAL,2865406279,484,2865406763,2874694103
2025-06-19 00:55:18,FAKE,2865406763,241,2865407004,2874694705
2025-06-19 00:55:20,FAKE,2865407004,244,2865407248,2874695187
2025-06-19 00:55:22,REAL,2865407248,485,2865407733,2874695672
2025-06-19 00:55:24,REAL,2865407733,477,2865408210,2874696149
2025-06-19 00:55:26,REAL,2865408210,486,2865408696,2874696635
2025-06-19 00:55:28,REAL,2865408696,493,2865409189,2874697128
2025-06-19 00:55:30,FAKE,2865409189,241,2865409430,2874697614
2025-06-19 00:55:32,FAKE,2865409430,241,2865409671,2874698099
2025-06-19 00:55:34,FAKE,2865409671,241,2865409912,2874698575
2025-06-19 00:55:36,REAL,2865409912,487,2865410399,2874699062
2025-06-19 00:55:38,REAL,2865410399,481,2865410880,2874699543
2025-06-19 00:55:40,REAL,2865410880,488,2865411368,2874700031
2025-06-19 00:55:42,REAL,2865411368,477,2865411845,2874700508
2025-06-19 00:55:44,FAKE,2865411845,238,2865412083,2874700987
2025-06-19 00:55:46,FAKE,2865412083,243,2865412326,2874701467
2025-06-19 00:55:48,REAL,2865412326,6236,2865418562,2874707703
2025-06-19 00:55:50,REAL,2865418562,13826,2865432388,2874721529
2025-06-19 00:55:52,REAL,2865432388,10306,2865442694,2874731835
2025-06-19 00:55:54,REAL,2865442694,10314,2865453008,2874742149
2025-06-19 00:55:56,FAKE,2865453008,238,2865453246,2874752398
2025-06-19 00:55:58,REAL,2865453246,10250,2865463496,2874762648
2025-06-19 00:56:00,REAL,2865463496,10255,2865473751,2874772903
2025-06-19 00:56:02,REAL,2865473751,10320,2865484071,2874783223
2025-06-19 00:56:04,REAL,2865484071,549,2865484620,2874783772
2025-06-19 00:56:06,FAKE,2865484620,238,2865484858,2874784250
2025-06-19 00:56:08,REAL,2865484858,482,2865485340,2874784732
2025-06-19 00:56:10,FAKE,2865485340,244,2865485584,2874785218
2025-06-19 00:56:12,FAKE,2865485584,244,2865485828,2874785705
2025-06-19 00:56:14,REAL,2865485828,484,2865486312,2874786189
2025-06-19 00:56:16,REAL,2865486312,485,2865486797,2874786674
2025-06-19 00:56:18,REAL,2865486797,491,2865487288,2874787165
2025-06-19 00:56:20,REAL,2865487288,482,2865487770,2874787647
2025-06-19 00:56:22,FAKE,2865487770,243,2865488013,2874788132
2025-06-19 00:56:24,FAKE,2865488013,238,2865488251,2874788624
2025-06-19 00:56:26,REAL,2865488251,542,2865488793,2874789166
2025-06-19 00:56:28,FAKE,2865488793,243,2865489036,2874789655
2025-06-19 00:56:30,REAL,2865489036,543,2865489579,2874790198
2025-06-19 00:56:32,FAKE,2865489579,238,2865489817,2874790678
2025-06-19 00:56:34,REAL,2865489817,484,2865490301,2874791162
2025-06-19 00:56:36,REAL,2865490301,480,2865490781,2874791642
2025-06-19 00:56:38,FAKE,2865490781,238,2865491019,2874792125
2025-06-19 00:56:40,REAL,2865491019,478,2865491497,2874792603
2025-06-19 00:56:42,REAL,2865491497,481,2865491978,2874793084
2025-06-19 00:56:44,FAKE,2865491978,243,2865492221,2874793569
2025-06-19 00:56:46,REAL,2865492221,478,2865492699,2874794047
2025-06-19 00:56:48,FAKE,2865492699,243,2865492942,2874794533
2025-06-19 00:56:50,REAL,2865492942,484,2865493426,2874795017
2025-06-19 00:56:52,REAL,2865493426,7428,2865500854,2874802445
2025-06-19 00:56:54,FAKE,2865500854,241,2865501095,2874813689
2025-06-19 00:56:56,REAL,2865501095,10259,2865511354,2874823948
2025-06-19 00:56:58,FAKE,2865511354,243,2865511597,2874834268
2025-06-19 00:57:00,REAL,2865511597,10371,2865521968,2874844639
2025-06-19 00:57:02,REAL,2865521968,10258,2865532226,2874854897
2025-06-19 00:57:04,REAL,2865532226,10254,2865542480,2874865151
2025-06-19 00:57:06,REAL,2865542480,9129,2865551609,2874874280
2025-06-19 00:57:08,FAKE,2865551609,241,2865551850,2874874764
2025-06-19 00:57:10,REAL,2865551850,484,2865552334,2874875248
2025-06-19 00:57:12,REAL,2865552334,488,2865552822,2874875736
2025-06-19 00:57:14,FAKE,2865552822,244,2865553066,2874876216
2025-06-19 00:57:16,REAL,2865553066,485,2865553551,2874876701
2025-06-19 00:57:18,FAKE,2865553551,243,2865553794,2874877188
2025-06-19 00:57:20,REAL,2865553794,485,2865554279,2874877673
2025-06-19 00:57:22,FAKE,2865554279,241,2865554520,2874878154
2025-06-19 00:57:24,REAL,2865554520,483,2865555003,2874878637
2025-06-19 00:57:26,REAL,2865555003,476,2865555479,2874879113
2025-06-19 00:57:28,REAL,2865555479,485,2865555964,2874879598
2025-06-19 00:57:30,REAL,2865555964,478,2865556442,2874880076
2025-06-19 00:57:32,REAL,2865556442,538,2865556980,2874880614
2025-06-19 00:57:34,FAKE,2865556980,241,2865557221,2874881154
2025-06-19 00:57:36,REAL,2865557221,482,2865557703,2874881636
2025-06-19 00:57:38,REAL,2865557703,485,2865558188,2874882121
2025-06-19 00:57:40,FAKE,2865558188,243,2865558431,2874882611
2025-06-19 00:57:42,REAL,2865558431,487,2865558918,2874883098
2025-06-19 00:57:44,REAL,2865558918,2998,2865561916,2874886096
2025-06-19 00:57:46,FAKE,2865561916,244,2865562160,2874897665
2025-06-19 00:57:48,FAKE,2865562160,241,2865562401,2874907922
2025-06-19 00:57:50,REAL,2865562401,10315,2865572716,2874918237
2025-06-19 00:57:52,REAL,2865572716,10255,2865582971,2874928492
2025-06-19 00:57:54,REAL,2865582971,10250,2865593221,2874938742
2025-06-19 00:57:56,FAKE,2865593221,241,2865593462,2874949056
2025-06-19 00:57:58,FAKE,2865593462,244,2865593706,2874959312
2025-06-19 00:58:00,REAL,2865593706,3256,2865596962,2874962568
2025-06-19 00:58:02,REAL,2865596962,477,2865597439,2874963045
2025-06-19 00:58:04,REAL,2865597439,492,2865597931,2874963537
2025-06-19 00:58:06,FAKE,2865597931,244,2865598175,2874964080
2025-06-19 00:58:08,REAL,2865598175,483,2865598658,2874964563
2025-06-19 00:58:10,FAKE,2865598658,244,2865598902,2874965043
2025-06-19 00:58:12,REAL,2865598902,482,2865599384,2874965525
2025-06-19 00:58:14,REAL,2865599384,483,2865599867,2874966008
2025-06-19 00:58:16,FAKE,2865599867,238,2865600105,2874966500
2025-06-19 00:58:18,REAL,2865600105,478,2865600583,2874966978
2025-06-19 00:58:20,REAL,2865600583,490,2865601073,2874967468
2025-06-19 00:58:22,REAL,2865601073,479,2865601552,2874967947
2025-06-19 00:58:24,FAKE,2865601552,241,2865601793,2874968434
2025-06-19 00:58:26,REAL,2865601793,542,2865602335,2874968976
2025-06-19 00:58:28,REAL,2865602335,239,2865602574,2874969215
2025-06-19 00:58:30,FAKE,2865602574,241,2865602815,2874969702
2025-06-19 00:58:32,REAL,2865602815,488,2865603303,2874970190
2025-06-19 00:58:34,REAL,2865603303,489,2865603792,2874970679
2025-06-19 00:58:36,REAL,2865603792,488,2865604280,2874971167
2025-06-19 00:58:38,REAL,2865604280,490,2865604770,2874971657
2025-06-19 00:58:40,FAKE,2865604770,243,2865605013,2874972193
2025-06-19 00:58:42,REAL,2865605013,491,2865605504,2874972684
2025-06-19 00:58:44,FAKE,2865605504,244,2865605748,2874973170
2025-06-19 00:58:46,FAKE,2865605748,244,2865605992,2874973659
2025-06-19 00:58:48,REAL,2865605992,4122,2865610114,2874977781
2025-06-19 00:58:50,REAL,2865610114,14354,2865624468,2874992135
2025-06-19 00:58:52,REAL,2865624468,10249,2865634717,2875002384
2025-06-19 00:58:54,REAL,2865634717,10256,2865644973,2875012640
2025-06-19 00:58:56,FAKE,2865644973,243,2865645216,2875022888
2025-06-19 00:58:58,REAL,2865645216,10314,2865655530,2875033202
2025-06-19 00:59:00,REAL,2865655530,10247,2865665777,2875043449
2025-06-19 00:59:02,REAL,2865665777,10250,2865676027,2875053699
2025-06-19 00:59:04,REAL,2865676027,2001,2865678028,2875055700
2025-06-19 00:59:06,FAKE,2865678028,243,2865678271,2875056187
2025-06-19 00:59:08,REAL,2865678271,477,2865678748,2875056664
2025-06-19 00:59:10,REAL,2865678748,11258,2865690006,2875067922
2025-06-19 00:59:12,FAKE,2865690006,238,2865690244,2875078313
2025-06-19 00:59:14,FAKE,2865690244,241,2865690485,2875088614
2025-06-19 00:59:16,REAL,2865690485,10249,2865700734,2875098863
2025-06-19 00:59:18,REAL,2865700734,10250,2865710984,2875109113
2025-06-19 00:59:20,REAL,2865710984,10243,2865721227,2875119356
2025-06-19 00:59:22,REAL,2865721227,10256,2865731483,2875129612
2025-06-19 00:59:24,REAL,2865731483,6487,2865737970,2875136099
2025-06-19 00:59:26,REAL,2865737970,485,2865738455,2875136584
2025-06-19 00:59:28,REAL,2865738455,491,2865738946,2875137075
2025-06-19 00:59:30,REAL,2865738946,486,2865739432,2875137561
2025-06-19 00:59:32,REAL,2865739432,482,2865739914,2875138043
2025-06-19 00:59:34,FAKE,2865739914,241,2865740155,2875138522
2025-06-19 00:59:36,FAKE,2865740155,238,2865740393,2875138999
2025-06-19 00:59:38,REAL,2865740393,483,2865740876,2875139482
2025-06-19 00:59:40,FAKE,2865740876,243,2865741119,2875139962
2025-06-19 00:59:42,FAKE,2865741119,238,2865741357,2875140439
2025-06-19 00:59:44,REAL,2865741357,482,2865741839,2875140921
2025-06-19 00:59:46,REAL,2865741839,538,2865742377,2875141459
2025-06-19 00:59:48,REAL,2865742377,486,2865742863,2875141945
2025-06-19 00:59:50,REAL,2865742863,480,2865743343,2875142425
2025-06-19 00:59:52,REAL,2865743343,488,2865743831,2875142913
2025-06-19 00:59:54,REAL,2865743831,477,2865744308,2875143390
2025-06-19 00:59:56,REAL,2865744308,542,2865744850,2875143932
2025-06-19 00:59:58,REAL,2865744850,490,2865745340,2875144422
2025-06-19 01:00:00,REAL,2865745340,492,2865745832,2875144914
2025-06-19 01:00:02,REAL,2865745832,485,2865746317,2875145399
2025-06-19 01:00:04,REAL,2865746317,494,2865746811,2875145893
2025-06-19 01:00:06,REAL,2865746811,481,2865747292,2875146374
2025-06-19 01:00:08,REAL,2865747292,484,2865747776,2875146858
2025-06-19 01:00:10,REAL,2865747776,494,2865748270,2875147352
2025-06-19 01:00:12,FAKE,2865748270,241,2865748511,2875147839
2025-06-19 01:00:14,REAL,2865748511,486,2865748997,2875148325
2025-06-19 01:00:16,REAL,2865748997,476,2865749473,2875148801
2025-06-19 01:00:18,REAL,2865749473,480,2865749953,2875149281
2025-06-19 01:00:20,REAL,2865749953,479,2865750432,2875149760
2025-06-19 01:00:22,FAKE,2865750432,238,2865750670,2875150291
2025-06-19 01:00:24,FAKE,2865750670,238,2865750908,2875150780
2025-06-19 01:00:26,FAKE,2865750908,238,2865751146,2875151263
2025-06-19 01:00:28,REAL,2865751146,486,2865751632,2875151749
2025-06-19 01:00:30,REAL,2865751632,483,2865752115,2875152232
2025-06-19 01:00:32,REAL,2865752115,489,2865752604,2875152721
2025-06-19 01:00:34,FAKE,2865752604,241,2865752845,2875153205
2025-06-19 01:00:36,FAKE,2865752845,241,2865753086,2875153693
2025-06-19 01:00:38,REAL,2865753086,494,2865753580,2875154187
2025-06-19 01:00:40,FAKE,2865753580,238,2865753818,2875154726
2025-06-19 01:00:42,REAL,2865753818,488,2865754306,2875155214
2025-06-19 01:00:44,FAKE,2865754306,244,2865754550,2875155691
2025-06-19 01:00:46,FAKE,2865754550,243,2865754793,2875156177
2025-06-19 01:00:48,FAKE,2865754793,241,2865755034,2875156665
2025-06-19 01:00:50,REAL,2865755034,15201,2865770235,2875171866
2025-06-19 01:00:52,FAKE,2865770235,238,2865770473,2875182182
2025-06-19 01:00:54,REAL,2865770473,10251,2865780724,2875192433
2025-06-19 01:00:56,REAL,2865780724,10254,2865790978,2875202687
2025-06-19 01:00:58,REAL,2865790978,10309,2865801287,2875212996
2025-06-19 01:01:00,REAL,2865801287,10251,2865811538,2875223247
2025-06-19 01:01:02,REAL,2865811538,10249,2865821787,2875233496
2025-06-19 01:01:04,REAL,2865821787,5103,2865826890,2875238599
2025-06-19 01:01:06,FAKE,2865826890,244,2865827134,2875239086
2025-06-19 01:01:08,REAL,2865827134,489,2865827623,2875239575
2025-06-19 01:01:10,REAL,2865827623,487,2865828110,2875240062
2025-06-19 01:01:12,REAL,2865828110,484,2865828594,2875240546
2025-06-19 01:01:14,REAL,2865828594,478,2865829072,2875241024
2025-06-19 01:01:16,REAL,2865829072,479,2865829551,2875241503
2025-06-19 01:01:18,REAL,2865829551,533,2865830084,2875242036
2025-06-19 01:01:20,REAL,2865830084,486,2865830570,2875242522
2025-06-19 01:01:22,REAL,2865830570,477,2865831047,2875242999
2025-06-19 01:01:24,FAKE,2865831047,244,2865831291,2875243484
2025-06-19 01:01:26,FAKE,2865831291,244,2865831535,2875243970
2025-06-19 01:01:28,REAL,2865831535,493,2865832028,2875244463
2025-06-19 01:01:30,REAL,2865832028,479,2865832507,2875244942
2025-06-19 01:01:32,FAKE,2865832507,243,2865832750,2875245428
2025-06-19 01:01:34,REAL,2865832750,534,2865833284,2875245962
2025-06-19 01:01:36,REAL,2865833284,482,2865833766,2875246444
2025-06-19 01:01:38,REAL,2865833766,480,2865834246,2875246924
2025-06-19 01:01:40,REAL,2865834246,481,2865834727,2875247405
2025-06-19 01:01:42,FAKE,2865834727,243,2865834970,2875247885
2025-06-19 01:01:44,REAL,2865834970,488,2865835458,2875248373
2025-06-19 01:01:46,REAL,2865835458,488,2865835946,2875248861
2025-06-19 01:01:48,REAL,2865835946,538,2865836484,2875249399
2025-06-19 01:01:50,REAL,2865836484,489,2865836973,2875249888
2025-06-19 01:01:52,REAL,2865836973,2348,2865839321,2875252236
2025-06-19 01:01:54,FAKE,2865839321,238,2865839559,2875264086
2025-06-19 01:01:56,REAL,2865839559,10261,2865849820,2875274347
2025-06-19 01:01:58,FAKE,2865849820,243,2865850063,2875284669
2025-06-19 01:02:00,REAL,2865850063,10256,2865860319,2875294925
2025-06-19 01:02:02,REAL,2865860319,10261,2865870580,2875305186
2025-06-19 01:02:04,REAL,2865870580,10317,2865880897,2875315503
2025-06-19 01:02:06,FAKE,2865880897,238,2865881135,2875325753
2025-06-19 01:02:08,FAKE,2865881135,243,2865881378,2875329605
2025-06-19 01:02:10,REAL,2865881378,489,2865881867,2875330094
2025-06-19 01:02:12,FAKE,2865881867,243,2865882110,2875330579
2025-06-19 01:02:14,FAKE,2865882110,241,2865882351,2875331057
2025-06-19 01:02:16,FAKE,2865882351,243,2865882594,2875331544
2025-06-19 01:02:18,FAKE,2865882594,241,2865882835,2875332085
2025-06-19 01:02:20,FAKE,2865882835,241,2865883076,2875332568
2025-06-19 01:02:22,FAKE,2865883076,244,2865883320,2875333055
2025-06-19 01:02:24,REAL,2865883320,3068,2865886388,2875336123
2025-06-19 01:02:26,REAL,2865886388,11502,2865897890,2875347625
2025-06-19 01:02:28,FAKE,2865897890,244,2865898134,2875357943
2025-06-19 01:02:30,REAL,2865898134,10256,2865908390,2875368199
2025-06-19 01:02:32,FAKE,2865908390,243,2865908633,2875378517
2025-06-19 01:02:34,REAL,2865908633,10246,2865918879,2875388763
2025-06-19 01:02:36,REAL,2865918879,10322,2865929201,2875399085
2025-06-19 01:02:38,REAL,2865929201,10257,2865939458,2875409342
2025-06-19 01:02:40,FAKE,2865939458,243,2865939701,2875412600
2025-06-19 01:02:42,FAKE,2865939701,243,2865939944,2875413085
2025-06-19 01:02:44,REAL,2865939944,483,2865940427,2875413568
2025-06-19 01:02:46,FAKE,2865940427,243,2865940670,2875414111
2025-06-19 01:02:48,REAL,2865940670,489,2865941159,2875414600
2025-06-19 01:02:50,REAL,2865941159,487,2865941646,2875415087
2025-06-19 01:02:52,REAL,2865941646,485,2865942131,2875415572
2025-06-19 01:02:54,REAL,2865942131,483,2865942614,2875416055
2025-06-19 01:02:56,FAKE,2865942614,241,2865942855,2875420506
2025-06-19 01:02:58,FAKE,2865942855,238,2865943093,2875435645
2025-06-19 01:03:00,REAL,2865943093,10253,2865953346,2875445898
2025-06-19 01:03:02,REAL,2865953346,10318,2865963664,2875456216
2025-06-19 01:03:04,REAL,2865963664,10250,2865973914,2875466466
2025-06-19 01:03:06,REAL,2865973914,10251,2865984165,2875476717
2025-06-19 01:03:08,REAL,2865984165,10315,2865994480,2875487032
2025-06-19 01:03:10,FAKE,2865994480,244,2865994724,2875497288
2025-06-19 01:03:12,FAKE,2865994724,238,2865994962,2875499876
2025-06-19 01:03:14,REAL,2865994962,484,2865995446,2875500360
2025-06-19 01:03:16,FAKE,2865995446,241,2865995687,2875500898
2025-06-19 01:03:18,REAL,2865995687,485,2865996172,2875501383
2025-06-19 01:03:20,REAL,2865996172,488,2865996660,2875501871
2025-06-19 01:03:22,REAL,2865996660,479,2865997139,2875502350
2025-06-19 01:03:24,FAKE,2865997139,238,2865997377,2875502839
2025-06-19 01:03:26,FAKE,2865997377,238,2865997615,2875503320
2025-06-19 01:03:28,REAL,2865997615,4313,2866001928,2875507633
2025-06-19 01:03:30,REAL,2866001928,11255,2866013183,2875518888
2025-06-19 01:03:32,FAKE,2866013183,241,2866013424,2875529202
2025-06-19 01:03:34,FAKE,2866013424,244,2866013668,2875539445
2025-06-19 01:03:36,REAL,2866013668,10249,2866023917,2875549694
2025-06-19 01:03:38,REAL,2866023917,10249,2866034166,2875559943
2025-06-19 01:03:40,FAKE,2866034166,244,2866034410,2875570203
2025-06-19 01:03:42,REAL,2866034410,10190,2866044600,2875580393
2025-06-19 01:03:44,FAKE,2866044600,238,2866044838,2875582392
2025-06-19 01:03:46,REAL,2866044838,542,2866045380,2875582934
2025-06-19 01:03:48,REAL,2866045380,478,2866045858,2875583412
2025-06-19 01:03:50,FAKE,2866045858,243,2866046101,2875583906
2025-06-19 01:03:52,REAL,2866046101,481,2866046582,2875584387
2025-06-19 01:03:54,REAL,2866046582,484,2866047066,2875584871
2025-06-19 01:03:56,REAL,2866047066,479,2866047545,2875585350
2025-06-19 01:03:58,REAL,2866047545,491,2866048036,2875585841
2025-06-19 01:04:00,REAL,2866048036,4986,2866053022,2875590827
2025-06-19 01:04:02,FAKE,2866053022,243,2866053265,2875601805
2025-06-19 01:04:04,FAKE,2866053265,238,2866053503,2875612057
2025-06-19 01:04:06,REAL,2866053503,10318,2866063821,2875622375
2025-06-19 01:04:08,FAKE,2866063821,244,2866064065,2875632619
2025-06-19 01:04:10,REAL,2866064065,10253,2866074318,2875642872
2025-06-19 01:04:12,REAL,2866074318,10257,2866084575,2875653129
2025-06-19 01:04:14,REAL,2866084575,10373,2866094948,2875663502
2025-06-19 01:04:16,REAL,2866094948,1344,2866096292,2875664846
2025-06-19 01:04:18,REAL,2866096292,484,2866096776,2875665330
2025-06-19 01:04:20,FAKE,2866096776,241,2866097017,2875665807
2025-06-19 01:04:22,REAL,2866097017,490,2866097507,2875666297
2025-06-19 01:04:24,REAL,2866097507,484,2866097991,2875666781
2025-06-19 01:04:26,REAL,2866097991,488,2866098479,2875667269
2025-06-19 01:04:28,FAKE,2866098479,241,2866098720,2875667752
2025-06-19 01:04:30,REAL,2866098720,485,2866099205,2875668237
2025-06-19 01:04:32,REAL,2866099205,477,2866099682,2875668714
2025-06-19 01:04:34,REAL,2866099682,486,2866100168,2875669200
2025-06-19 01:04:36,REAL,2866100168,485,2866100653,2875669685
2025-06-19 01:04:38,REAL,2866100653,485,2866101138,2875670170
2025-06-19 01:04:40,FAKE,2866101138,238,2866101376,2875670654
2025-06-19 01:04:42,REAL,2866101376,489,2866101865,2875671143
2025-06-19 01:04:44,REAL,2866101865,542,2866102407,2875671685
2025-06-19 01:04:46,REAL,2866102407,479,2866102886,2875672164
2025-06-19 01:04:48,REAL,2866102886,482,2866103368,2875672646
2025-06-19 01:04:50,REAL,2866103368,541,2866103909,2875673187
2025-06-19 01:04:52,REAL,2866103909,478,2866104387,2875673665
2025-06-19 01:04:54,FAKE,2866104387,238,2866104625,2875674144
2025-06-19 01:04:56,REAL,2866104625,476,2866105101,2875674620
2025-06-19 01:04:58,REAL,2866105101,476,2866105577,2875675096
2025-06-19 01:05:00,REAL,2866105577,486,2866106063,2875675582
2025-06-19 01:05:02,FAKE,2866106063,244,2866106307,2875676070
2025-06-19 01:05:04,FAKE,2866106307,238,2866106545,2875676553
2025-06-19 01:05:06,REAL,2866106545,485,2866107030,2875677038
2025-06-19 01:05:08,FAKE,2866107030,244,2866107274,2875677521
2025-06-19 01:05:10,REAL,2866107274,482,2866107756,2875678003
2025-06-19 01:05:12,FAKE,2866107756,244,2866108000,2875678482
2025-06-19 01:05:14,REAL,2866108000,485,2866108485,2875678967
2025-06-19 01:05:16,REAL,2866108485,488,2866108973,2875679455
2025-06-19 01:05:18,FAKE,2866108973,238,2866109211,2875680004
2025-06-19 01:05:20,REAL,2866109211,488,2866109699,2875680492
2025-06-19 01:05:22,REAL,2866109699,483,2866110182,2875680975
2025-06-19 01:05:24,REAL,2866110182,486,2866110668,2875681461
2025-06-19 01:05:26,REAL,2866110668,482,2866111150,2875681943
2025-06-19 01:05:28,REAL,2866111150,477,2866111627,2875682420
2025-06-19 01:05:30,REAL,2866111627,480,2866112107,2875682900
2025-06-19 01:05:32,REAL,2866112107,483,2866112590,2875683383
2025-06-19 01:05:34,REAL,2866112590,492,2866113082,2875683875
2025-06-19 01:05:36,REAL,2866113082,483,2866113565,2875684358
2025-06-19 01:05:38,REAL,2866113565,487,2866114052,2875684845
2025-06-19 01:05:40,FAKE,2866114052,238,2866114290,2875685384
2025-06-19 01:05:42,FAKE,2866114290,244,2866114534,2875685869
2025-06-19 01:05:44,REAL,2866114534,487,2866115021,2875686356
2025-06-19 01:05:46,REAL,2866115021,485,2866115506,2875686841
2025-06-19 01:05:48,FAKE,2866115506,244,2866115750,2875687328
2025-06-19 01:05:50,FAKE,2866115750,244,2866115994,2875687807
2025-06-19 01:05:52,REAL,2866115994,486,2866116480,2875688293
2025-06-19 01:05:54,REAL,2866116480,540,2866117020,2875688833
2025-06-19 01:05:56,REAL,2866117020,486,2866117506,2875689319
2025-06-19 01:05:58,FAKE,2866117506,238,2866117744,2875689801
2025-06-19 01:06:00,FAKE,2866117744,241,2866117985,2875690281
2025-06-19 01:06:02,REAL,2866117985,488,2866118473,2875690769
2025-06-19 01:06:04,REAL,2866118473,489,2866118962,2875691258
2025-06-19 01:06:06,FAKE,2866118962,241,2866119203,2875691737
2025-06-19 01:06:08,REAL,2866119203,480,2866119683,2875692217
2025-06-19 01:06:10,REAL,2866119683,489,2866120172,2875692706
2025-06-19 01:06:12,REAL,2866120172,2476,2866122648,2875695182
2025-06-19 01:06:14,REAL,2866122648,11788,2866134436,2875706970
2025-06-19 01:06:16,REAL,2866134436,10327,2866144763,2875717297
2025-06-19 01:06:18,FAKE,2866144763,244,2866145007,2875727553
2025-06-19 01:06:20,REAL,2866145007,10315,2866155322,2875737868
2025-06-19 01:06:22,REAL,2866155322,10255,2866165577,2875748123
2025-06-19 01:06:24,FAKE,2866165577,244,2866165821,2875758376
2025-06-19 01:06:26,FAKE,2866165821,243,2866166064,2875768629
2025-06-19 01:06:28,REAL,2866166064,3717,2866169781,2875772346
2025-06-19 01:06:30,FAKE,2866169781,243,2866170024,2875772889
2025-06-19 01:06:32,REAL,2866170024,479,2866170503,2875773368
2025-06-19 01:06:34,FAKE,2866170503,244,2866170747,2875773847
2025-06-19 01:06:36,REAL,2866170747,482,2866171229,2875774329
2025-06-19 01:06:38,REAL,2866171229,492,2866171721,2875774821
2025-06-19 01:06:40,REAL,2866171721,483,2866172204,2875775304
2025-06-19 01:06:42,REAL,2866172204,485,2866172689,2875775789
2025-06-19 01:06:44,FAKE,2866172689,243,2866172932,2875778992
2025-06-19 01:06:46,REAL,2866172932,11375,2866184307,2875790367
2025-06-19 01:06:48,REAL,2866184307,10250,2866194557,2875800617
2025-06-19 01:06:50,FAKE,2866194557,243,2866194800,2875810870
2025-06-19 01:06:52,REAL,2866194800,10253,2866205053,2875821123
2025-06-19 01:06:54,REAL,2866205053,10249,2866215302,2875831372
2025-06-19 01:06:56,FAKE,2866215302,243,2866215545,2875841689
2025-06-19 01:06:58,REAL,2866215545,10250,2866225795,2875851939
2025-06-19 01:07:00,FAKE,2866225795,238,2866226033,2875854993
2025-06-19 01:07:02,REAL,2866226033,485,2866226518,2875855478
2025-06-19 01:07:04,REAL,2866226518,479,2866226997,2875855957
2025-06-19 01:07:06,REAL,2866226997,547,2866227544,2875856504
2025-06-19 01:07:08,FAKE,2866227544,238,2866227782,2875856992
2025-06-19 01:07:10,REAL,2866227782,489,2866228271,2875857481
2025-06-19 01:07:12,REAL,2866228271,474,2866228745,2875857955
2025-06-19 01:07:14,REAL,2866228745,485,2866229230,2875858440
2025-06-19 01:07:16,FAKE,2866229230,243,2866229473,2875862432
2025-06-19 01:07:18,FAKE,2866229473,241,2866229714,2875873943
2025-06-19 01:07:20,REAL,2866229714,10317,2866240031,2875884260
2025-06-19 01:07:22,REAL,2866240031,10255,2866250286,2875894515
2025-06-19 01:07:24,FAKE,2866250286,241,2866250527,2875904764
2025-06-19 01:07:26,REAL,2866250527,10245,2866260772,2875915009
2025-06-19 01:07:28,REAL,2866260772,10318,2866271090,2875925327
2025-06-19 01:07:30,FAKE,2866271090,238,2866271328,2875935576
2025-06-19 01:07:32,REAL,2866271328,2460,2866273788,2875938036
2025-06-19 01:07:34,REAL,2866273788,491,2866274279,2875938527
2025-06-19 01:07:36,FAKE,2866274279,241,2866274520,2875939013
2025-06-19 01:07:38,FAKE,2866274520,238,2866274758,2875939502
2025-06-19 01:07:40,REAL,2866274758,480,2866275238,2875939982
2025-06-19 01:07:42,REAL,2866275238,488,2866275726,2875940470
2025-06-19 01:07:44,REAL,2866275726,542,2866276268,2875941012
2025-06-19 01:07:46,REAL,2866276268,488,2866276756,2875941500
2025-06-19 01:07:48,REAL,2866276756,4579,2866281335,2875946079
2025-06-19 01:07:50,REAL,2866281335,14488,2866295823,2875960567
2025-06-19 01:07:52,FAKE,2866295823,238,2866296061,2875970877
2025-06-19 01:07:54,REAL,2866296061,10251,2866306312,2875981128
2025-06-19 01:07:56,REAL,2866306312,10318,2866316630,2875991446
2025-06-19 01:07:58,REAL,2866316630,10255,2866326885,2876001701
2025-06-19 01:08:00,REAL,2866326885,10251,2866337136,2876011952
2025-06-19 01:08:02,REAL,2866337136,10252,2866347388,2876022204
2025-06-19 01:08:04,FAKE,2866347388,238,2866347626,2876024008
2025-06-19 01:08:06,REAL,2866347626,477,2866348103,2876024485
2025-06-19 01:08:08,REAL,2866348103,483,2866348586,2876024968
2025-06-19 01:08:10,REAL,2866348586,482,2866349068,2876025450
2025-06-19 01:08:12,REAL,2866349068,481,2866349549,2876025931
2025-06-19 01:08:14,REAL,2866349549,488,2866350037,2876026419
2025-06-19 01:08:16,FAKE,2866350037,244,2866350281,2876026907
2025-06-19 01:08:18,FAKE,2866350281,244,2866350525,2876027388
2025-06-19 01:08:20,REAL,2866350525,5578,2866356103,2876032966
2025-06-19 01:08:22,FAKE,2866356103,241,2866356344,2876044347
2025-06-19 01:08:24,FAKE,2866356344,241,2866356585,2876054599
2025-06-19 01:08:26,FAKE,2866356585,244,2866356829,2876064852
2025-06-19 01:08:28,FAKE,2866356829,238,2866357067,2876075170
2025-06-19 01:08:30,FAKE,2866357067,241,2866357308,2876085430
2025-06-19 01:08:32,REAL,2866357308,10252,2866367560,2876095682
2025-06-19 01:08:34,FAKE,2866367560,241,2866367801,2876105995
2025-06-19 01:08:36,REAL,2866367801,1149,2866368950,2876107144
2025-06-19 01:08:38,REAL,2866368950,484,2866369434,2876107628
2025-06-19 01:08:40,FAKE,2866369434,241,2866369675,2876108112
2025-06-19 01:08:42,REAL,2866369675,478,2866370153,2876108590
2025-06-19 01:08:44,REAL,2866370153,482,2866370635,2876109072
2025-06-19 01:08:46,FAKE,2866370635,241,2866370876,2876109558
2025-06-19 01:08:48,FAKE,2866370876,243,2866371119,2876110036
2025-06-19 01:08:50,FAKE,2866371119,241,2866371360,2876110520
2025-06-19 01:08:52,FAKE,2866371360,241,2866371601,2876116361
2025-06-19 01:08:54,FAKE,2866371601,243,2866371844,2876127606
2025-06-19 01:08:56,REAL,2866371844,10251,2866382095,2876137857
2025-06-19 01:08:58,FAKE,2866382095,244,2866382339,2876148112
2025-06-19 01:09:00,REAL,2866382339,10318,2866392657,2876158430
2025-06-19 01:09:02,FAKE,2866392657,243,2866392900,2876168682
2025-06-19 01:09:04,REAL,2866392900,10249,2866403149,2876178931
2025-06-19 01:09:06,FAKE,2866403149,243,2866403392,2876189179
2025-06-19 01:09:08,REAL,2866403392,556,2866403948,2876189735
2025-06-19 01:09:10,REAL,2866403948,487,2866404435,2876190222
2025-06-19 01:09:12,REAL,2866404435,484,2866404919,2876190706
2025-06-19 01:09:14,REAL,2866404919,481,2866405400,2876191187
2025-06-19 01:09:16,FAKE,2866405400,243,2866405643,2876191670
2025-06-19 01:09:18,FAKE,2866405643,244,2866405887,2876192149
2025-06-19 01:09:20,REAL,2866405887,491,2866406378,2876192640
2025-06-19 01:09:22,REAL,2866406378,485,2866406863,2876193125
2025-06-19 01:09:24,REAL,2866406863,491,2866407354,2876193616
2025-06-19 01:09:26,REAL,2866407354,488,2866407842,2876194104
2025-06-19 01:09:28,REAL,2866407842,485,2866408327,2876194589
2025-06-19 01:09:30,FAKE,2866408327,243,2866408570,2876195126
2025-06-19 01:09:32,REAL,2866408570,489,2866409059,2876195615
2025-06-19 01:09:34,FAKE,2866409059,238,2866409297,2876196096
2025-06-19 01:09:36,FAKE,2866409297,241,2866409538,2876196578
2025-06-19 01:09:38,FAKE,2866409538,241,2866409779,2876197061
2025-06-19 01:09:40,FAKE,2866409779,244,2866410023,2876197549
2025-06-19 01:09:42,REAL,2866410023,545,2866410568,2876198094
2025-06-19 01:09:44,FAKE,2866410568,244,2866410812,2876199253
2025-06-19 01:09:46,FAKE,2866410812,243,2866411055,2876211017
2025-06-19 01:09:48,REAL,2866411055,10251,2866421306,2876221268
2025-06-19 01:09:50,REAL,2866421306,10252,2866431558,2876231520
2025-06-19 01:09:52,REAL,2866431558,10316,2866441874,2876241836
2025-06-19 01:09:54,FAKE,2866441874,243,2866442117,2876252082
2025-06-19 01:09:56,FAKE,2866442117,243,2866442360,2876262330
2025-06-19 01:09:58,REAL,2866442360,10318,2866452678,2876272648
2025-06-19 01:10:00,FAKE,2866452678,238,2866452916,2876277285
2025-06-19 01:10:02,REAL,2866452916,484,2866453400,2876277769
2025-06-19 01:10:04,REAL,2866453400,482,2866453882,2876278251
2025-06-19 01:10:06,REAL,2866453882,544,2866454426,2876278795
2025-06-19 01:10:08,REAL,2866454426,482,2866454908,2876279277
2025-06-19 01:10:10,REAL,2866454908,486,2866455394,2876279763
2025-06-19 01:10:12,REAL,2866455394,489,2866455883,2876280252
2025-06-19 01:10:14,REAL,2866455883,481,2866456364,2876280733
2025-06-19 01:10:16,REAL,2866456364,487,2866456851,2876281220
2025-06-19 01:10:18,FAKE,2866456851,241,2866457092,2876281701
2025-06-19 01:10:20,REAL,2866457092,489,2866457581,2876282190
2025-06-19 01:10:22,FAKE,2866457581,243,2866457824,2876282676
2025-06-19 01:10:24,FAKE,2866457824,241,2866458065,2876283162
2025-06-19 01:10:26,REAL,2866458065,491,2866458556,2876283653
2025-06-19 01:10:28,FAKE,2866458556,244,2866458800,2876284141
2025-06-19 01:10:30,FAKE,2866458800,243,2866459043,2876284629
2025-06-19 01:10:32,REAL,2866459043,541,2866459584,2876285170
2025-06-19 01:10:34,REAL,2866459584,486,2866460070,2876285656
2025-06-19 01:10:36,REAL,2866460070,490,2866460560,2876286146
2025-06-19 01:10:38,REAL,2866460560,8276,2866468836,2876294422
2025-06-19 01:10:40,FAKE,2866468836,241,2866469077,2876305266
2025-06-19 01:10:42,FAKE,2866469077,241,2866469318,2876315576
2025-06-19 01:10:44,REAL,2866469318,10261,2866479579,2876325837
2025-06-19 01:10:46,REAL,2866479579,10257,2866489836,2876336094
2025-06-19 01:10:48,REAL,2866489836,10315,2866500151,2876346409
2025-06-19 01:10:50,FAKE,2866500151,243,2866500394,2876356715
2025-06-19 01:10:52,REAL,2866500394,8736,2866509130,2876365451
2025-06-19 01:10:54,REAL,2866509130,488,2866509618,2876365939
2025-06-19 01:10:56,REAL,2866509618,489,2866510107,2876366428
2025-06-19 01:10:58,FAKE,2866510107,238,2866510345,2876366909
2025-06-19 01:11:00,FAKE,2866510345,243,2866510588,2876367394
2025-06-19 01:11:02,REAL,2866510588,481,2866511069,2876367875
2025-06-19 01:11:04,REAL,2866511069,485,2866511554,2876368360
2025-06-19 01:11:06,FAKE,2866511554,241,2866511795,2876368837
2025-06-19 01:11:08,REAL,2866511795,474,2866512269,2876369311
2025-06-19 01:11:10,FAKE,2866512269,241,2866512510,2876369788
2025-06-19 01:11:12,REAL,2866512510,490,2866513000,2876370278
2025-06-19 01:11:14,REAL,2866513000,489,2866513489,2876370767
2025-06-19 01:11:16,REAL,2866513489,484,2866513973,2876371251
2025-06-19 01:11:18,REAL,2866513973,490,2866514463,2876371741
2025-06-19 01:11:20,FAKE,2866514463,243,2866514706,2876372223
2025-06-19 01:11:22,REAL,2866514706,485,2866515191,2876372708
2025-06-19 01:11:24,REAL,2866515191,483,2866515674,2876373191
2025-06-19 01:11:26,REAL,2866515674,537,2866516211,2876373728
2025-06-19 01:11:28,REAL,2866516211,488,2866516699,2876374216
2025-06-19 01:11:30,FAKE,2866516699,241,2866516940,2876374694
2025-06-19 01:11:32,REAL,2866516940,539,2866517479,2876375233
2025-06-19 01:11:34,FAKE,2866517479,243,2866517722,2876375723
2025-06-19 01:11:36,REAL,2866517722,474,2866518196,2876376197
2025-06-19 01:11:38,FAKE,2866518196,238,2866518434,2876376672
2025-06-19 01:11:40,FAKE,2866518434,238,2866518672,2876377159
2025-06-19 01:11:42,FAKE,2866518672,243,2866518915,2876377641
2025-06-19 01:11:44,REAL,2866518915,488,2866519403,2876378129
2025-06-19 01:11:46,REAL,2866519403,481,2866519884,2876378610
2025-06-19 01:11:48,REAL,2866519884,488,2866520372,2876379098
2025-06-19 01:11:50,FAKE,2866520372,241,2866520613,2876379591
2025-06-19 01:11:52,REAL,2866520613,487,2866521100,2876380078
2025-06-19 01:11:54,REAL,2866521100,476,2866521576,2876380554
2025-06-19 01:11:56,REAL,2866521576,489,2866522065,2876381043
2025-06-19 01:11:58,REAL,2866522065,486,2866522551,2876381529
2025-06-19 01:12:00,REAL,2866522551,478,2866523029,2876382007
2025-06-19 01:12:02,REAL,2866523029,479,2866523508,2876382486
2025-06-19 01:12:04,FAKE,2866523508,241,2866523749,2876382973
2025-06-19 01:12:06,FAKE,2866523749,244,2866523993,2876383461
2025-06-19 01:12:08,REAL,2866523993,478,2866524471,2876383939
2025-06-19 01:12:10,REAL,2866524471,478,2866524949,2876384417
2025-06-19 01:12:12,REAL,2866524949,479,2866525428,2876384896
2025-06-19 01:12:14,FAKE,2866525428,241,2866525669,2876385380
2025-06-19 01:12:16,FAKE,2866525669,243,2866525912,2876385982
2025-06-19 01:12:18,REAL,2866525912,4649,2866530561,2876390631
2025-06-19 01:12:20,FAKE,2866530561,243,2866530804,2876402472
2025-06-19 01:12:22,FAKE,2866530804,238,2866531042,2876412726
2025-06-19 01:12:24,REAL,2866531042,10315,2866541357,2876423041
2025-06-19 01:12:26,REAL,2866541357,10256,2866551613,2876433297
2025-06-19 01:12:28,REAL,2866551613,10321,2866561934,2876443618
2025-06-19 01:12:30,FAKE,2866561934,244,2866562178,2876453870
2025-06-19 01:12:32,REAL,2866562178,10256,2866572434,2876464126
2025-06-19 01:12:34,REAL,2866572434,1932,2866574366,2876466058
2025-06-19 01:12:36,REAL,2866574366,484,2866574850,2876466542
2025-06-19 01:12:38,REAL,2866574850,479,2866575329,2876467021
2025-06-19 01:12:40,REAL,2866575329,490,2866575819,2876467511
2025-06-19 01:12:42,FAKE,2866575819,241,2866576060,2876467990
2025-06-19 01:12:44,REAL,2866576060,485,2866576545,2876468475
2025-06-19 01:12:46,FAKE,2866576545,241,2866576786,2876468961
2025-06-19 01:12:48,REAL,2866576786,487,2866577273,2876469448
2025-06-19 01:12:50,REAL,2866577273,5380,2866582653,2876474828
2025-06-19 01:12:52,REAL,2866582653,11108,2866593761,2876485936
2025-06-19 01:12:54,REAL,2866593761,10257,2866604018,2876496193
2025-06-19 01:12:56,REAL,2866604018,10319,2866614337,2876506512
2025-06-19 01:12:58,FAKE,2866614337,243,2866614580,2876516810
2025-06-19 01:13:00,REAL,2866614580,10316,2866624896,2876527126
2025-06-19 01:13:02,FAKE,2866624896,244,2866625140,2876537440
2025-06-19 01:13:04,REAL,2866625140,10245,2866635385,2876547685
2025-06-19 01:13:06,FAKE,2866635385,243,2866635628,2876548958
2025-06-19 01:13:08,REAL,2866635628,486,2866636114,2876549444
2025-06-19 01:13:10,REAL,2866636114,475,2866636589,2876549919
2025-06-19 01:13:12,FAKE,2866636589,244,2866636833,2876550402
2025-06-19 01:13:14,FAKE,2866636833,244,2866637077,2876550889
2025-06-19 01:13:16,FAKE,2866637077,244,2866637321,2876551374
2025-06-19 01:13:18,FAKE,2866637321,244,2866637565,2876551855
2025-06-19 01:13:20,FAKE,2866637565,238,2866637803,2876552338
2025-06-19 01:13:22,REAL,2866637803,5904,2866643707,2876558242
2025-06-19 01:13:24,REAL,2866643707,11310,2866655017,2876569552
2025-06-19 01:13:26,FAKE,2866655017,241,2866655258,2876579802
2025-06-19 01:13:28,FAKE,2866655258,241,2866655499,2876590052
2025-06-19 01:13:30,REAL,2866655499,10250,2866665749,2876600302
2025-06-19 01:13:32,REAL,2866665749,10247,2866675996,2876610549
2025-06-19 01:13:34,FAKE,2866675996,238,2866676234,2876620803
2025-06-19 01:13:36,REAL,2866676234,10320,2866686554,2876631123
2025-06-19 01:13:38,REAL,2866686554,616,2866687170,2876631739
2025-06-19 01:13:40,REAL,2866687170,487,2866687657,2876632226
2025-06-19 01:13:42,REAL,2866687657,536,2866688193,2876632762
2025-06-19 01:13:44,REAL,2866688193,481,2866688674,2876633243
2025-06-19 01:13:46,REAL,2866688674,479,2866689153,2876633722
2025-06-19 01:13:48,REAL,2866689153,482,2866689635,2876634204
2025-06-19 01:13:50,REAL,2866689635,480,2866690115,2876634684
2025-06-19 01:13:52,FAKE,2866690115,241,2866690356,2876635166
2025-06-19 01:13:54,REAL,2866690356,491,2866690847,2876635657
2025-06-19 01:13:56,REAL,2866690847,478,2866691325,2876636135
2025-06-19 01:13:58,REAL,2866691325,488,2866691813,2876636623
2025-06-19 01:14:00,FAKE,2866691813,243,2866692056,2876637105
2025-06-19 01:14:02,FAKE,2866692056,243,2866692299,2876637588
2025-06-19 01:14:04,REAL,2866692299,484,2866692783,2876638072
2025-06-19 01:14:06,FAKE,2866692783,243,2866693026,2876638558
2025-06-19 01:14:08,REAL,2866693026,483,2866693509,2876639041
2025-06-19 01:14:10,REAL,2866693509,475,2866693984,2876639516
2025-06-19 01:14:12,FAKE,2866693984,241,2866694225,2876640054
2025-06-19 01:14:14,REAL,2866694225,483,2866694708,2876640537
2025-06-19 01:14:16,REAL,2866694708,483,2866695191,2876641020
2025-06-19 01:14:18,FAKE,2866695191,243,2866695434,2876641501
2025-06-19 01:14:20,REAL,2866695434,483,2866695917,2876641984
2025-06-19 01:14:22,REAL,2866695917,482,2866696399,2876642466
2025-06-19 01:14:24,REAL,2866696399,480,2866696879,2876642946
2025-06-19 01:14:26,REAL,2866696879,538,2866697417,2876643484
2025-06-19 01:14:28,FAKE,2866697417,241,2866697658,2876643970
2025-06-19 01:14:30,FAKE,2866697658,238,2866697896,2876644451
2025-06-19 01:14:32,REAL,2866697896,483,2866698379,2876644934
2025-06-19 01:14:34,REAL,2866698379,488,2866698867,2876645422
2025-06-19 01:14:36,REAL,2866698867,491,2866699358,2876645913
2025-06-19 01:14:38,REAL,2866699358,481,2866699839,2876646394
2025-06-19 01:14:40,REAL,2866699839,493,2866700332,2876646887
2025-06-19 01:14:42,REAL,2866700332,490,2866700822,2876647377
2025-06-19 01:14:44,REAL,2866700822,483,2866701305,2876647860
2025-06-19 01:14:46,REAL,2866701305,475,2866701780,2876648335
2025-06-19 01:14:48,REAL,2866701780,480,2866702260,2876648815
2025-06-19 01:14:50,REAL,2866702260,484,2866702744,2876649299
2025-06-19 01:14:52,REAL,2866702744,481,2866703225,2876649780
2025-06-19 01:14:54,REAL,2866703225,482,2866703707,2876650262
2025-06-19 01:14:56,FAKE,2866703707,244,2866703951,2876650750
2025-06-19 01:14:58,REAL,2866703951,8261,2866712212,2876659011
2025-06-19 01:15:00,FAKE,2866712212,241,2866712453,2876669848
2025-06-19 01:15:02,REAL,2866712453,10318,2866722771,2876680166
2025-06-19 01:15:04,REAL,2866722771,10251,2866733022,2876690417
2025-06-19 01:15:06,FAKE,2866733022,243,2866733265,2876700673
2025-06-19 01:15:08,REAL,2866733265,10302,2866743567,2876710975
2025-06-19 01:15:10,REAL,2866743567,10319,2866753886,2876721294
2025-06-19 01:15:12,FAKE,2866753886,244,2866754130,2876729832
2025-06-19 01:15:14,REAL,2866754130,489,2866754619,2876730321
2025-06-19 01:15:16,REAL,2866754619,484,2866755103,2876730805
2025-06-19 01:15:18,REAL,2866755103,489,2866755592,2876731294
2025-06-19 01:15:20,REAL,2866755592,486,2866756078,2876731780
2025-06-19 01:15:22,REAL,2866756078,477,2866756555,2876732257
2025-06-19 01:15:24,REAL,2866756555,476,2866757031,2876732733
2025-06-19 01:15:26,FAKE,2866757031,243,2866757274,2876733207
2025-06-19 01:15:28,REAL,2866757274,478,2866757752,2876733685
2025-06-19 01:15:30,REAL,2866757752,8877,2866766629,2876742562
2025-06-19 01:15:32,REAL,2866766629,10141,2866776770,2876752703
2025-06-19 01:15:34,REAL,2866776770,10251,2866787021,2876762954
2025-06-19 01:15:36,REAL,2866787021,10313,2866797334,2876773267
2025-06-19 01:15:38,REAL,2866797334,10251,2866807585,2876783518
2025-06-19 01:15:40,REAL,2866807585,10254,2866817839,2876793772
2025-06-19 01:15:42,REAL,2866817839,10313,2866828152,2876804085
2025-06-19 01:15:44,REAL,2866828152,7876,2866836028,2876811961
2025-06-19 01:15:46,FAKE,2866836028,238,2866836266,2876812500
2025-06-19 01:15:48,REAL,2866836266,482,2866836748,2876812982
2025-06-19 01:15:50,FAKE,2866836748,244,2866836992,2876813467
2025-06-19 01:15:52,FAKE,2866836992,244,2866837236,2876813946
2025-06-19 01:15:54,REAL,2866837236,484,2866837720,2876814430
2025-06-19 01:15:56,REAL,2866837720,487,2866838207,2876814917
2025-06-19 01:15:58,FAKE,2866838207,243,2866838450,2876815399
2025-06-19 01:16:00,REAL,2866838450,492,2866838942,2876815891
2025-06-19 01:16:02,FAKE,2866838942,238,2866839180,2876825883
2025-06-19 01:16:04,FAKE,2866839180,241,2866839421,2876836469
2025-06-19 01:16:06,FAKE,2866839421,243,2866839664,2876846717
2025-06-19 01:16:08,REAL,2866839664,10258,2866849922,2876856975
2025-06-19 01:16:10,FAKE,2866849922,244,2866850166,2876867229
2025-06-19 01:16:12,REAL,2866850166,10253,2866860419,2876877482
2025-06-19 01:16:14,REAL,2866860419,10317,2866870736,2876887799
2025-06-19 01:16:16,FAKE,2866870736,238,2866870974,2876895082
2025-06-19 01:16:18,FAKE,2866870974,241,2866871215,2876895568
2025-06-19 01:16:20,REAL,2866871215,477,2866871692,2876896045
2025-06-19 01:16:22,REAL,2866871692,482,2866872174,2876896527
2025-06-19 01:16:24,REAL,2866872174,539,2866872713,2876897066
2025-06-19 01:16:26,FAKE,2866872713,238,2866872951,2876897550
2025-06-19 01:16:28,REAL,2866872951,491,2866873442,2876898041
2025-06-19 01:16:30,REAL,2866873442,479,2866873921,2876898520
2025-06-19 01:16:32,REAL,2866873921,485,2866874406,2876899005
2025-06-19 01:16:34,REAL,2866874406,482,2866874888,2876899487
2025-06-19 01:16:36,FAKE,2866874888,238,2866875126,2876899964
2025-06-19 01:16:38,REAL,2866875126,481,2866875607,2876900445
2025-06-19 01:16:40,FAKE,2866875607,244,2866875851,2876900924
2025-06-19 01:16:42,REAL,2866875851,488,2866876339,2876901412
2025-06-19 01:16:44,REAL,2866876339,479,2866876818,2876901891
2025-06-19 01:16:46,FAKE,2866876818,241,2866877059,2876902428
2025-06-19 01:16:48,REAL,2866877059,482,2866877541,2876902910
2025-06-19 01:16:50,REAL,2866877541,474,2866878015,2876903384
2025-06-19 01:16:52,REAL,2866878015,488,2866878503,2876903872
2025-06-19 01:16:54,FAKE,2866878503,243,2866878746,2876904359
2025-06-19 01:16:56,REAL,2866878746,482,2866879228,2876904841
2025-06-19 01:16:58,REAL,2866879228,480,2866879708,2876905321
2025-06-19 01:17:00,FAKE,2866879708,243,2866879951,2876905861
2025-06-19 01:17:02,REAL,2866879951,484,2866880435,2876906345
2025-06-19 01:17:04,FAKE,2866880435,243,2866880678,2876906835
2025-06-19 01:17:06,REAL,2866880678,483,2866881161,2876907318
2025-06-19 01:17:08,FAKE,2866881161,243,2866881404,2876907806
2025-06-19 01:17:10,REAL,2866881404,478,2866881882,2876908284
2025-06-19 01:17:12,REAL,2866881882,482,2866882364,2876908766
2025-06-19 01:17:14,REAL,2866882364,490,2866882854,2876909256
2025-06-19 01:17:16,REAL,2866882854,480,2866883334,2876909736
2025-06-19 01:17:18,REAL,2866883334,481,2866883815,2876910217
2025-06-19 01:17:20,FAKE,2866883815,238,2866884053,2876910708
2025-06-19 01:17:22,FAKE,2866884053,241,2866884294,2876922156
2025-06-19 01:17:24,FAKE,2866884294,243,2866884537,2876932473
2025-06-19 01:17:26,REAL,2866884537,10243,2866894780,2876942716
2025-06-19 01:17:28,REAL,2866894780,10309,2866905089,2876953025
2025-06-19 01:17:30,REAL,2866905089,10245,2866915334,2876963270
2025-06-19 01:17:32,FAKE,2866915334,244,2866915578,2876973518
2025-06-19 01:17:34,FAKE,2866915578,241,2866915819,2876983774
2025-06-19 01:17:36,REAL,2866915819,5764,2866921583,2876989538
2025-06-19 01:17:38,REAL,2866921583,475,2866922058,2876990013
2025-06-19 01:17:40,FAKE,2866922058,243,2866922301,2876990557
2025-06-19 01:17:42,FAKE,2866922301,243,2866922544,2876991041
2025-06-19 01:17:44,REAL,2866922544,490,2866923034,2876991531
2025-06-19 01:17:46,REAL,2866923034,487,2866923521,2876992018
2025-06-19 01:17:48,REAL,2866923521,483,2866924004,2876992501
2025-06-19 01:17:50,REAL,2866924004,476,2866924480,2876992977
2025-06-19 01:17:52,FAKE,2866924480,243,2866924723,2876993463
2025-06-19 01:17:54,REAL,2866924723,12367,2866937090,2877005830
2025-06-19 01:17:56,REAL,2866937090,10247,2866947337,2877016077
2025-06-19 01:17:58,REAL,2866947337,10247,2866957584,2877026324
2025-06-19 01:18:00,FAKE,2866957584,238,2866957822,2877036577
2025-06-19 01:18:02,FAKE,2866957822,238,2866958060,2877046897
2025-06-19 01:18:04,REAL,2866958060,10256,2866968316,2877057153
2025-06-19 01:18:06,REAL,2866968316,10248,2866978564,2877067401
2025-06-19 01:18:08,REAL,2866978564,5168,2866983732,2877072569
2025-06-19 01:18:10,REAL,2866983732,484,2866984216,2877073053
2025-06-19 01:18:12,REAL,2866984216,480,2866984696,2877073533
2025-06-19 01:18:14,REAL,2866984696,481,2866985177,2877074014
2025-06-19 01:18:16,FAKE,2866985177,243,2866985420,2877074506
2025-06-19 01:18:18,REAL,2866985420,534,2866985954,2877075040
2025-06-19 01:18:20,REAL,2866985954,488,2866986442,2877075528
2025-06-19 01:18:22,REAL,2866986442,494,2866986936,2877076022
2025-06-19 01:18:24,FAKE,2866986936,243,2866987179,2877076506
2025-06-19 01:18:26,REAL,2866987179,480,2866987659,2877076986
2025-06-19 01:18:28,REAL,2866987659,482,2866988141,2877077468
2025-06-19 01:18:30,REAL,2866988141,483,2866988624,2877077951
2025-06-19 01:18:32,REAL,2866988624,481,2866989105,2877078432
2025-06-19 01:18:34,REAL,2866989105,478,2866989583,2877078910
2025-06-19 01:18:36,REAL,2866989583,480,2866990063,2877079390
2025-06-19 01:18:38,REAL,2866990063,538,2866990601,2877079928
2025-06-19 01:18:40,REAL,2866990601,477,2866991078,2877080405
2025-06-19 01:18:42,FAKE,2866991078,243,2866991321,2877080895
2025-06-19 01:18:44,REAL,2866991321,489,2866991810,2877081384
2025-06-19 01:18:46,REAL,2866991810,7622,2866999432,2877089006
2025-06-19 01:18:48,REAL,2866999432,11043,2867010475,2877100049
2025-06-19 01:18:50,REAL,2867010475,10325,2867020800,2877110374
2025-06-19 01:18:52,FAKE,2867020800,238,2867021038,2877120625
2025-06-19 01:18:54,REAL,2867021038,10246,2867031284,2877130871
2025-06-19 01:18:56,REAL,2867031284,10327,2867041611,2877141198
2025-06-19 01:18:58,REAL,2867041611,10299,2867051910,2877151497
2025-06-19 01:19:00,REAL,2867051910,9063,2867060973,2877160560
2025-06-19 01:19:02,REAL,2867060973,484,2867061457,2877161044
2025-06-19 01:19:04,REAL,2867061457,482,2867061939,2877161526
2025-06-19 01:19:06,REAL,2867061939,489,2867062428,2877162015
2025-06-19 01:19:08,REAL,2867062428,482,2867062910,2877162497
2025-06-19 01:19:10,FAKE,2867062910,241,2867063151,2877162981
2025-06-19 01:19:12,REAL,2867063151,490,2867063641,2877163471
2025-06-19 01:19:14,REAL,2867063641,482,2867064123,2877163953
2025-06-19 01:19:16,REAL,2867064123,485,2867064608,2877164438
2025-06-19 01:19:18,REAL,2867064608,481,2867065089,2877164919
2025-06-19 01:19:20,REAL,2867065089,477,2867065566,2877165396
2025-06-19 01:19:22,REAL,2867065566,490,2867066056,2877165886
2025-06-19 01:19:24,REAL,2867066056,478,2867066534,2877166364
2025-06-19 01:19:26,FAKE,2867066534,244,2867066778,2877166846
2025-06-19 01:19:28,REAL,2867066778,490,2867067268,2877167336
2025-06-19 01:19:30,REAL,2867067268,547,2867067815,2877167883
2025-06-19 01:19:32,REAL,2867067815,490,2867068305,2877168373
2025-06-19 01:19:34,REAL,2867068305,481,2867068786,2877168854
2025-06-19 01:19:36,REAL,2867068786,537,2867069323,2877169391
2025-06-19 01:19:38,FAKE,2867069323,241,2867069564,2877169875
2025-06-19 01:19:40,REAL,2867069564,488,2867070052,2877170363
2025-06-19 01:19:42,REAL,2867070052,481,2867070533,2877170844
2025-06-19 01:19:44,FAKE,2867070533,238,2867070771,2877171320
2025-06-19 01:19:46,FAKE,2867070771,238,2867071009,2877171804
2025-06-19 01:19:48,REAL,2867071009,487,2867071496,2877172291
2025-06-19 01:19:50,FAKE,2867071496,243,2867071739,2877181690
2025-06-19 01:19:52,REAL,2867071739,10795,2867082534,2877192485
2025-06-19 01:19:54,REAL,2867082534,10245,2867092779,2877202730
2025-06-19 01:19:56,REAL,2867092779,10247,2867103026,2877212977
2025-06-19 01:19:58,FAKE,2867103026,238,2867103264,2877223297
2025-06-19 01:20:00,FAKE,2867103264,243,2867103507,2877233540
2025-06-19 01:20:02,REAL,2867103507,10245,2867113752,2877243785
2025-06-19 01:20:04,REAL,2867113752,7804,2867121556,2877251589
2025-06-19 01:20:06,REAL,2867121556,483,2867122039,2877252072
2025-06-19 01:20:08,REAL,2867122039,491,2867122530,2877252563
2025-06-19 01:20:10,REAL,2867122530,3858,2867126388,2877256421
2025-06-19 01:20:12,REAL,2867126388,11586,2867137974,2877268007
2025-06-19 01:20:14,REAL,2867137974,10306,2867148280,2877278313
2025-06-19 01:20:16,FAKE,2867148280,238,2867148518,2877288637
2025-06-19 01:20:18,REAL,2867148518,10251,2867158769,2877298888
2025-06-19 01:20:20,FAKE,2867158769,243,2867159012,2877309145
2025-06-19 01:20:22,REAL,2867159012,10315,2867169327,2877319460
2025-06-19 01:20:24,REAL,2867169327,10255,2867179582,2877329715
2025-06-19 01:20:26,REAL,2867179582,2598,2867182180,2877332313
2025-06-19 01:20:28,REAL,2867182180,484,2867182664,2877332797
2025-06-19 01:20:30,REAL,2867182664,488,2867183152,2877333285
2025-06-19 01:20:32,FAKE,2867183152,243,2867183395,2877333777
2025-06-19 01:20:34,REAL,2867183395,489,2867183884,2877334266
2025-06-19 01:20:36,REAL,2867183884,489,2867184373,2877334755
2025-06-19 01:20:38,FAKE,2867184373,238,2867184611,2877335244
2025-06-19 01:20:40,FAKE,2867184611,243,2867184854,2877335721
2025-06-19 01:20:42,FAKE,2867184854,244,2867185098,2877340434
2025-06-19 01:20:44,REAL,2867185098,14692,2867199790,2877355126
2025-06-19 01:20:46,REAL,2867199790,10252,2867210042,2877365378
2025-06-19 01:20:48,FAKE,2867210042,238,2867210280,2877375705
2025-06-19 01:20:50,REAL,2867210280,10310,2867220590,2877386015
2025-06-19 01:20:52,REAL,2867220590,10312,2867230902,2877396327
2025-06-19 01:20:54,REAL,2867230902,10249,2867241151,2877406576
2025-06-19 01:20:56,REAL,2867241151,10324,2867251475,2877416900
2025-06-19 01:20:58,REAL,2867251475,1937,2867253412,2877418837
2025-06-19 01:21:00,REAL,2867253412,475,2867253887,2877419312
2025-06-19 01:21:02,FAKE,2867253887,243,2867254130,2877419804
2025-06-19 01:21:04,REAL,2867254130,487,2867254617,2877420291
2025-06-19 01:21:06,REAL,2867254617,475,2867255092,2877420766
2025-06-19 01:21:08,REAL,2867255092,485,2867255577,2877421251
2025-06-19 01:21:10,REAL,2867255577,489,2867256066,2877421740
2025-06-19 01:21:12,FAKE,2867256066,241,2867256307,2877422227
2025-06-19 01:21:14,FAKE,2867256307,244,2867256551,2877427530
2025-06-19 01:21:16,REAL,2867256551,11384,2867267935,2877438914
2025-06-19 01:21:18,REAL,2867267935,10246,2867278181,2877449160
2025-06-19 01:21:20,FAKE,2867278181,244,2867278425,2877459406
2025-06-19 01:21:22,REAL,2867278425,10322,2867288747,2877469728
2025-06-19 01:21:24,REAL,2867288747,10252,2867298999,2877479980
2025-06-19 01:21:26,REAL,2867298999,10316,2867309315,2877490296
2025-06-19 01:21:28,FAKE,2867309315,244,2867309559,2877500615
2025-06-19 01:21:30,REAL,2867309559,1286,2867310845,2877501901
2025-06-19 01:21:32,FAKE,2867310845,244,2867311089,2877502384
2025-06-19 01:21:34,REAL,2867311089,487,2867311576,2877502871
2025-06-19 01:21:36,REAL,2867311576,481,2867312057,2877503352
2025-06-19 01:21:38,REAL,2867312057,486,2867312543,2877503838
2025-06-19 01:21:40,FAKE,2867312543,241,2867312784,2877504321
2025-06-19 01:21:42,FAKE,2867312784,244,2867313028,2877504809
2025-06-19 01:21:44,REAL,2867313028,492,2867313520,2877505301
2025-06-19 01:21:46,REAL,2867313520,5773,2867319293,2877511074
2025-06-19 01:21:48,REAL,2867319293,10990,2867330283,2877522064
2025-06-19 01:21:50,REAL,2867330283,10317,2867340600,2877532381
2025-06-19 01:21:52,REAL,2867340600,10251,2867350851,2877542632
2025-06-19 01:21:54,REAL,2867350851,10257,2867361108,2877552889
2025-06-19 01:21:56,REAL,2867361108,10319,2867371427,2877563208
2025-06-19 01:21:58,FAKE,2867371427,243,2867371670,2877573463
2025-06-19 01:22:00,REAL,2867371670,10320,2867381990,2877583783
2025-06-19 01:22:02,FAKE,2867381990,243,2867382233,2877584463
2025-06-19 01:22:04,REAL,2867382233,538,2867382771,2877585001
2025-06-19 01:22:06,FAKE,2867382771,238,2867383009,2877585475
2025-06-19 01:22:08,REAL,2867383009,477,2867383486,2877585952
2025-06-19 01:22:10,FAKE,2867383486,243,2867383729,2877586440
2025-06-19 01:22:12,REAL,2867383729,484,2867384213,2877586924
2025-06-19 01:22:14,REAL,2867384213,485,2867384698,2877587409
2025-06-19 01:22:16,FAKE,2867384698,238,2867384936,2877587896
2025-06-19 01:22:18,FAKE,2867384936,238,2867385174,2877595055
2025-06-19 01:22:20,REAL,2867385174,10778,2867395952,2877605833
2025-06-19 01:22:22,REAL,2867395952,10321,2867406273,2877616154
2025-06-19 01:22:24,REAL,2867406273,10253,2867416526,2877626407
2025-06-19 01:22:26,REAL,2867416526,10246,2867426772,2877636653
2025-06-19 01:22:28,REAL,2867426772,10253,2867437025,2877646906
2025-06-19 01:22:30,REAL,2867437025,10314,2867447339,2877657220
2025-06-19 01:22:32,REAL,2867447339,9792,2867457131,2877667012
2025-06-19 01:22:34,REAL,2867457131,481,2867457612,2877667493
2025-06-19 01:22:36,REAL,2867457612,478,2867458090,2877667971
2025-06-19 01:22:38,REAL,2867458090,482,2867458572,2877668453
2025-06-19 01:22:40,REAL,2867458572,533,2867459105,2877668986
2025-06-19 01:22:42,REAL,2867459105,480,2867459585,2877669466
2025-06-19 01:22:44,REAL,2867459585,480,2867460065,2877669946
2025-06-19 01:22:46,FAKE,2867460065,244,2867460309,2877670424
2025-06-19 01:22:48,REAL,2867460309,476,2867460785,2877670900
2025-06-19 01:22:50,REAL,2867460785,7618,2867468403,2877678518
2025-06-19 01:22:52,FAKE,2867468403,238,2867468641,2877689296
2025-06-19 01:22:54,REAL,2867468641,10251,2867478892,2877699547
2025-06-19 01:22:56,REAL,2867478892,10318,2867489210,2877709865
2025-06-19 01:22:58,REAL,2867489210,10254,2867499464,2877720119
2025-06-19 01:23:00,REAL,2867499464,10247,2867509711,2877730366
2025-06-19 01:23:02,REAL,2867509711,10252,2867519963,2877740618
2025-06-19 01:23:04,REAL,2867519963,9196,2867529159,2877749814
2025-06-19 01:23:06,FAKE,2867529159,241,2867529400,2877750291
2025-06-19 01:23:08,FAKE,2867529400,238,2867529638,2877750779
2025-06-19 01:23:10,REAL,2867529638,481,2867530119,2877751260
2025-06-19 01:23:12,REAL,2867530119,476,2867530595,2877751736
2025-06-19 01:23:14,REAL,2867530595,481,2867531076,2877752217
2025-06-19 01:23:16,REAL,2867531076,488,2867531564,2877752705
2025-06-19 01:23:18,REAL,2867531564,543,2867532107,2877753248
2025-06-19 01:23:20,REAL,2867532107,478,2867532585,2877753726
2025-06-19 01:23:22,REAL,2867532585,8486,2867541071,2877762212
2025-06-19 01:23:24,FAKE,2867541071,241,2867541312,2877772928
2025-06-19 01:23:26,FAKE,2867541312,244,2867541556,2877783243
2025-06-19 01:23:28,REAL,2867541556,10251,2867551807,2877793494
2025-06-19 01:23:30,FAKE,2867551807,244,2867552051,2877803741
2025-06-19 01:23:32,REAL,2867552051,10317,2867562368,2877814058
2025-06-19 01:23:34,REAL,2867562368,10256,2867572624,2877824314
2025-06-19 01:23:36,REAL,2867572624,8609,2867581233,2877832923
2025-06-19 01:23:38,REAL,2867581233,488,2867581721,2877833411
2025-06-19 01:23:40,REAL,2867581721,477,2867582198,2877833888
2025-06-19 01:23:42,REAL,2867582198,485,2867582683,2877834373
2025-06-19 01:23:44,REAL,2867582683,474,2867583157,2877834847
2025-06-19 01:23:46,REAL,2867583157,486,2867583643,2877835333
2025-06-19 01:23:48,REAL,2867583643,487,2867584130,2877835820
2025-06-19 01:23:50,FAKE,2867584130,238,2867584368,2877836314
2025-06-19 01:23:52,FAKE,2867584368,238,2867584606,2877836793
2025-06-19 01:23:54,REAL,2867584606,9603,2867594209,2877846396
2025-06-19 01:23:56,FAKE,2867594209,241,2867594450,2877857113
2025-06-19 01:23:58,REAL,2867594450,10256,2867604706,2877867369
2025-06-19 01:24:00,FAKE,2867604706,243,2867604949,2877877618
2025-06-19 01:24:02,REAL,2867604949,10260,2867615209,2877887878
2025-06-19 01:24:04,REAL,2867615209,10321,2867625530,2877898199
2025-06-19 01:24:06,REAL,2867625530,10258,2867635788,2877908457
2025-06-19 01:24:08,REAL,2867635788,8016,2867643804,2877916473
2025-06-19 01:24:10,FAKE,2867643804,241,2867644045,2877916953
2025-06-19 01:24:12,FAKE,2867644045,244,2867644289,2877917442
2025-06-19 01:24:14,FAKE,2867644289,244,2867644533,2877917928
2025-06-19 01:24:16,REAL,2867644533,493,2867645026,2877918421
2025-06-19 01:24:18,FAKE,2867645026,241,2867645267,2877918906
2025-06-19 01:24:20,FAKE,2867645267,244,2867645511,2877919395
2025-06-19 01:24:22,FAKE,2867645511,244,2867645755,2877919888
2025-06-19 01:24:24,FAKE,2867645755,244,2867645999,2877920367
2025-06-19 01:24:26,REAL,2867645999,10536,2867656535,2877930903
2025-06-19 01:24:28,REAL,2867656535,10583,2867667118,2877941486
2025-06-19 01:24:30,REAL,2867667118,10313,2867677431,2877951799
2025-06-19 01:24:32,REAL,2867677431,10253,2867687684,2877962052
2025-06-19 01:24:34,REAL,2867687684,10323,2867698007,2877972375
2025-06-19 01:24:36,FAKE,2867698007,238,2867698245,2877982625
2025-06-19 01:24:38,REAL,2867698245,10322,2867708567,2877992947
2025-06-19 01:24:40,REAL,2867708567,7346,2867715913,2878000293
2025-06-19 01:24:42,FAKE,2867715913,244,2867716157,2878000775
2025-06-19 01:24:44,REAL,2867716157,479,2867716636,2878001254
2025-06-19 01:24:46,REAL,2867716636,486,2867717122,2878001740
2025-06-19 01:24:48,REAL,2867717122,483,2867717605,2878002223
2025-06-19 01:24:50,REAL,2867717605,488,2867718093,2878002711
2025-06-19 01:24:52,REAL,2867718093,482,2867718575,2878003193
2025-06-19 01:24:54,REAL,2867718575,475,2867719050,2878003668
2025-06-19 01:24:56,REAL,2867719050,485,2867719535,2878004153
2025-06-19 01:24:58,REAL,2867719535,10728,2867730263,2878014881
2025-06-19 01:25:00,FAKE,2867730263,238,2867730501,2878025402
2025-06-19 01:25:02,FAKE,2867730501,243,2867730744,2878035658
2025-06-19 01:25:04,REAL,2867730744,10258,2867741002,2878045916
2025-06-19 01:25:06,REAL,2867741002,10252,2867751254,2878056168
2025-06-19 01:25:08,REAL,2867751254,10371,2867761625,2878066539
2025-06-19 01:25:10,REAL,2867761625,10249,2867771874,2878076788
2025-06-19 01:25:12,REAL,2867771874,6695,2867778569,2878083483
2025-06-19 01:25:14,REAL,2867778569,488,2867779057,2878083971
2025-06-19 01:25:16,FAKE,2867779057,243,2867779300,2878084448
2025-06-19 01:25:18,REAL,2867779300,486,2867779786,2878084934
2025-06-19 01:25:20,REAL,2867779786,491,2867780277,2878085425
2025-06-19 01:25:22,FAKE,2867780277,243,2867780520,2878085910
2025-06-19 01:25:24,REAL,2867780520,491,2867781011,2878086401
2025-06-19 01:25:26,REAL,2867781011,475,2867781486,2878086876
2025-06-19 01:25:28,FAKE,2867781486,238,2867781724,2878087353
2025-06-19 01:25:30,REAL,2867781724,11183,2867792907,2878098536
2025-06-19 01:25:32,REAL,2867792907,10246,2867803153,2878108782
2025-06-19 01:25:34,REAL,2867803153,10319,2867813472,2878119101
2025-06-19 01:25:36,REAL,2867813472,10256,2867823728,2878129357
2025-06-19 01:25:38,REAL,2867823728,10316,2867834044,2878139673
2025-06-19 01:25:40,REAL,2867834044,10256,2867844300,2878149929
2025-06-19 01:25:42,REAL,2867844300,10252,2867854552,2878160181
2025-06-19 01:25:44,REAL,2867854552,6099,2867860651,2878166280
2025-06-19 01:25:46,REAL,2867860651,483,2867861134,2878166763
2025-06-19 01:25:48,FAKE,2867861134,244,2867861378,2878167250
2025-06-19 01:25:50,REAL,2867861378,481,2867861859,2878167731
2025-06-19 01:25:52,FAKE,2867861859,244,2867862103,2878168208
2025-06-19 01:25:54,FAKE,2867862103,244,2867862347,2878168688
2025-06-19 01:25:56,REAL,2867862347,535,2867862882,2878169223
2025-06-19 01:25:58,REAL,2867862882,485,2867863367,2878169708
2025-06-19 01:26:00,REAL,2867863367,476,2867863843,2878170184
2025-06-19 01:26:02,FAKE,2867863843,244,2867864087,2878170668
2025-06-19 01:26:04,FAKE,2867864087,238,2867864325,2878171215
2025-06-19 01:26:06,REAL,2867864325,494,2867864819,2878171709
2025-06-19 01:26:08,REAL,2867864819,486,2867865305,2878172195
2025-06-19 01:26:10,REAL,2867865305,481,2867865786,2878172676
2025-06-19 01:26:12,FAKE,2867865786,244,2867866030,2878173157
2025-06-19 01:26:14,REAL,2867866030,477,2867866507,2878173634
2025-06-19 01:26:16,REAL,2867866507,480,2867866987,2878174114
2025-06-19 01:26:18,REAL,2867866987,489,2867867476,2878174603
2025-06-19 01:26:20,FAKE,2867867476,238,2867867714,2878175090
2025-06-19 01:26:22,REAL,2867867714,488,2867868202,2878175578
2025-06-19 01:26:24,REAL,2867868202,478,2867868680,2878176056
2025-06-19 01:26:26,REAL,2867868680,481,2867869161,2878176537
2025-06-19 01:26:28,FAKE,2867869161,238,2867869399,2878177020
2025-06-19 01:26:30,REAL,2867869399,481,2867869880,2878177501
2025-06-19 01:26:32,FAKE,2867869880,241,2867870121,2878178321
2025-06-19 01:26:34,FAKE,2867870121,238,2867870359,2878191076
2025-06-19 01:26:36,REAL,2867870359,10313,2867880672,2878201389
2025-06-19 01:26:38,REAL,2867880672,10257,2867890929,2878211646
2025-06-19 01:26:40,FAKE,2867890929,244,2867891173,2878221970
2025-06-19 01:26:42,REAL,2867891173,10257,2867901430,2878232227
2025-06-19 01:26:44,REAL,2867901430,10302,2867911732,2878242529
2025-06-19 01:26:46,REAL,2867911732,10326,2867922058,2878252855
2025-06-19 01:26:48,FAKE,2867922058,244,2867922302,2878257692
2025-06-19 01:26:50,REAL,2867922302,489,2867922791,2878258181
2025-06-19 01:26:52,FAKE,2867922791,241,2867923032,2878258665
2025-06-19 01:26:54,REAL,2867923032,490,2867923522,2878259155
2025-06-19 01:26:56,FAKE,2867923522,238,2867923760,2878259637
2025-06-19 01:26:58,REAL,2867923760,492,2867924252,2878260129
2025-06-19 01:27:00,FAKE,2867924252,238,2867924490,2878260610
2025-06-19 01:27:02,FAKE,2867924490,243,2867924733,2878261092
2025-06-19 01:27:04,FAKE,2867924733,244,2867924977,2878262837
2025-06-19 01:27:06,REAL,2867924977,11965,2867936942,2878274802
2025-06-19 01:27:08,REAL,2867936942,10319,2867947261,2878285121
2025-06-19 01:27:10,REAL,2867947261,10248,2867957509,2878295369
2025-06-19 01:27:12,FAKE,2867957509,238,2867957747,2878305616
2025-06-19 01:27:14,FAKE,2867957747,244,2867957991,2878315864
2025-06-19 01:27:16,REAL,2867957991,10314,2867968305,2878326178
2025-06-19 01:27:18,FAKE,2867968305,244,2867968549,2878336425
2025-06-19 01:27:20,REAL,2867968549,4170,2867972719,2878340595
2025-06-19 01:27:22,REAL,2867972719,480,2867973199,2878341075
2025-06-19 01:27:24,REAL,2867973199,483,2867973682,2878341558
2025-06-19 01:27:26,REAL,2867973682,486,2867974168,2878342044
2025-06-19 01:27:28,REAL,2867974168,482,2867974650,2878342526
2025-06-19 01:27:30,REAL,2867974650,491,2867975141,2878343017
2025-06-19 01:27:32,REAL,2867975141,546,2867975687,2878343563
2025-06-19 01:27:34,REAL,2867975687,493,2867976180,2878344056
2025-06-19 01:27:36,REAL,2867976180,481,2867976661,2878344537
2025-06-19 01:27:38,FAKE,2867976661,241,2867976902,2878345027
2025-06-19 01:27:40,REAL,2867976902,547,2867977449,2878345574
2025-06-19 01:27:42,REAL,2867977449,485,2867977934,2878346059
2025-06-19 01:27:44,REAL,2867977934,480,2867978414,2878346539
2025-06-19 01:27:46,REAL,2867978414,487,2867978901,2878347026
2025-06-19 01:27:48,REAL,2867978901,486,2867979387,2878347512
2025-06-19 01:27:50,FAKE,2867979387,238,2867979625,2878347995
2025-06-19 01:27:52,REAL,2867979625,482,2867980107,2878348477
2025-06-19 01:27:54,FAKE,2867980107,243,2867980350,2878348964
2025-06-19 01:27:56,REAL,2867980350,481,2867980831,2878349445
2025-06-19 01:27:58,REAL,2867980831,483,2867981314,2878349928
2025-06-19 01:28:00,REAL,2867981314,477,2867981791,2878350405
2025-06-19 01:28:02,REAL,2867981791,475,2867982266,2878350880
2025-06-19 01:28:04,REAL,2867982266,480,2867982746,2878351360
2025-06-19 01:28:06,REAL,2867982746,491,2867983237,2878351851
2025-06-19 01:28:08,REAL,2867983237,479,2867983716,2878352330
2025-06-19 01:28:10,REAL,2867983716,478,2867984194,2878352808
2025-06-19 01:28:12,REAL,2867984194,484,2867984678,2878353292
2025-06-19 01:28:14,FAKE,2867984678,243,2867984921,2878353772
2025-06-19 01:28:16,FAKE,2867984921,243,2867985164,2878354313
2025-06-19 01:28:18,REAL,2867985164,489,2867985653,2878354802
2025-06-19 01:28:20,FAKE,2867985653,241,2867985894,2878355293
2025-06-19 01:28:22,FAKE,2867985894,243,2867986137,2878355830
2025-06-19 01:28:24,REAL,2867986137,3792,2867989929,2878359622
2025-06-19 01:28:26,REAL,2867989929,11314,2868001243,2878370936
2025-06-19 01:28:28,REAL,2868001243,10250,2868011493,2878381186
2025-06-19 01:28:30,FAKE,2868011493,238,2868011731,2878391442
2025-06-19 01:28:32,REAL,2868011731,10255,2868021986,2878401697
2025-06-19 01:28:34,FAKE,2868021986,243,2868022229,2878411944
2025-06-19 01:28:36,REAL,2868022229,10251,2868032480,2878422195
2025-06-19 01:28:38,REAL,2868032480,10262,2868042742,2878432457
2025-06-19 01:28:40,REAL,2868042742,2659,2868045401,2878435116
2025-06-19 01:28:42,REAL,2868045401,489,2868045890,2878435605
2025-06-19 01:28:44,REAL,2868045890,485,2868046375,2878436090
2025-06-19 01:28:46,REAL,2868046375,478,2868046853,2878436568
2025-06-19 01:28:48,FAKE,2868046853,243,2868047096,2878437057
2025-06-19 01:28:50,REAL,2868047096,489,2868047585,2878437546
2025-06-19 01:28:52,FAKE,2868047585,244,2868047829,2878438027
2025-06-19 01:28:54,FAKE,2868047829,238,2868048067,2878438508
2025-06-19 01:28:56,REAL,2868048067,4401,2868052468,2878442909
2025-06-19 01:28:58,REAL,2868052468,11636,2868064104,2878454545
2025-06-19 01:29:00,REAL,2868064104,10320,2868074424,2878464865
2025-06-19 01:29:02,REAL,2868074424,10244,2868084668,2878475109
2025-06-19 01:29:04,FAKE,2868084668,241,2868084909,2878485423
2025-06-19 01:29:06,REAL,2868084909,10252,2868095161,2878495675
2025-06-19 01:29:08,REAL,2868095161,10310,2868105471,2878505985
2025-06-19 01:29:10,REAL,2868105471,10252,2868115723,2878516237
2025-06-19 01:29:12,REAL,2868115723,2122,2868117845,2878518359
2025-06-19 01:29:14,FAKE,2868117845,238,2868118083,2878518838
2025-06-19 01:29:16,REAL,2868118083,490,2868118573,2878519328
2025-06-19 01:29:18,FAKE,2868118573,241,2868118814,2878519810
2025-06-19 01:29:20,REAL,2868118814,481,2868119295,2878520291
2025-06-19 01:29:22,REAL,2868119295,493,2868119788,2878520784
2025-06-19 01:29:24,REAL,2868119788,483,2868120271,2878521267
2025-06-19 01:29:26,REAL,2868120271,488,2868120759,2878521755
2025-06-19 01:29:28,REAL,2868120759,477,2868121236,2878522232
2025-06-19 01:29:30,FAKE,2868121236,244,2868121480,2878522717
2025-06-19 01:29:32,REAL,2868121480,534,2868122014,2878523251
2025-06-19 01:29:34,FAKE,2868122014,241,2868122255,2878523734
2025-06-19 01:29:36,REAL,2868122255,484,2868122739,2878524218
2025-06-19 01:29:38,REAL,2868122739,490,2868123229,2878524708
2025-06-19 01:29:40,REAL,2868123229,486,2868123715,2878525194
2025-06-19 01:29:42,REAL,2868123715,492,2868124207,2878525686
2025-06-19 01:29:44,REAL,2868124207,480,2868124687,2878526166
2025-06-19 01:29:46,FAKE,2868124687,244,2868124931,2878526647
2025-06-19 01:29:48,FAKE,2868124931,238,2868125169,2878527133
2025-06-19 01:29:50,REAL,2868125169,482,2868125651,2878527615
2025-06-19 01:29:52,REAL,2868125651,482,2868126133,2878528097
2025-06-19 01:29:54,REAL,2868126133,480,2868126613,2878528577
2025-06-19 01:29:56,REAL,2868126613,476,2868127089,2878529053
2025-06-19 01:29:58,REAL,2868127089,475,2868127564,2878529528
2025-06-19 01:30:00,REAL,2868127564,5829,2868133393,2878535357
2025-06-19 01:30:02,REAL,2868133393,11248,2868144641,2878546605
2025-06-19 01:30:04,FAKE,2868144641,238,2868144879,2878556791
2025-06-19 01:30:06,FAKE,2868144879,243,2868145122,2878567047
2025-06-19 01:30:08,REAL,2868145122,10247,2868155369,2878577294
2025-06-19 01:30:10,FAKE,2868155369,241,2868155610,2878587552
2025-06-19 01:30:12,REAL,2868155610,10189,2868165799,2878597741
2025-06-19 01:30:14,REAL,2868165799,10253,2868176052,2878607994
2025-06-19 01:30:16,FAKE,2868176052,241,2868176293,2878608801
2025-06-19 01:30:18,REAL,2868176293,483,2868176776,2878609284
2025-06-19 01:30:20,FAKE,2868176776,241,2868177017,2878609768
2025-06-19 01:30:22,FAKE,2868177017,243,2868177260,2878610252
2025-06-19 01:30:24,REAL,2868177260,485,2868177745,2878610737
2025-06-19 01:30:26,REAL,2868177745,483,2868178228,2878611220
2025-06-19 01:30:28,REAL,2868178228,484,2868178712,2878611704
2025-06-19 01:30:30,REAL,2868178712,490,2868179202,2878612194
2025-06-19 01:30:32,FAKE,2868179202,243,2868179445,2878612682
2025-06-19 01:30:34,FAKE,2868179445,238,2868179683,2878613174
2025-06-19 01:30:36,REAL,2868179683,487,2868180170,2878613661
2025-06-19 01:30:38,FAKE,2868180170,238,2868180408,2878614152
2025-06-19 01:30:40,REAL,2868180408,489,2868180897,2878614641
2025-06-19 01:30:42,FAKE,2868180897,243,2868181140,2878615134
2025-06-19 01:30:44,FAKE,2868181140,243,2868181383,2878615625
2025-06-19 01:30:46,REAL,2868181383,481,2868181864,2878616106
2025-06-19 01:30:48,REAL,2868181864,479,2868182343,2878616585
2025-06-19 01:30:50,REAL,2868182343,589,2868182932,2878617174
2025-06-19 01:30:52,FAKE,2868182932,241,2868183173,2878617659
2025-06-19 01:30:54,FAKE,2868183173,238,2868183411,2878618148
2025-06-19 01:30:56,FAKE,2868183411,241,2868183652,2878618630
2025-06-19 01:30:58,REAL,2868183652,484,2868184136,2878619114
2025-06-19 01:31:00,REAL,2868184136,481,2868184617,2878619595
2025-06-19 01:31:02,REAL,2868184617,490,2868185107,2878620085
2025-06-19 01:31:04,REAL,2868185107,484,2868185591,2878620569
2025-06-19 01:31:06,REAL,2868185591,479,2868186070,2878621048
2025-06-19 01:31:08,REAL,2868186070,487,2868186557,2878621535
2025-06-19 01:31:10,FAKE,2868186557,241,2868186798,2878622018
2025-06-19 01:31:12,REAL,2868186798,474,2868187272,2878622492
2025-06-19 01:31:14,REAL,2868187272,490,2868187762,2878622982
2025-06-19 01:31:16,REAL,2868187762,494,2868188256,2878623476
2025-06-19 01:31:18,FAKE,2868188256,241,2868188497,2878623969
2025-06-19 01:31:20,REAL,2868188497,483,2868188980,2878624452
2025-06-19 01:31:22,FAKE,2868188980,238,2868189218,2878624940
2025-06-19 01:31:24,REAL,2868189218,537,2868189755,2878625477
2025-06-19 01:31:26,REAL,2868189755,487,2868190242,2878625964
2025-06-19 01:31:28,REAL,2868190242,491,2868190733,2878626455
2025-06-19 01:31:30,REAL,2868190733,474,2868191207,2878626929
2025-06-19 01:31:32,FAKE,2868191207,243,2868191450,2878627406
2025-06-19 01:31:34,REAL,2868191450,477,2868191927,2878627883
2025-06-19 01:31:36,REAL,2868191927,486,2868192413,2878628369
2025-06-19 01:31:38,REAL,2868192413,536,2868192949,2878628905
2025-06-19 01:31:40,REAL,2868192949,483,2868193432,2878629388
2025-06-19 01:31:42,REAL,2868193432,493,2868193925,2878629881
2025-06-19 01:31:44,REAL,2868193925,478,2868194403,2878630359
2025-06-19 01:31:46,REAL,2868194403,480,2868194883,2878630839
2025-06-19 01:31:48,REAL,2868194883,483,2868195366,2878631322
2025-06-19 01:31:50,REAL,2868195366,479,2868195845,2878631801
2025-06-19 01:31:52,REAL,2868195845,487,2868196332,2878632288
2025-06-19 01:31:54,FAKE,2868196332,244,2868196576,2878632766
2025-06-19 01:31:56,FAKE,2868196576,244,2868196820,2878633255
2025-06-19 01:31:58,REAL,2868196820,543,2868197363,2878633798
2025-06-19 01:32:00,REAL,2868197363,484,2868197847,2878634282
2025-06-19 01:32:02,REAL,2868197847,484,2868198331,2878634766
2025-06-19 01:32:04,FAKE,2868198331,244,2868198575,2878635248
2025-06-19 01:32:06,FAKE,2868198575,238,2868198813,2878635734
2025-06-19 01:32:08,REAL,2868198813,490,2868199303,2878636224
2025-06-19 01:32:10,REAL,2868199303,481,2868199784,2878636705
2025-06-19 01:32:12,REAL,2868199784,493,2868200277,2878637198
2025-06-19 01:32:14,REAL,2868200277,480,2868200757,2878637678
2025-06-19 01:32:16,REAL,2868200757,245,2868201002,2878637923
2025-06-19 01:32:18,REAL,2868201002,489,2868201491,2878638412
2025-06-19 01:32:20,FAKE,2868201491,241,2868201732,2878638901
2025-06-19 01:32:22,REAL,2868201732,482,2868202214,2878639383
2025-06-19 01:32:24,REAL,2868202214,482,2868202696,2878639865
2025-06-19 01:32:26,REAL,2868202696,494,2868203190,2878640359
2025-06-19 01:32:28,REAL,2868203190,534,2868203724,2878640893
2025-06-19 01:32:30,REAL,2868203724,541,2868204265,2878641434
2025-06-19 01:32:32,REAL,2868204265,487,2868204752,2878641921
2025-06-19 01:32:34,FAKE,2868204752,241,2868204993,2878642407
2025-06-19 01:32:36,FAKE,2868204993,244,2868205237,2878642892
2025-06-19 01:32:38,REAL,2868205237,479,2868205716,2878643371
2025-06-19 01:32:40,REAL,2868205716,486,2868206202,2878643857
2025-06-19 01:32:42,REAL,2868206202,726,2868206928,2878644583
2025-06-19 01:32:44,FAKE,2868206928,241,2868207169,2878644820
2025-06-19 01:32:46,REAL,2868207169,483,2868207652,2878645303
2025-06-19 01:32:48,FAKE,2868207652,244,2868207896,2878645782
2025-06-19 01:32:50,REAL,2868207896,9606,2868217502,2878655388
2025-06-19 01:32:52,FAKE,2868217502,241,2868217743,2878666032
2025-06-19 01:32:54,REAL,2868217743,10317,2868228060,2878676349
2025-06-19 01:32:56,FAKE,2868228060,238,2868228298,2878686601
2025-06-19 01:32:58,REAL,2868228298,10255,2868238553,2878696856
2025-06-19 01:33:00,REAL,2868238553,10256,2868248809,2878707112
2025-06-19 01:33:02,REAL,2868248809,10252,2868259061,2878717364
2025-06-19 01:33:04,REAL,2868259061,7539,2868266600,2878724903
2025-06-19 01:33:06,REAL,2868266600,544,2868267144,2878725447
2025-06-19 01:33:08,FAKE,2868267144,243,2868267387,2878725930
2025-06-19 01:33:10,REAL,2868267387,481,2868267868,2878726411
2025-06-19 01:33:12,REAL,2868267868,482,2868268350,2878726893
2025-06-19 01:33:14,REAL,2868268350,482,2868268832,2878727375
2025-06-19 01:33:16,REAL,2868268832,481,2868269313,2878727856
2025-06-19 01:33:18,REAL,2868269313,479,2868269792,2878728335
2025-06-19 01:33:20,REAL,2868269792,487,2868270279,2878728822
2025-06-19 01:33:22,REAL,2868270279,10456,2868280735,2878739278
2025-06-19 01:33:24,REAL,2868280735,10471,2868291206,2878749749
2025-06-19 01:33:26,FAKE,2868291206,241,2868291447,2878760006
2025-06-19 01:33:28,REAL,2868291447,10258,2868301705,2878770264
2025-06-19 01:33:30,REAL,2868301705,10311,2868312016,2878780575
2025-06-19 01:33:32,REAL,2868312016,10252,2868322268,2878790827
2025-06-19 01:33:34,REAL,2868322268,10250,2868332518,2878801077
2025-06-19 01:33:36,FAKE,2868332518,238,2868332756,2878808029
2025-06-19 01:33:38,REAL,2868332756,481,2868333237,2878808510
2025-06-19 01:33:40,REAL,2868333237,535,2868333772,2878809045
2025-06-19 01:33:42,REAL,2868333772,483,2868334255,2878809528
2025-06-19 01:33:44,REAL,2868334255,483,2868334738,2878810011
2025-06-19 01:33:46,REAL,2868334738,479,2868335217,2878810490
2025-06-19 01:33:48,REAL,2868335217,485,2868335702,2878810975
2025-06-19 01:33:50,FAKE,2868335702,243,2868335945,2878811459
2025-06-19 01:33:52,FAKE,2868335945,238,2868336183,2878811945
2025-06-19 01:33:54,FAKE,2868336183,244,2868336427,2878822810
2025-06-19 01:33:56,REAL,2868336427,10514,2868346941,2878833324
2025-06-19 01:33:58,FAKE,2868346941,241,2868347182,2878843576
2025-06-19 01:34:00,REAL,2868347182,10248,2868357430,2878853824
2025-06-19 01:34:02,REAL,2868357430,10322,2868367752,2878864146
2025-06-19 01:34:04,FAKE,2868367752,238,2868367990,2878874394
2025-06-19 01:34:06,REAL,2868367990,10248,2868378238,2878884642
2025-06-19 01:34:08,REAL,2868378238,6292,2868384530,2878890934
2025-06-19 01:34:10,FAKE,2868384530,238,2868384768,2878891426
2025-06-19 01:34:12,REAL,2868384768,483,2868385251,2878891909
2025-06-19 01:34:14,REAL,2868385251,532,2868385783,2878892441
2025-06-19 01:34:16,FAKE,2868385783,241,2868386024,2878892925
2025-06-19 01:34:18,REAL,2868386024,480,2868386504,2878893405
2025-06-19 01:34:20,REAL,2868386504,477,2868386981,2878893882
2025-06-19 01:34:22,FAKE,2868386981,244,2868387225,2878894366
2025-06-19 01:34:24,FAKE,2868387225,244,2868387469,2878894857
2025-06-19 01:34:26,REAL,2868387469,11515,2868398984,2878906372
2025-06-19 01:34:28,REAL,2868398984,10262,2868409246,2878916634
2025-06-19 01:34:30,FAKE,2868409246,241,2868409487,2878926894
2025-06-19 01:34:32,REAL,2868409487,10315,2868419802,2878937209
2025-06-19 01:34:34,REAL,2868419802,10252,2868430054,2878947461
2025-06-19 01:34:36,REAL,2868430054,10309,2868440363,2878957770
2025-06-19 01:34:38,REAL,2868440363,10257,2868450620,2878968027
2025-06-19 01:34:40,REAL,2868450620,5693,2868456313,2878973720
2025-06-19 01:34:42,REAL,2868456313,477,2868456790,2878974197
2025-06-19 01:34:44,REAL,2868456790,480,2868457270,2878974677
2025-06-19 01:34:46,FAKE,2868457270,243,2868457513,2878975165
2025-06-19 01:34:48,REAL,2868457513,545,2868458058,2878975710
2025-06-19 01:34:50,REAL,2868458058,479,2868458537,2878976189
2025-06-19 01:34:52,REAL,2868458537,488,2868459025,2878976677
2025-06-19 01:34:54,REAL,2868459025,479,2868459504,2878977156
2025-06-19 01:34:56,REAL,2868459504,560,2868460064,2878977716
2025-06-19 01:34:58,REAL,2868460064,15396,2868475460,2878993112
2025-06-19 01:35:00,REAL,2868475460,10251,2868485711,2879003363
2025-06-19 01:35:02,REAL,2868485711,10316,2868496027,2879013679
2025-06-19 01:35:04,REAL,2868496027,10250,2868506277,2879023929
2025-06-19 01:35:06,FAKE,2868506277,241,2868506518,2879034251
2025-06-19 01:35:08,REAL,2868506518,10253,2868516771,2879044504
2025-06-19 01:35:10,REAL,2868516771,10252,2868527023,2879054756
2025-06-19 01:35:12,FAKE,2868527023,238,2868527261,2879059796
2025-06-19 01:35:14,REAL,2868527261,488,2868527749,2879060284
2025-06-19 01:35:16,REAL,2868527749,485,2868528234,2879060769
2025-06-19 01:35:18,FAKE,2868528234,241,2868528475,2879061247
2025-06-19 01:35:20,REAL,2868528475,491,2868528966,2879061738
2025-06-19 01:35:22,REAL,2868528966,547,2868529513,2879062285
2025-06-19 01:35:24,REAL,2868529513,485,2868529998,2879062770
2025-06-19 01:35:26,REAL,2868529998,483,2868530481,2879063253
2025-06-19 01:35:28,FAKE,2868530481,243,2868530724,2879064726
2025-06-19 01:35:30,REAL,2868530724,14940,2868545664,2879079666
2025-06-19 01:35:32,FAKE,2868545664,243,2868545907,2879089922
2025-06-19 01:35:34,REAL,2868545907,10323,2868556230,2879100245
2025-06-19 01:35:36,REAL,2868556230,10255,2868566485,2879110500
2025-06-19 01:35:38,REAL,2868566485,10247,2868576732,2879120747
2025-06-19 01:35:40,REAL,2868576732,10257,2868586989,2879131004
2025-06-19 01:35:42,FAKE,2868586989,241,2868587230,2879141252
2025-06-19 01:35:44,REAL,2868587230,4375,2868591605,2879145627
2025-06-19 01:35:46,REAL,2868591605,478,2868592083,2879146105
2025-06-19 01:35:48,REAL,2868592083,488,2868592571,2879146593
2025-06-19 01:35:50,REAL,2868592571,486,2868593057,2879147079
2025-06-19 01:35:52,REAL,2868593057,485,2868593542,2879147564
2025-06-19 01:35:54,FAKE,2868593542,243,2868593785,2879148047
2025-06-19 01:35:56,REAL,2868593785,481,2868594266,2879148528
2025-06-19 01:35:58,REAL,2868594266,534,2868594800,2879149062
2025-06-19 01:36:00,REAL,2868594800,478,2868595278,2879149540
2025-06-19 01:36:02,REAL,2868595278,489,2868595767,2879150029
2025-06-19 01:36:04,FAKE,2868595767,243,2868596010,2879150512
2025-06-19 01:36:06,FAKE,2868596010,244,2868596254,2879151042
2025-06-19 01:36:08,FAKE,2868596254,243,2868596497,2879151528
2025-06-19 01:36:10,REAL,2868596497,484,2868596981,2879152012
2025-06-19 01:36:12,REAL,2868596981,485,2868597466,2879152497
2025-06-19 01:36:14,REAL,2868597466,481,2868597947,2879152978
2025-06-19 01:36:16,FAKE,2868597947,238,2868598185,2879153466
2025-06-19 01:36:18,FAKE,2868598185,241,2868598426,2879153948
2025-06-19 01:36:20,REAL,2868598426,475,2868598901,2879154423
2025-06-19 01:36:22,REAL,2868598901,478,2868599379,2879154901
2025-06-19 01:36:24,REAL,2868599379,478,2868599857,2879155379
2025-06-19 01:36:26,REAL,2868599857,485,2868600342,2879155864
2025-06-19 01:36:28,FAKE,2868600342,238,2868600580,2879156345
2025-06-19 01:36:30,REAL,2868600580,481,2868601061,2879156826
2025-06-19 01:36:32,REAL,2868601061,534,2868601595,2879157360
2025-06-19 01:36:34,REAL,2868601595,484,2868602079,2879157844
2025-06-19 01:36:36,REAL,2868602079,486,2868602565,2879158330
2025-06-19 01:36:38,FAKE,2868602565,243,2868602808,2879158817
2025-06-19 01:36:40,REAL,2868602808,481,2868603289,2879159298
2025-06-19 01:36:42,FAKE,2868603289,243,2868603532,2879159790
2025-06-19 01:36:44,REAL,2868603532,489,2868604021,2879160279
2025-06-19 01:36:46,FAKE,2868604021,244,2868604265,2879160829
2025-06-19 01:36:48,REAL,2868604265,482,2868604747,2879161311
2025-06-19 01:36:50,REAL,2868604747,484,2868605231,2879161795
2025-06-19 01:36:52,REAL,2868605231,482,2868605713,2879162277
2025-06-19 01:36:54,REAL,2868605713,487,2868606200,2879162764
2025-06-19 01:36:56,REAL,2868606200,493,2868606693,2879163257
2025-06-19 01:36:58,REAL,2868606693,478,2868607171,2879163735
2025-06-19 01:37:00,FAKE,2868607171,243,2868607414,2879164213
2025-06-19 01:37:02,REAL,2868607414,486,2868607900,2879164699
2025-06-19 01:37:04,FAKE,2868607900,244,2868608144,2879165181
2025-06-19 01:37:06,REAL,2868608144,537,2868608681,2879165718
2025-06-19 01:37:08,FAKE,2868608681,241,2868608922,2879166202
2025-06-19 01:37:10,REAL,2868608922,490,2868609412,2879166692
2025-06-19 01:37:12,REAL,2868609412,493,2868609905,2879167185
2025-06-19 01:37:14,REAL,2868609905,482,2868610387,2879167667
2025-06-19 01:37:16,REAL,2868610387,480,2868610867,2879168147
2025-06-19 01:37:18,REAL,2868610867,490,2868611357,2879168637
2025-06-19 01:37:20,REAL,2868611357,491,2868611848,2879169128
2025-06-19 01:37:22,REAL,2868611848,478,2868612326,2879169606
2025-06-19 01:37:24,REAL,2868612326,540,2868612866,2879170146
2025-06-19 01:37:26,REAL,2868612866,9951,2868622817,2879180097
2025-06-19 01:37:28,REAL,2868622817,10521,2868633338,2879190618
2025-06-19 01:37:30,REAL,2868633338,10256,2868643594,2879200874
2025-06-19 01:37:32,FAKE,2868643594,238,2868643832,2879211200
2025-06-19 01:37:34,REAL,2868643832,10256,2868654088,2879221456
2025-06-19 01:37:36,REAL,2868654088,10317,2868664405,2879231773
2025-06-19 01:37:38,REAL,2868664405,10252,2868674657,2879242025
2025-06-19 01:37:40,REAL,2868674657,7085,2868681742,2879249110
2025-06-19 01:37:42,REAL,2868681742,539,2868682281,2879249649
2025-06-19 01:37:44,REAL,2868682281,483,2868682764,2879250132
2025-06-19 01:37:46,FAKE,2868682764,238,2868683002,2879250609
2025-06-19 01:37:48,REAL,2868683002,478,2868683480,2879251087
2025-06-19 01:37:50,FAKE,2868683480,238,2868683718,2879251579
2025-06-19 01:37:52,REAL,2868683718,486,2868684204,2879252065
2025-06-19 01:37:54,REAL,2868684204,486,2868684690,2879252551
2025-06-19 01:37:56,REAL,2868684690,484,2868685174,2879253035
2025-06-19 01:37:58,REAL,2868685174,484,2868685658,2879253519
2025-06-19 01:38:00,REAL,2868685658,479,2868686137,2879253998
2025-06-19 01:38:02,REAL,2868686137,486,2868686623,2879254484
2025-06-19 01:38:04,FAKE,2868686623,244,2868686867,2879255017
2025-06-19 01:38:06,FAKE,2868686867,241,2868687108,2879255495
2025-06-19 01:38:08,REAL,2868687108,477,2868687585,2879255972
2025-06-19 01:38:10,REAL,2868687585,483,2868688068,2879256455
2025-06-19 01:38:12,REAL,2868688068,475,2868688543,2879256930
2025-06-19 01:38:14,FAKE,2868688543,243,2868688786,2879257412
2025-06-19 01:38:16,REAL,2868688786,538,2868689324,2879257950
2025-06-19 01:38:18,FAKE,2868689324,243,2868689567,2879263193
2025-06-19 01:38:20,REAL,2868689567,10780,2868700347,2879273973
2025-06-19 01:38:22,REAL,2868700347,10251,2868710598,2879284224
2025-06-19 01:38:24,REAL,2868710598,10253,2868720851,2879294477
2025-06-19 01:38:26,FAKE,2868720851,243,2868721094,2879304728
2025-06-19 01:38:28,FAKE,2868721094,244,2868721338,2879314985
2025-06-19 01:38:30,REAL,2868721338,10260,2868731598,2879325245
2025-06-19 01:38:32,FAKE,2868731598,238,2868731836,2879335564
2025-06-19 01:38:34,FAKE,2868731836,238,2868732074,2879336710
2025-06-19 01:38:36,REAL,2868732074,482,2868732556,2879337192
2025-06-19 01:38:38,FAKE,2868732556,238,2868732794,2879337681
2025-06-19 01:38:40,REAL,2868732794,481,2868733275,2879338162
2025-06-19 01:38:42,FAKE,2868733275,243,2868733518,2879338639
2025-06-19 01:38:44,FAKE,2868733518,241,2868733759,2879339122
2025-06-19 01:38:46,REAL,2868733759,488,2868734247,2879339610
2025-06-19 01:38:48,FAKE,2868734247,244,2868734491,2879340093
2025-06-19 01:38:50,FAKE,2868734491,243,2868734734,2879340578
2025-06-19 01:38:52,REAL,2868734734,545,2868735279,2879341123
2025-06-19 01:38:54,FAKE,2868735279,241,2868735520,2879341611
2025-06-19 01:38:56,REAL,2868735520,545,2868736065,2879342156
2025-06-19 01:38:58,FAKE,2868736065,244,2868736309,2879342637
2025-06-19 01:39:00,REAL,2868736309,483,2868736792,2879343120
2025-06-19 01:39:02,FAKE,2868736792,244,2868737036,2879343612
2025-06-19 01:39:04,REAL,2868737036,483,2868737519,2879344095
2025-06-19 01:39:06,REAL,2868737519,492,2868738011,2879344587
2025-06-19 01:39:08,FAKE,2868738011,244,2868738255,2879345067
2025-06-19 01:39:10,REAL,2868738255,483,2868738738,2879345550
2025-06-19 01:39:12,REAL,2868738738,482,2868739220,2879346032
2025-06-19 01:39:14,FAKE,2868739220,243,2868739463,2879346509
2025-06-19 01:39:16,FAKE,2868739463,243,2868739706,2879346992
2025-06-19 01:39:18,FAKE,2868739706,244,2868739950,2879347476
2025-06-19 01:39:20,FAKE,2868739950,243,2868740193,2879347961
2025-06-19 01:39:22,FAKE,2868740193,243,2868740436,2879356431
2025-06-19 01:39:24,REAL,2868740436,11035,2868751471,2879367466
2025-06-19 01:39:26,FAKE,2868751471,238,2868751709,2879377839
2025-06-19 01:39:28,FAKE,2868751709,244,2868751953,2879388092
2025-06-19 01:39:30,FAKE,2868751953,241,2868752194,2879398353
2025-06-19 01:39:32,REAL,2868752194,10251,2868762445,2879408604
2025-06-19 01:39:34,REAL,2868762445,10319,2868772764,2879418923
2025-06-19 01:39:36,REAL,2868772764,9717,2868782481,2879428640
2025-06-19 01:39:38,REAL,2868782481,485,2868782966,2879429125
2025-06-19 01:39:40,FAKE,2868782966,243,2868783209,2879429606
2025-06-19 01:39:42,FAKE,2868783209,243,2868783452,2879430100
2025-06-19 01:39:44,REAL,2868783452,487,2868783939,2879430587
2025-06-19 01:39:46,REAL,2868783939,480,2868784419,2879431067
2025-06-19 01:39:48,REAL,2868784419,489,2868784908,2879431556
2025-06-19 01:39:50,REAL,2868784908,485,2868785393,2879432041
2025-06-19 01:39:52,FAKE,2868785393,241,2868785634,2879432528
2025-06-19 01:39:54,REAL,2868785634,492,2868786126,2879433020
2025-06-19 01:39:56,REAL,2868786126,485,2868786611,2879433505
2025-06-19 01:39:58,REAL,2868786611,486,2868787097,2879433991
2025-06-19 01:40:00,REAL,2868787097,600,2868787697,2879434591
2025-06-19 01:40:02,REAL,2868787697,494,2868788191,2879435085
2025-06-19 01:40:04,REAL,2868788191,484,2868788675,2879435569
2025-06-19 01:40:06,REAL,2868788675,480,2868789155,2879436049
2025-06-19 01:40:08,FAKE,2868789155,244,2868789399,2879436530
2025-06-19 01:40:10,FAKE,2868789399,241,2868789640,2879437016
2025-06-19 01:40:12,REAL,2868789640,484,2868790124,2879437500
2025-06-19 01:40:14,REAL,2868790124,485,2868790609,2879437985
2025-06-19 01:40:16,REAL,2868790609,480,2868791089,2879438465
2025-06-19 01:40:18,REAL,2868791089,485,2868791574,2879438950
2025-06-19 01:40:20,REAL,2868791574,484,2868792058,2879439434
2025-06-19 01:40:22,REAL,2868792058,490,2868792548,2879439924
2025-06-19 01:40:24,REAL,2868792548,489,2868793037,2879440413
2025-06-19 01:40:26,REAL,2868793037,486,2868793523,2879440899
2025-06-19 01:40:28,REAL,2868793523,493,2868794016,2879441392
2025-06-19 01:40:30,REAL,2868794016,541,2868794557,2879441933
2025-06-19 01:40:32,REAL,2868794557,486,2868795043,2879442419
2025-06-19 01:40:34,FAKE,2868795043,244,2868795287,2879442899
2025-06-19 01:40:36,REAL,2868795287,541,2868795828,2879443440
2025-06-19 01:40:38,REAL,2868795828,487,2868796315,2879443927
2025-06-19 01:40:40,REAL,2868796315,483,2868796798,2879444410
2025-06-19 01:40:42,FAKE,2868796798,243,2868797041,2879444895
2025-06-19 01:40:44,REAL,2868797041,485,2868797526,2879445380
2025-06-19 01:40:46,FAKE,2868797526,241,2868797767,2879448314
2025-06-19 01:40:48,REAL,2868797767,12102,2868809869,2879460416
2025-06-19 01:40:50,FAKE,2868809869,238,2868810107,2879470672
2025-06-19 01:40:52,REAL,2868810107,10317,2868820424,2879480989
2025-06-19 01:40:54,FAKE,2868820424,241,2868820665,2879491248
2025-06-19 01:40:56,FAKE,2868820665,238,2868820903,2879501565
2025-06-19 01:40:58,REAL,2868820903,10256,2868831159,2879511821
2025-06-19 01:41:00,FAKE,2868831159,241,2868831400,2879522141
2025-06-19 01:41:02,FAKE,2868831400,243,2868831643,2879525324
2025-06-19 01:41:04,REAL,2868831643,483,2868832126,2879525807
2025-06-19 01:41:06,REAL,2868832126,538,2868832664,2879526345
2025-06-19 01:41:08,REAL,2868832664,475,2868833139,2879526820
2025-06-19 01:41:10,FAKE,2868833139,243,2868833382,2879527303
2025-06-19 01:41:12,REAL,2868833382,474,2868833856,2879527777
2025-06-19 01:41:14,FAKE,2868833856,244,2868834100,2879528257
2025-06-19 01:41:16,REAL,2868834100,541,2868834641,2879528798
2025-06-19 01:41:18,REAL,2868834641,3722,2868838363,2879532520
2025-06-19 01:41:20,FAKE,2868838363,244,2868838607,2879544297
2025-06-19 01:41:22,FAKE,2868838607,238,2868838845,2879554616
2025-06-19 01:41:24,REAL,2868838845,10322,2868849167,2879564938
2025-06-19 01:41:26,REAL,2868849167,10247,2868859414,2879575185
2025-06-19 01:41:28,FAKE,2868859414,238,2868859652,2879585502
2025-06-19 01:41:30,REAL,2868859652,10310,2868869962,2879595812
2025-06-19 01:41:32,REAL,2868869962,10248,2868880210,2879606060
2025-06-19 01:41:34,REAL,2868880210,2663,2868882873,2879608723
2025-06-19 01:41:36,FAKE,2868882873,241,2868883114,2879609200
2025-06-19 01:41:38,FAKE,2868883114,243,2868883357,2879609736
2025-06-19 01:41:40,FAKE,2868883357,238,2868883595,2879610216
2025-06-19 01:41:42,REAL,2868883595,493,2868884088,2879610709
2025-06-19 01:41:44,FAKE,2868884088,244,2868884332,2879611201
2025-06-19 01:41:46,FAKE,2868884332,238,2868884570,2879611685
2025-06-19 01:41:48,REAL,2868884570,537,2868885107,2879612222
2025-06-19 01:41:50,FAKE,2868885107,241,2868885348,2879617206
2025-06-19 01:41:52,REAL,2868885348,14552,2868899900,2879631758
2025-06-19 01:41:54,REAL,2868899900,10247,2868910147,2879642005
2025-06-19 01:41:56,FAKE,2868910147,244,2868910391,2879652329
2025-06-19 01:41:58,FAKE,2868910391,238,2868910629,2879662579
2025-06-19 01:42:00,REAL,2868910629,10312,2868920941,2879672891
2025-06-19 01:42:02,REAL,2868920941,10251,2868931192,2879683142
2025-06-19 01:42:04,FAKE,2868931192,238,2868931430,2879693454
2025-06-19 01:42:06,REAL,2868931430,2005,2868933435,2879695459
2025-06-19 01:42:08,REAL,2868933435,481,2868933916,2879695940
2025-06-19 01:42:10,FAKE,2868933916,243,2868934159,2879696480
2025-06-19 01:42:12,FAKE,2868934159,241,2868934400,2879696965
2025-06-19 01:42:14,REAL,2868934400,486,2868934886,2879697451
2025-06-19 01:42:16,REAL,2868934886,479,2868935365,2879697930
2025-06-19 01:42:18,REAL,2868935365,480,2868935845,2879698410
2025-06-19 01:42:20,FAKE,2868935845,244,2868936089,2879698945
2025-06-19 01:42:22,REAL,2868936089,5176,2868941265,2879704121
2025-06-19 01:42:24,REAL,2868941265,11312,2868952577,2879715433
2025-06-19 01:42:26,REAL,2868952577,10244,2868962821,2879725677
2025-06-19 01:42:28,REAL,2868962821,10245,2868973066,2879735922
2025-06-19 01:42:30,REAL,2868973066,10253,2868983319,2879746175
2025-06-19 01:42:32,FAKE,2868983319,243,2868983562,2879756426
2025-06-19 01:42:34,FAKE,2868983562,241,2868983803,2879766744
2025-06-19 01:42:36,FAKE,2868983803,244,2868984047,2879776999
2025-06-19 01:42:38,REAL,2868984047,1348,2868985395,2879778347
2025-06-19 01:42:40,FAKE,2868985395,241,2868985636,2879778884
2025-06-19 01:42:42,REAL,2868985636,482,2868986118,2879779366
2025-06-19 01:42:44,REAL,2868986118,11455,2868997573,2879790821
2025-06-19 01:42:46,REAL,2868997573,10246,2869007819,2879801067
2025-06-19 01:42:48,REAL,2869007819,10247,2869018066,2879811314
2025-06-19 01:42:50,REAL,2869018066,10312,2869028378,2879821626
2025-06-19 01:42:52,REAL,2869028378,10253,2869038631,2879831879
2025-06-19 01:42:54,REAL,2869038631,10255,2869048886,2879842134
2025-06-19 01:42:56,REAL,2869048886,10318,2869059204,2879852452
2025-06-19 01:42:58,REAL,2869059204,5891,2869065095,2879858343
2025-06-19 01:43:00,REAL,2869065095,487,2869065582,2879858830
2025-06-19 01:43:02,REAL,2869065582,486,2869066068,2879859316
2025-06-19 01:43:04,REAL,2869066068,487,2869066555,2879859803
2025-06-19 01:43:06,REAL,2869066555,488,2869067043,2879860291
2025-06-19 01:43:08,FAKE,2869067043,244,2869067287,2879860771
2025-06-19 01:43:10,FAKE,2869067287,238,2869067525,2879861307
2025-06-19 01:43:12,FAKE,2869067525,243,2869067768,2879861843
2025-06-19 01:43:14,REAL,2869067768,484,2869068252,2879862327
2025-06-19 01:43:16,FAKE,2869068252,238,2869068490,2879873839
2025-06-19 01:43:18,FAKE,2869068490,238,2869068728,2879884099
2025-06-19 01:43:20,FAKE,2869068728,243,2869068971,2879894352
2025-06-19 01:43:22,FAKE,2869068971,243,2869069214,2879904605
2025-06-19 01:43:24,REAL,2869069214,10314,2869079528,2879914919
2025-06-19 01:43:26,FAKE,2869079528,243,2869079771,2879925173
2025-06-19 01:43:28,FAKE,2869079771,238,2869080009,2879935418
2025-06-19 01:43:30,FAKE,2869080009,241,2869080250,2879940715
2025-06-19 01:43:32,FAKE,2869080250,238,2869080488,2879941203
2025-06-19 01:43:34,REAL,2869080488,476,2869080964,2879941679
2025-06-19 01:43:36,FAKE,2869080964,243,2869081207,2879942154
2025-06-19 01:43:38,FAKE,2869081207,241,2869081448,2879942641
2025-06-19 01:43:40,REAL,2869081448,480,2869081928,2879943121
2025-06-19 01:43:42,FAKE,2869081928,244,2869082172,2879943660
2025-06-19 01:43:44,REAL,2869082172,542,2869082714,2879944202
2025-06-19 01:43:46,REAL,2869082714,1086,2869083800,2879945288
2025-06-19 01:43:48,REAL,2869083800,15143,2869098943,2879960431
2025-06-19 01:43:50,REAL,2869098943,10251,2869109194,2879970682
2025-06-19 01:43:52,REAL,2869109194,10256,2869119450,2879980938
2025-06-19 01:43:54,REAL,2869119450,10255,2869129705,2879991193
2025-06-19 01:43:56,REAL,2869129705,10251,2869139956,2880001444
2025-06-19 01:43:58,REAL,2869139956,10322,2869150278,2880011766
2025-06-19 01:44:00,REAL,2869150278,10259,2869160537,2880022025
2025-06-19 01:44:02,REAL,2869160537,4650,2869165187,2880026675
2025-06-19 01:44:04,REAL,2869165187,483,2869165670,2880027158
2025-06-19 01:44:06,FAKE,2869165670,244,2869165914,2880027640
2025-06-19 01:44:08,FAKE,2869165914,244,2869166158,2880028124
2025-06-19 01:44:10,FAKE,2869166158,241,2869166399,2880028609
2025-06-19 01:44:12,REAL,2869166399,545,2869166944,2880029154
2025-06-19 01:44:14,REAL,2869166944,486,2869167430,2880029640
2025-06-19 01:44:16,REAL,2869167430,535,2869167965,2880030175
2025-06-19 01:44:18,REAL,2869167965,482,2869168447,2880030657
2025-06-19 01:44:20,FAKE,2869168447,241,2869168688,2880031148
2025-06-19 01:44:22,REAL,2869168688,484,2869169172,2880031632
2025-06-19 01:44:24,REAL,2869169172,477,2869169649,2880032109
2025-06-19 01:44:26,FAKE,2869169649,241,2869169890,2880032596
2025-06-19 01:44:28,FAKE,2869169890,238,2869170128,2880033086
2025-06-19 01:44:30,REAL,2869170128,478,2869170606,2880033564
2025-06-19 01:44:32,REAL,2869170606,488,2869171094,2880034052
2025-06-19 01:44:34,FAKE,2869171094,241,2869171335,2880034530
2025-06-19 01:44:36,REAL,2869171335,483,2869171818,2880035013
2025-06-19 01:44:38,FAKE,2869171818,238,2869172056,2880035498
2025-06-19 01:44:40,REAL,2869172056,478,2869172534,2880035976
2025-06-19 01:44:42,REAL,2869172534,541,2869173075,2880036517
2025-06-19 01:44:44,REAL,2869173075,489,2869173564,2880037006
2025-06-19 01:44:46,FAKE,2869173564,238,2869173802,2880037537
2025-06-19 01:44:48,FAKE,2869173802,238,2869174040,2880038027
2025-06-19 01:44:50,REAL,2869174040,485,2869174525,2880038512
2025-06-19 01:44:52,FAKE,2869174525,244,2869174769,2880038992
2025-06-19 01:44:54,REAL,2869174769,486,2869175255,2880039478
2025-06-19 01:44:56,FAKE,2869175255,243,2869175498,2880039964
2025-06-19 01:44:58,FAKE,2869175498,243,2869175741,2880040451
2025-06-19 01:45:00,REAL,2869175741,485,2869176226,2880040936
2025-06-19 01:45:02,REAL,2869176226,491,2869176717,2880041427
2025-06-19 01:45:04,REAL,2869176717,494,2869177211,2880041921
2025-06-19 01:45:06,REAL,2869177211,483,2869177694,2880042404
2025-06-19 01:45:08,REAL,2869177694,488,2869178182,2880042892
2025-06-19 01:45:10,FAKE,2869178182,243,2869178425,2880043376
2025-06-19 01:45:12,REAL,2869178425,481,2869178906,2880043857
2025-06-19 01:45:14,REAL,2869178906,538,2869179444,2880044395
2025-06-19 01:45:16,REAL,2869179444,492,2869179936,2880044887
2025-06-19 01:45:18,FAKE,2869179936,238,2869180174,2880045373
2025-06-19 01:45:20,REAL,2869180174,483,2869180657,2880045856
2025-06-19 01:45:22,REAL,2869180657,483,2869181140,2880046339
2025-06-19 01:45:24,FAKE,2869181140,238,2869181378,2880046879
2025-06-19 01:45:26,REAL,2869181378,483,2869181861,2880047362
2025-06-19 01:45:28,REAL,2869181861,9199,2869191060,2880056561
2025-06-19 01:45:30,REAL,2869191060,10520,2869201580,2880067081
2025-06-19 01:45:32,REAL,2869201580,10247,2869211827,2880077328
2025-06-19 01:45:34,FAKE,2869211827,238,2869212065,2880087649
2025-06-19 01:45:36,REAL,2869212065,10251,2869222316,2880097900
2025-06-19 01:45:38,FAKE,2869222316,243,2869222559,2880108157
2025-06-19 01:45:40,REAL,2869222559,10315,2869232874,2880118472
2025-06-19 01:45:42,REAL,2869232874,7607,2869240481,2880126079
2025-06-19 01:45:44,FAKE,2869240481,241,2869240722,2880126561
2025-06-19 01:45:46,REAL,2869240722,483,2869241205,2880127044
2025-06-19 01:45:48,FAKE,2869241205,244,2869241449,2880127533
2025-06-19 01:45:50,REAL,2869241449,476,2869241925,2880128009
2025-06-19 01:45:52,FAKE,2869241925,238,2869242163,2880128549
2025-06-19 01:45:54,REAL,2869242163,487,2869242650,2880129036
2025-06-19 01:45:56,REAL,2869242650,483,2869243133,2880129519
2025-06-19 01:45:58,FAKE,2869243133,244,2869243377,2880129996
2025-06-19 01:46:00,REAL,2869243377,10056,2869253433,2880140052
2025-06-19 01:46:02,FAKE,2869253433,244,2869253677,2880150574
2025-06-19 01:46:04,REAL,2869253677,10256,2869263933,2880160830
2025-06-19 01:46:06,REAL,2869263933,10256,2869274189,2880171086
2025-06-19 01:46:08,REAL,2869274189,10253,2869284442,2880181339
2025-06-19 01:46:10,REAL,2869284442,10254,2869294696,2880191593
2025-06-19 01:46:12,REAL,2869294696,10245,2869304941,2880201838
2025-06-19 01:46:14,REAL,2869304941,7017,2869311958,2880208855
2025-06-19 01:46:16,REAL,2869311958,482,2869312440,2880209337
2025-06-19 01:46:18,FAKE,2869312440,244,2869312684,2880209820
2025-06-19 01:46:20,REAL,2869312684,5896,2869318580,2880215716
2025-06-19 01:46:22,FAKE,2869318580,243,2869318823,2880229602
2025-06-19 01:46:24,FAKE,2869318823,243,2869319066,2880239862
2025-06-19 01:46:26,REAL,2869319066,10251,2869329317,2880250113
2025-06-19 01:46:28,REAL,2869329317,10319,2869339636,2880260432
2025-06-19 01:46:30,REAL,2869339636,10311,2869349947,2880270743
2025-06-19 01:46:32,REAL,2869349947,10316,2869360263,2880281059
2025-06-19 01:46:34,FAKE,2869360263,243,2869360506,2880291310
2025-06-19 01:46:36,REAL,2869360506,1730,2869362236,2880293040
2025-06-19 01:46:38,REAL,2869362236,483,2869362719,2880293523
2025-06-19 01:46:40,FAKE,2869362719,244,2869362963,2880294002
2025-06-19 01:46:42,REAL,2869362963,482,2869363445,2880294484
2025-06-19 01:46:44,FAKE,2869363445,241,2869363686,2880294960
2025-06-19 01:46:46,REAL,2869363686,476,2869364162,2880295436
2025-06-19 01:46:48,REAL,2869364162,483,2869364645,2880295919
2025-06-19 01:46:50,REAL,2869364645,490,2869365135,2880296409
2025-06-19 01:46:52,FAKE,2869365135,241,2869365376,2880302049
2025-06-19 01:46:54,REAL,2869365376,11044,2869376420,2880313093
2025-06-19 01:46:56,FAKE,2869376420,238,2869376658,2880323415
2025-06-19 01:46:58,FAKE,2869376658,238,2869376896,2880333719
2025-06-19 01:47:00,REAL,2869376896,10252,2869387148,2880343971
2025-06-19 01:47:02,FAKE,2869387148,241,2869387389,2880354221
2025-06-19 01:47:04,FAKE,2869387389,244,2869387633,2880364538
2025-06-19 01:47:06,REAL,2869387633,10253,2869397886,2880374791
2025-06-19 01:47:08,REAL,2869397886,1196,2869399082,2880375987
2025-06-19 01:47:10,REAL,2869399082,477,2869399559,2880376464
2025-06-19 01:47:12,REAL,2869399559,488,2869400047,2880376952
2025-06-19 01:47:14,FAKE,2869400047,244,2869400291,2880377444
2025-06-19 01:47:16,REAL,2869400291,491,2869400782,2880377935
2025-06-19 01:47:18,REAL,2869400782,484,2869401266,2880378419
2025-06-19 01:47:20,REAL,2869401266,483,2869401749,2880378902
2025-06-19 01:47:22,FAKE,2869401749,241,2869401990,2880379384
2025-06-19 01:47:24,REAL,2869401990,6036,2869408026,2880385420
2025-06-19 01:47:26,REAL,2869408026,11305,2869419331,2880396725
2025-06-19 01:47:28,REAL,2869419331,10247,2869429578,2880406972
2025-06-19 01:47:30,REAL,2869429578,10254,2869439832,2880417226
2025-06-19 01:47:32,REAL,2869439832,10256,2869450088,2880427482
2025-06-19 01:47:34,REAL,2869450088,10321,2869460409,2880437803
2025-06-19 01:47:36,REAL,2869460409,10252,2869470661,2880448055
2025-06-19 01:47:38,REAL,2869470661,10321,2869480982,2880458376
2025-06-19 01:47:40,REAL,2869480982,477,2869481459,2880458853
2025-06-19 01:47:42,REAL,2869481459,482,2869481941,2880459335
2025-06-19 01:47:44,FAKE,2869481941,241,2869482182,2880459829
2025-06-19 01:47:46,FAKE,2869482182,238,2869482420,2880460320
2025-06-19 01:47:48,REAL,2869482420,546,2869482966,2880460866
2025-06-19 01:47:50,REAL,2869482966,479,2869483445,2880461345
2025-06-19 01:47:52,REAL,2869483445,481,2869483926,2880461826
2025-06-19 01:47:54,REAL,2869483926,483,2869484409,2880462309
2025-06-19 01:47:56,REAL,2869484409,7821,2869492230,2880470130
2025-06-19 01:47:58,REAL,2869492230,12772,2869505002,2880482902
2025-06-19 01:48:00,REAL,2869505002,10256,2869515258,2880493158
2025-06-19 01:48:02,FAKE,2869515258,243,2869515501,2880503538
2025-06-19 01:48:04,REAL,2869515501,10315,2869525816,2880513853
2025-06-19 01:48:06,FAKE,2869525816,238,2869526054,2880524107
2025-06-19 01:48:08,REAL,2869526054,10318,2869536372,2880534425
2025-06-19 01:48:10,REAL,2869536372,9598,2869545970,2880544023
2025-06-19 01:48:12,REAL,2869545970,489,2869546459,2880544512
2025-06-19 01:48:14,FAKE,2869546459,238,2869546697,2880544995
2025-06-19 01:48:16,FAKE,2869546697,244,2869546941,2880545478
2025-06-19 01:48:18,REAL,2869546941,480,2869547421,2880545958
2025-06-19 01:48:20,FAKE,2869547421,244,2869547665,2880546447
2025-06-19 01:48:22,REAL,2869547665,479,2869548144,2880546926
2025-06-19 01:48:24,FAKE,2869548144,238,2869548382,2880547415
2025-06-19 01:48:26,REAL,2869548382,544,2869548926,2880547959
2025-06-19 01:48:28,REAL,2869548926,487,2869549413,2880548446
2025-06-19 01:48:30,REAL,2869549413,490,2869549903,2880548936
2025-06-19 01:48:32,REAL,2869549903,493,2869550396,2880549429
2025-06-19 01:48:34,FAKE,2869550396,241,2869550637,2880549916
2025-06-19 01:48:36,FAKE,2869550637,238,2869550875,2880550391
2025-06-19 01:48:38,REAL,2869550875,543,2869551418,2880550934
2025-06-19 01:48:40,REAL,2869551418,485,2869551903,2880551419
2025-06-19 01:48:42,REAL,2869551903,486,2869552389,2880551905
2025-06-19 01:48:44,REAL,2869552389,483,2869552872,2880552388
2025-06-19 01:48:46,REAL,2869552872,479,2869553351,2880552867
2025-06-19 01:48:48,REAL,2869553351,487,2869553838,2880553354
2025-06-19 01:48:50,REAL,2869553838,489,2869554327,2880553843
2025-06-19 01:48:52,FAKE,2869554327,244,2869554571,2880554337
2025-06-19 01:48:54,REAL,2869554571,480,2869555051,2880554817
2025-06-19 01:48:56,REAL,2869555051,246,2869555297,2880555063
2025-06-19 01:48:58,REAL,2869555297,486,2869555783,2880555549
2025-06-19 01:49:00,FAKE,2869555783,241,2869556024,2880556039
2025-06-19 01:49:02,REAL,2869556024,484,2869556508,2880556523
2025-06-19 01:49:04,FAKE,2869556508,241,2869556749,2880558993
2025-06-19 01:49:06,REAL,2869556749,14327,2869571076,2880573320
2025-06-19 01:49:08,REAL,2869571076,10317,2869581393,2880583637
2025-06-19 01:49:10,FAKE,2869581393,238,2869581631,2880593890
2025-06-19 01:49:12,FAKE,2869581631,243,2869581874,2880604138
2025-06-19 01:49:14,REAL,2869581874,10248,2869592122,2880614386
2025-06-19 01:49:16,REAL,2869592122,10257,2869602379,2880624643
2025-06-19 01:49:18,REAL,2869602379,10326,2869612705,2880634969
2025-06-19 01:49:20,FAKE,2869612705,241,2869612946,2880638421
2025-06-19 01:49:22,REAL,2869612946,480,2869613426,2880638901
2025-06-19 01:49:24,REAL,2869613426,481,2869613907,2880639382
2025-06-19 01:49:26,REAL,2869613907,485,2869614392,2880639867
2025-06-19 01:49:28,REAL,2869614392,480,2869614872,2880640347
2025-06-19 01:49:30,REAL,2869614872,483,2869615355,2880640830
2025-06-19 01:49:32,FAKE,2869615355,243,2869615598,2880641318
2025-06-19 01:49:34,REAL,2869615598,485,2869616083,2880641803
2025-06-19 01:49:36,REAL,2869616083,3261,2869619344,2880645064
2025-06-19 01:49:38,REAL,2869619344,11459,2869630803,2880656523
2025-06-19 01:49:40,REAL,2869630803,10310,2869641113,2880666833
2025-06-19 01:49:42,REAL,2869641113,10310,2869651423,2880677143
2025-06-19 01:49:44,REAL,2869651423,10364,2869661787,2880687507
2025-06-19 01:49:46,REAL,2869661787,10262,2869672049,2880697769
2025-06-19 01:49:48,REAL,2869672049,10319,2869682368,2880708088
2025-06-19 01:49:50,REAL,2869682368,10247,2869692615,2880718335
2025-06-19 01:49:52,FAKE,2869692615,241,2869692856,2880721191
2025-06-19 01:49:54,FAKE,2869692856,244,2869693100,2880721672
2025-06-19 01:49:56,REAL,2869693100,487,2869693587,2880722159
2025-06-19 01:49:58,FAKE,2869693587,244,2869693831,2880722636
2025-06-19 01:50:00,REAL,2869693831,492,2869694323,2880723128
2025-06-19 01:50:02,REAL,2869694323,486,2869694809,2880723614
2025-06-19 01:50:04,FAKE,2869694809,238,2869695047,2880724101
2025-06-19 01:50:06,FAKE,2869695047,243,2869695290,2880724581
2025-06-19 01:50:08,REAL,2869695290,3984,2869699274,2880728565
2025-06-19 01:50:10,REAL,2869699274,14883,2869714157,2880743448
2025-06-19 01:50:12,REAL,2869714157,10257,2869724414,2880753705
2025-06-19 01:50:14,REAL,2869724414,10322,2869734736,2880764027
2025-06-19 01:50:16,REAL,2869734736,10257,2869744993,2880774284
2025-06-19 01:50:18,REAL,2869744993,10253,2869755246,2880784537
2025-06-19 01:50:20,REAL,2869755246,10251,2869765497,2880794788
2025-06-19 01:50:22,REAL,2869765497,10312,2869775809,2880805100
2025-06-19 01:50:24,REAL,2869775809,2251,2869778060,2880807351
2025-06-19 01:50:26,REAL,2869778060,485,2869778545,2880807836
2025-06-19 01:50:28,FAKE,2869778545,238,2869778783,2880808315
2025-06-19 01:50:30,REAL,2869778783,477,2869779260,2880808792
2025-06-19 01:50:32,FAKE,2869779260,241,2869779501,2880809276
2025-06-19 01:50:34,FAKE,2869779501,244,2869779745,2880809757
2025-06-19 01:50:36,REAL,2869779745,480,2869780225,2880810237
2025-06-19 01:50:38,REAL,2869780225,540,2869780765,2880810777
2025-06-19 01:50:40,REAL,2869780765,5118,2869785883,2880815895
2025-06-19 01:50:42,FAKE,2869785883,238,2869786121,2880827467
2025-06-19 01:50:44,FAKE,2869786121,238,2869786359,2880837714
2025-06-19 01:50:46,REAL,2869786359,10253,2869796612,2880847967
2025-06-19 01:50:48,FAKE,2869796612,243,2869796855,2880858284
2025-06-19 01:50:50,FAKE,2869796855,241,2869797096,2880868537
2025-06-19 01:50:52,REAL,2869797096,10252,2869807348,2880878789
2025-06-19 01:50:54,REAL,2869807348,10258,2869817606,2880889047
2025-06-19 01:50:56,REAL,2869817606,1614,2869819220,2880890661
2025-06-19 01:50:58,REAL,2869819220,485,2869819705,2880891146
2025-06-19 01:51:00,REAL,2869819705,491,2869820196,2880891637
2025-06-19 01:51:02,REAL,2869820196,11582,2869831778,2880903219
2025-06-19 01:51:04,REAL,2869831778,10384,2869842162,2880913603
2025-06-19 01:51:06,FAKE,2869842162,243,2869842405,2880923852
2025-06-19 01:51:08,FAKE,2869842405,243,2869842648,2880934168
2025-06-19 01:51:10,REAL,2869842648,10256,2869852904,2880944424
2025-06-19 01:51:12,FAKE,2869852904,238,2869853142,2880954682
2025-06-19 01:51:14,REAL,2869853142,10322,2869863464,2880965004
2025-06-19 01:51:16,REAL,2869863464,6225,2869869689,2880971229
2025-06-19 01:51:18,FAKE,2869869689,238,2869869927,2880971719
2025-06-19 01:51:20,REAL,2869869927,491,2869870418,2880972210
2025-06-19 01:51:22,REAL,2869870418,489,2869870907,2880972699
2025-06-19 01:51:24,FAKE,2869870907,244,2869871151,2880973188
2025-06-19 01:51:26,FAKE,2869871151,241,2869871392,2880973668
2025-06-19 01:51:28,REAL,2869871392,537,2869871929,2880974205
2025-06-19 01:51:30,FAKE,2869871929,238,2869872167,2880974690
2025-06-19 01:51:32,FAKE,2869872167,243,2869872410,2880975178
2025-06-19 01:51:34,REAL,2869872410,11973,2869884383,2880987151
2025-06-19 01:51:36,FAKE,2869884383,243,2869884626,2880997471
2025-06-19 01:51:38,REAL,2869884626,10255,2869894881,2881007726
2025-06-19 01:51:40,REAL,2869894881,10244,2869905125,2881017970
2025-06-19 01:51:42,REAL,2869905125,10252,2869915377,2881028222
2025-06-19 01:51:44,REAL,2869915377,10248,2869925625,2881038470
2025-06-19 01:51:46,REAL,2869925625,10309,2869935934,2881048779
2025-06-19 01:51:48,FAKE,2869935934,244,2869936178,2881054416
2025-06-19 01:51:50,REAL,2869936178,485,2869936663,2881054901
2025-06-19 01:51:52,REAL,2869936663,494,2869937157,2881055395
2025-06-19 01:51:54,REAL,2869937157,479,2869937636,2881055874
2025-06-19 01:51:56,REAL,2869937636,493,2869938129,2881056367
2025-06-19 01:51:58,REAL,2869938129,487,2869938616,2881056854
2025-06-19 01:52:00,REAL,2869938616,540,2869939156,2881057394
2025-06-19 01:52:02,REAL,2869939156,480,2869939636,2881057874
2025-06-19 01:52:04,FAKE,2869939636,244,2869939880,2881058421
2025-06-19 01:52:06,REAL,2869939880,492,2869940372,2881058913
2025-06-19 01:52:08,REAL,2869940372,486,2869940858,2881059399
2025-06-19 01:52:10,REAL,2869940858,487,2869941345,2881059886
2025-06-19 01:52:12,REAL,2869941345,484,2869941829,2881060370
2025-06-19 01:52:14,REAL,2869941829,484,2869942313,2881060854
2025-06-19 01:52:16,REAL,2869942313,481,2869942794,2881061335
2025-06-19 01:52:18,REAL,2869942794,478,2869943272,2881061813
2025-06-19 01:52:20,FAKE,2869943272,241,2869943513,2881062298
2025-06-19 01:52:22,REAL,2869943513,485,2869943998,2881062783
2025-06-19 01:52:24,REAL,2869943998,484,2869944482,2881063267
2025-06-19 01:52:26,REAL,2869944482,487,2869944969,2881063754
2025-06-19 01:52:28,REAL,2869944969,540,2869945509,2881064294
2025-06-19 01:52:30,REAL,2869945509,480,2869945989,2881064774
2025-06-19 01:52:32,REAL,2869945989,488,2869946477,2881065262
2025-06-19 01:52:34,REAL,2869946477,539,2869947016,2881065801
2025-06-19 01:52:36,REAL,2869947016,485,2869947501,2881066286
2025-06-19 01:52:38,FAKE,2869947501,241,2869947742,2881066777
2025-06-19 01:52:40,REAL,2869947742,488,2869948230,2881067265
2025-06-19 01:52:42,REAL,2869948230,488,2869948718,2881067753
2025-06-19 01:52:44,REAL,2869948718,491,2869949209,2881068244
2025-06-19 01:52:46,REAL,2869949209,483,2869949692,2881068727
2025-06-19 01:52:48,REAL,2869949692,487,2869950179,2881069214
2025-06-19 01:52:50,REAL,2869950179,488,2869950667,2881069702
2025-06-19 01:52:52,REAL,2869950667,493,2869951160,2881070195
2025-06-19 01:52:54,FAKE,2869951160,238,2869951398,2881070741
2025-06-19 01:52:56,FAKE,2869951398,241,2869951639,2881071234
2025-06-19 01:52:58,REAL,2869951639,481,2869952120,2881071715
2025-06-19 01:53:00,REAL,2869952120,486,2869952606,2881072201
2025-06-19 01:53:02,REAL,2869952606,479,2869953085,2881072680
2025-06-19 01:53:04,FAKE,2869953085,241,2869953326,2881073164
2025-06-19 01:53:06,REAL,2869953326,538,2869953864,2881073702
2025-06-19 01:53:08,REAL,2869953864,491,2869954355,2881074193
2025-06-19 01:53:10,FAKE,2869954355,241,2869954596,2881074683
2025-06-19 01:53:12,REAL,2869954596,491,2869955087,2881075174
2025-06-19 01:53:14,REAL,2869955087,484,2869955571,2881075658
2025-06-19 01:53:16,FAKE,2869955571,241,2869955812,2881076144
2025-06-19 01:53:18,REAL,2869955812,477,2869956289,2881076621
2025-06-19 01:53:20,REAL,2869956289,485,2869956774,2881077106
2025-06-19 01:53:22,FAKE,2869956774,241,2869957015,2881077652
2025-06-19 01:53:24,REAL,2869957015,479,2869957494,2881078131
2025-06-19 01:53:26,REAL,2869957494,482,2869957976,2881078613
2025-06-19 01:53:28,REAL,2869957976,480,2869958456,2881079093
2025-06-19 01:53:30,REAL,2869958456,486,2869958942,2881079579
2025-06-19 01:53:32,REAL,2869958942,488,2869959430,2881080067
2025-06-19 01:53:34,FAKE,2869959430,243,2869959673,2881080558
2025-06-19 01:53:36,REAL,2869959673,536,2869960209,2881081094
2025-06-19 01:53:38,FAKE,2869960209,244,2869960453,2881081585
2025-06-19 01:53:40,REAL,2869960453,484,2869960937,2881082069
2025-06-19 01:53:42,REAL,2869960937,477,2869961414,2881082546
2025-06-19 01:53:44,REAL,2869961414,477,2869961891,2881083023
2025-06-19 01:53:46,REAL,2869961891,8685,2869970576,2881091708
2025-06-19 01:53:48,REAL,2869970576,10722,2869981298,2881102430
2025-06-19 01:53:50,REAL,2869981298,10246,2869991544,2881112676
2025-06-19 01:53:52,REAL,2869991544,10255,2870001799,2881122931
2025-06-19 01:53:54,FAKE,2870001799,244,2870002043,2881133251
2025-06-19 01:53:56,FAKE,2870002043,241,2870002284,2881143502
2025-06-19 01:53:58,REAL,2870002284,10244,2870012528,2881153746
2025-06-19 01:54:00,REAL,2870012528,8198,2870020726,2881161944
2025-06-19 01:54:02,FAKE,2870020726,241,2870020967,2881162427
2025-06-19 01:54:04,REAL,2870020967,482,2870021449,2881162909
2025-06-19 01:54:06,FAKE,2870021449,243,2870021692,2881163448
2025-06-19 01:54:08,REAL,2870021692,486,2870022178,2881163934
2025-06-19 01:54:10,REAL,2870022178,484,2870022662,2881164418
2025-06-19 01:54:12,REAL,2870022662,489,2870023151,2881164907
2025-06-19 01:54:14,REAL,2870023151,543,2870023694,2881165450
2025-06-19 01:54:16,REAL,2870023694,490,2870024184,2881165940
2025-06-19 01:54:18,REAL,2870024184,480,2870024664,2881166420
2025-06-19 01:54:20,FAKE,2870024664,238,2870024902,2881166903
2025-06-19 01:54:22,REAL,2870024902,486,2870025388,2881167389
2025-06-19 01:54:24,REAL,2870025388,483,2870025871,2881167872
2025-06-19 01:54:26,REAL,2870025871,490,2870026361,2881168362
2025-06-19 01:54:28,REAL,2870026361,480,2870026841,2881168842
2025-06-19 01:54:30,FAKE,2870026841,244,2870027085,2881169326
2025-06-19 01:54:32,REAL,2870027085,482,2870027567,2881169808
2025-06-19 01:54:34,REAL,2870027567,487,2870028054,2881170295
2025-06-19 01:54:36,FAKE,2870028054,238,2870028292,2881170782
2025-06-19 01:54:38,REAL,2870028292,543,2870028835,2881171325
2025-06-19 01:54:40,FAKE,2870028835,244,2870029079,2881171813
2025-06-19 01:54:42,FAKE,2870029079,241,2870029320,2881172351
2025-06-19 01:54:44,FAKE,2870029320,238,2870029558,2881172840
2025-06-19 01:54:46,REAL,2870029558,488,2870030046,2881173328
2025-06-19 01:54:48,REAL,2870030046,485,2870030531,2881173813
2025-06-19 01:54:50,FAKE,2870030531,244,2870030775,2881174297
2025-06-19 01:54:52,FAKE,2870030775,244,2870031019,2881174785
2025-06-19 01:54:54,FAKE,2870031019,243,2870031262,2881175272
2025-06-19 01:54:56,FAKE,2870031262,238,2870031500,2881175759
2025-06-19 01:54:58,REAL,2870031500,487,2870031987,2881176246
2025-06-19 01:55:00,REAL,2870031987,478,2870032465,2881176724
2025-06-19 01:55:02,FAKE,2870032465,244,2870032709,2881177207
2025-06-19 01:55:04,REAL,2870032709,481,2870033190,2881177688
2025-06-19 01:55:06,FAKE,2870033190,241,2870033431,2881188556
2025-06-19 01:55:08,REAL,2870033431,10507,2870043938,2881199063
2025-06-19 01:55:10,REAL,2870043938,10243,2870054181,2881209306
2025-06-19 01:55:12,FAKE,2870054181,243,2870054424,2881219630
2025-06-19 01:55:14,REAL,2870054424,10249,2870064673,2881229879
2025-06-19 01:55:16,REAL,2870064673,10251,2870074924,2881240130
2025-06-19 01:55:18,REAL,2870074924,10320,2870085244,2881250450
2025-06-19 01:55:20,REAL,2870085244,6617,2870091861,2881257067
2025-06-19 01:55:22,REAL,2870091861,488,2870092349,2881257555
2025-06-19 01:55:24,REAL,2870092349,485,2870092834,2881258040
2025-06-19 01:55:26,REAL,2870092834,476,2870093310,2881258516
2025-06-19 01:55:28,REAL,2870093310,477,2870093787,2881258993
2025-06-19 01:55:30,REAL,2870093787,483,2870094270,2881259476
2025-06-19 01:55:32,FAKE,2870094270,243,2870094513,2881259968
2025-06-19 01:55:34,FAKE,2870094513,243,2870094756,2881260505
2025-06-19 01:55:36,FAKE,2870094756,243,2870094999,2881260987
2025-06-19 01:55:38,REAL,2870094999,11390,2870106389,2881272377
2025-06-19 01:55:40,REAL,2870106389,10309,2870116698,2881282686
2025-06-19 01:55:42,REAL,2870116698,10245,2870126943,2881292931
2025-06-19 01:55:44,REAL,2870126943,10255,2870137198,2881303186
2025-06-19 01:55:46,FAKE,2870137198,238,2870137436,2881313510
2025-06-19 01:55:48,REAL,2870137436,10257,2870147693,2881323767
2025-06-19 01:55:50,FAKE,2870147693,241,2870147934,2881334025
2025-06-19 01:55:52,FAKE,2870147934,243,2870148177,2881339989
2025-06-19 01:55:54,REAL,2870148177,489,2870148666,2881340478
2025-06-19 01:55:56,FAKE,2870148666,243,2870148909,2881340967
2025-06-19 01:55:58,REAL,2870148909,485,2870149394,2881341452
2025-06-19 01:56:00,REAL,2870149394,486,2870149880,2881341938
2025-06-19 01:56:02,REAL,2870149880,481,2870150361,2881342419
2025-06-19 01:56:04,REAL,2870150361,542,2870150903,2881342961
2025-06-19 01:56:06,REAL,2870150903,540,2870151443,2881343501
2025-06-19 01:56:08,REAL,2870151443,490,2870151933,2881343991
2025-06-19 01:56:10,REAL,2870151933,491,2870152424,2881344482
2025-06-19 01:56:12,FAKE,2870152424,238,2870152662,2881344966
2025-06-19 01:56:14,REAL,2870152662,488,2870153150,2881345454
2025-06-19 01:56:16,REAL,2870153150,489,2870153639,2881345943
2025-06-19 01:56:18,FAKE,2870153639,243,2870153882,2881346435
2025-06-19 01:56:20,REAL,2870153882,481,2870154363,2881346916
2025-06-19 01:56:22,REAL,2870154363,477,2870154840,2881347393
2025-06-19 01:56:24,REAL,2870154840,478,2870155318,2881347871
2025-06-19 01:56:26,FAKE,2870155318,241,2870155559,2881348356
2025-06-19 01:56:28,FAKE,2870155559,244,2870155803,2881348845
2025-06-19 01:56:30,REAL,2870155803,7026,2870162829,2881355871
2025-06-19 01:56:32,FAKE,2870162829,238,2870163067,2881367042
2025-06-19 01:56:34,REAL,2870163067,10301,2870173368,2881377343
2025-06-19 01:56:36,FAKE,2870173368,244,2870173612,2881387664
2025-06-19 01:56:38,REAL,2870173612,10245,2870183857,2881397909
2025-06-19 01:56:40,REAL,2870183857,10254,2870194111,2881408163
2025-06-19 01:56:42,REAL,2870194111,10318,2870204429,2881418481
2025-06-19 01:56:44,FAKE,2870204429,238,2870204667,2881428327
2025-06-19 01:56:46,REAL,2870204667,482,2870205149,2881428809
2025-06-19 01:56:48,REAL,2870205149,484,2870205633,2881429293
2025-06-19 01:56:50,FAKE,2870205633,241,2870205874,2881429780
2025-06-19 01:56:52,REAL,2870205874,478,2870206352,2881430258
2025-06-19 01:56:54,REAL,2870206352,487,2870206839,2881430745
2025-06-19 01:56:56,REAL,2870206839,481,2870207320,2881431226
2025-06-19 01:56:58,FAKE,2870207320,244,2870207564,2881431766
2025-06-19 01:57:00,REAL,2870207564,549,2870208113,2881432315
2025-06-19 01:57:02,REAL,2870208113,7491,2870215604,2881439806
2025-06-19 01:57:04,REAL,2870215604,10930,2870226534,2881450736
2025-06-19 01:57:06,FAKE,2870226534,244,2870226778,2881460991
2025-06-19 01:57:08,FAKE,2870226778,238,2870227016,2881471313
2025-06-19 01:57:10,REAL,2870227016,10252,2870237268,2881481565
2025-06-19 01:57:12,REAL,2870237268,10257,2870247525,2881491822
2025-06-19 01:57:14,FAKE,2870247525,238,2870247763,2881502132
2025-06-19 01:57:16,FAKE,2870247763,238,2870248001,2881511399
2025-06-19 01:57:18,FAKE,2870248001,243,2870248244,2881511887
2025-06-19 01:57:20,FAKE,2870248244,238,2870248482,2881512375
2025-06-19 01:57:22,FAKE,2870248482,238,2870248720,2881512862
2025-06-19 01:57:24,FAKE,2870248720,238,2870248958,2881513346
2025-06-19 01:57:26,FAKE,2870248958,244,2870249202,2881513827
2025-06-19 01:57:28,REAL,2870249202,602,2870249804,2881514429
2025-06-19 01:57:30,REAL,2870249804,481,2870250285,2881514910
2025-06-19 01:57:32,FAKE,2870250285,241,2870250526,2881515401
2025-06-19 01:57:34,REAL,2870250526,481,2870251007,2881515882
2025-06-19 01:57:36,REAL,2870251007,480,2870251487,2881516362
2025-06-19 01:57:38,REAL,2870251487,493,2870251980,2881516855
2025-06-19 01:57:40,REAL,2870251980,484,2870252464,2881517339
2025-06-19 01:57:42,REAL,2870252464,490,2870252954,2881517829
2025-06-19 01:57:44,REAL,2870252954,482,2870253436,2881518311
2025-06-19 01:57:46,REAL,2870253436,483,2870253919,2881518794
2025-06-19 01:57:48,REAL,2870253919,484,2870254403,2881519278
2025-06-19 01:57:50,FAKE,2870254403,241,2870254644,2881519765
2025-06-19 01:57:52,REAL,2870254644,485,2870255129,2881520250
2025-06-19 01:57:54,REAL,2870255129,490,2870255619,2881520740
2025-06-19 01:57:56,REAL,2870255619,538,2870256157,2881521278
2025-06-19 01:57:58,REAL,2870256157,535,2870256692,2881521813
2025-06-19 01:58:00,REAL,2870256692,485,2870257177,2881522298
2025-06-19 01:58:02,FAKE,2870257177,241,2870257418,2881522787
2025-06-19 01:58:04,REAL,2870257418,483,2870257901,2881523270
2025-06-19 01:58:06,REAL,2870257901,10321,2870268222,2881533591
2025-06-19 01:58:08,REAL,2870268222,11766,2870279988,2881545357
2025-06-19 01:58:10,REAL,2870279988,10254,2870290242,2881555611
2025-06-19 01:58:12,REAL,2870290242,10322,2870300564,2881565933
2025-06-19 01:58:14,REAL,2870300564,10249,2870310813,2881576182
2025-06-19 01:58:16,REAL,2870310813,10323,2870321136,2881586505
2025-06-19 01:58:18,REAL,2870321136,10248,2870331384,2881596753
2025-06-19 01:58:20,FAKE,2870331384,241,2870331625,2881604761
2025-06-19 01:58:22,REAL,2870331625,544,2870332169,2881605305
2025-06-19 01:58:24,REAL,2870332169,486,2870332655,2881605791
2025-06-19 01:58:26,FAKE,2870332655,244,2870332899,2881606274
2025-06-19 01:58:28,REAL,2870332899,493,2870333392,2881606767
2025-06-19 01:58:30,REAL,2870333392,493,2870333885,2881607260
2025-06-19 01:58:32,FAKE,2870333885,244,2870334129,2881607805
2025-06-19 01:58:34,FAKE,2870334129,244,2870334373,2881608287
2025-06-19 01:58:36,REAL,2870334373,481,2870334854,2881608768
2025-06-19 01:58:38,REAL,2870334854,9737,2870344591,2881618505
2025-06-19 01:58:40,FAKE,2870344591,241,2870344832,2881629021
2025-06-19 01:58:42,FAKE,2870344832,244,2870345076,2881639266
2025-06-19 01:58:44,REAL,2870345076,10255,2870355331,2881649521
2025-06-19 01:58:46,REAL,2870355331,10243,2870365574,2881659764
2025-06-19 01:58:48,REAL,2870365574,10314,2870375888,2881670078
2025-06-19 01:58:50,FAKE,2870375888,241,2870376129,2881680385
2025-06-19 01:58:52,FAKE,2870376129,244,2870376373,2881687809
2025-06-19 01:58:54,FAKE,2870376373,241,2870376614,2881688296
2025-06-19 01:58:56,FAKE,2870376614,244,2870376858,2881688773
2025-06-19 01:58:58,REAL,2870376858,482,2870377340,2881689255
2025-06-19 01:59:00,REAL,2870377340,489,2870377829,2881689744
2025-06-19 01:59:02,REAL,2870377829,480,2870378309,2881690224
2025-06-19 01:59:04,FAKE,2870378309,244,2870378553,2881690762
2025-06-19 01:59:06,FAKE,2870378553,238,2870378791,2881691244
2025-06-19 01:59:08,FAKE,2870378791,238,2870379029,2881691723
2025-06-19 01:59:10,REAL,2870379029,10193,2870389222,2881701916
2025-06-19 01:59:12,FAKE,2870389222,244,2870389466,2881712299
2025-06-19 01:59:14,FAKE,2870389466,238,2870389704,2881722554
2025-06-19 01:59:16,FAKE,2870389704,244,2870389948,2881732868
2025-06-19 01:59:18,REAL,2870389948,10308,2870400256,2881743176
2025-06-19 01:59:20,REAL,2870400256,10243,2870410499,2881753419
2025-06-19 01:59:22,FAKE,2870410499,243,2870410742,2881763677
2025-06-19 01:59:24,FAKE,2870410742,244,2870410986,2881770489
2025-06-19 01:59:26,REAL,2870410986,485,2870411471,2881770974
2025-06-19 01:59:28,REAL,2870411471,482,2870411953,2881771456
2025-06-19 01:59:30,REAL,2870411953,474,2870412427,2881771930
2025-06-19 01:59:32,FAKE,2870412427,244,2870412671,2881772417
2025-06-19 01:59:34,FAKE,2870412671,238,2870412909,2881772909
2025-06-19 01:59:36,REAL,2870412909,549,2870413458,2881773458
2025-06-19 01:59:38,REAL,2870413458,483,2870413941,2881773941
2025-06-19 01:59:40,REAL,2870413941,482,2870414423,2881774423
2025-06-19 01:59:42,FAKE,2870414423,243,2870414666,2881774909
2025-06-19 01:59:44,REAL,2870414666,541,2870415207,2881775450
2025-06-19 01:59:46,REAL,2870415207,6243,2870421450,2881781693
2025-06-19 01:59:48,REAL,2870421450,13885,2870435335,2881795578
2025-06-19 01:59:50,REAL,2870435335,10313,2870445648,2881805891
2025-06-19 01:59:52,FAKE,2870445648,238,2870445886,2881816150
2025-06-19 01:59:54,REAL,2870445886,10257,2870456143,2881826407
2025-06-19 01:59:56,REAL,2870456143,10251,2870466394,2881836658
2025-06-19 01:59:58,FAKE,2870466394,243,2870466637,2881846968
2025-06-19 02:00:00,REAL,2870466637,10254,2870476891,2881857222
2025-06-19 02:00:02,REAL,2870476891,1148,2870478039,2881858370
2025-06-19 02:00:04,FAKE,2870478039,241,2870478280,2881858863
2025-06-19 02:00:06,REAL,2870478280,475,2870478755,2881859338
2025-06-19 02:00:08,REAL,2870478755,485,2870479240,2881859823
2025-06-19 02:00:10,REAL,2870479240,480,2870479720,2881860303
2025-06-19 02:00:12,REAL,2870479720,537,2870480257,2881860840
2025-06-19 02:00:14,REAL,2870480257,481,2870480738,2881861321
2025-06-19 02:00:16,REAL,2870480738,481,2870481219,2881861802
2025-06-19 02:00:18,FAKE,2870481219,244,2870481463,2881867842
2025-06-19 02:00:20,FAKE,2870481463,244,2870481707,2881878691
2025-06-19 02:00:22,REAL,2870481707,10249,2870491956,2881888940
2025-06-19 02:00:24,FAKE,2870491956,238,2870492194,2881899189
2025-06-19 02:00:26,REAL,2870492194,10323,2870502517,2881909512
2025-06-19 02:00:28,REAL,2870502517,10259,2870512776,2881919771
2025-06-19 02:00:30,REAL,2870512776,10249,2870523025,2881930020
2025-06-19 02:00:32,REAL,2870523025,10255,2870533280,2881940275
2025-06-19 02:00:34,REAL,2870533280,616,2870533896,2881940891
2025-06-19 02:00:36,REAL,2870533896,482,2870534378,2881941373
2025-06-19 02:00:38,REAL,2870534378,477,2870534855,2881941850
2025-06-19 02:00:40,FAKE,2870534855,238,2870535093,2881942341
2025-06-19 02:00:42,REAL,2870535093,483,2870535576,2881942824
2025-06-19 02:00:44,REAL,2870535576,483,2870536059,2881943307
2025-06-19 02:00:46,FAKE,2870536059,244,2870536303,2881943794
2025-06-19 02:00:48,FAKE,2870536303,243,2870536546,2881944281
2025-06-19 02:00:50,REAL,2870536546,484,2870537030,2881944765
2025-06-19 02:00:52,FAKE,2870537030,244,2870537274,2881945249
2025-06-19 02:00:54,REAL,2870537274,484,2870537758,2881945733
2025-06-19 02:00:56,REAL,2870537758,481,2870538239,2881946214
2025-06-19 02:00:58,REAL,2870538239,482,2870538721,2881946696
2025-06-19 02:01:00,REAL,2870538721,487,2870539208,2881947183
2025-06-19 02:01:02,FAKE,2870539208,244,2870539452,2881947667
2025-06-19 02:01:04,REAL,2870539452,547,2870539999,2881948214
2025-06-19 02:01:06,FAKE,2870539999,243,2870540242,2881948759
2025-06-19 02:01:08,REAL,2870540242,481,2870540723,2881949240
2025-06-19 02:01:10,FAKE,2870540723,238,2870540961,2881950191
2025-06-19 02:01:12,REAL,2870540961,15334,2870556295,2881965525
2025-06-19 02:01:14,REAL,2870556295,10319,2870566614,2881975844
2025-06-19 02:01:16,REAL,2870566614,10252,2870576866,2881986096
2025-06-19 02:01:18,REAL,2870576866,10246,2870587112,2881996342
2025-06-19 02:01:20,REAL,2870587112,10318,2870597430,2882006660
2025-06-19 02:01:22,REAL,2870597430,10257,2870607687,2882016917
2025-06-19 02:01:24,FAKE,2870607687,243,2870607930,2882027171
2025-06-19 02:01:26,FAKE,2870607930,243,2870608173,2882031819
2025-06-19 02:01:28,REAL,2870608173,486,2870608659,2882032305
2025-06-19 02:01:30,REAL,2870608659,478,2870609137,2882032783
2025-06-19 02:01:32,REAL,2870609137,475,2870609612,2882033258
2025-06-19 02:01:34,FAKE,2870609612,243,2870609855,2882033750
2025-06-19 02:01:36,FAKE,2870609855,238,2870610093,2882034234
2025-06-19 02:01:38,REAL,2870610093,487,2870610580,2882034721
2025-06-19 02:01:40,REAL,2870610580,482,2870611062,2882035203
2025-06-19 02:01:42,REAL,2870611062,2076,2870613138,2882037279
2025-06-19 02:01:44,REAL,2870613138,11707,2870624845,2882048986
2025-06-19 02:01:46,REAL,2870624845,10262,2870635107,2882059248
2025-06-19 02:01:48,FAKE,2870635107,241,2870635348,2882069502
2025-06-19 02:01:50,REAL,2870635348,10317,2870645665,2882079819
2025-06-19 02:01:52,REAL,2870645665,10261,2870655926,2882090080
2025-06-19 02:01:54,REAL,2870655926,10319,2870666245,2882100399
2025-06-19 02:01:56,REAL,2870666245,10311,2870676556,2882110710
2025-06-19 02:01:58,REAL,2870676556,4048,2870680604,2882114758
2025-06-19 02:02:00,FAKE,2870680604,241,2870680845,2882115241
2025-06-19 02:02:02,REAL,2870680845,486,2870681331,2882115727
2025-06-19 02:02:04,FAKE,2870681331,244,2870681575,2882124006
2025-06-19 02:02:06,FAKE,2870681575,238,2870681813,2882134789
2025-06-19 02:02:08,REAL,2870681813,10259,2870692072,2882145048
2025-06-19 02:02:10,REAL,2870692072,10257,2870702329,2882155305
2025-06-19 02:02:12,REAL,2870702329,10248,2870712577,2882165553
2025-06-19 02:02:14,REAL,2870712577,10260,2870722837,2882175813
2025-06-19 02:02:16,REAL,2870722837,10320,2870733157,2882186133
2025-06-19 02:02:18,FAKE,2870733157,238,2870733395,2882194743
2025-06-19 02:02:20,REAL,2870733395,483,2870733878,2882195226
2025-06-19 02:02:22,REAL,2870733878,481,2870734359,2882195707
2025-06-19 02:02:24,FAKE,2870734359,243,2870734602,2882196190
2025-06-19 02:02:26,FAKE,2870734602,238,2870734840,2882196679
2025-06-19 02:02:28,FAKE,2870734840,243,2870735083,2882197153
2025-06-19 02:02:30,REAL,2870735083,481,2870735564,2882197634
2025-06-19 02:02:32,REAL,2870735564,478,2870736042,2882198112
2025-06-19 02:02:34,FAKE,2870736042,238,2870736280,2882198592
2025-06-19 02:02:36,FAKE,2870736280,241,2870736521,2882199077
2025-06-19 02:02:38,REAL,2870736521,484,2870737005,2882199561
2025-06-19 02:02:40,REAL,2870737005,489,2870737494,2882200050
2025-06-19 02:02:42,REAL,2870737494,481,2870737975,2882200531
2025-06-19 02:02:44,FAKE,2870737975,243,2870738218,2882201009
2025-06-19 02:02:46,REAL,2870738218,542,2870738760,2882201551
2025-06-19 02:02:48,REAL,2870738760,480,2870739240,2882202031
2025-06-19 02:02:50,REAL,2870739240,487,2870739727,2882202518
2025-06-19 02:02:52,REAL,2870739727,539,2870740266,2882203057
2025-06-19 02:02:54,REAL,2870740266,489,2870740755,2882203546
2025-06-19 02:02:56,REAL,2870740755,480,2870741235,2882204026
2025-06-19 02:02:58,REAL,2870741235,481,2870741716,2882204507
2025-06-19 02:03:00,REAL,2870741716,481,2870742197,2882204988
2025-06-19 02:03:02,FAKE,2870742197,241,2870742438,2882205480
2025-06-19 02:03:04,REAL,2870742438,493,2870742931,2882205973
2025-06-19 02:03:06,FAKE,2870742931,244,2870743175,2882206452
2025-06-19 02:03:08,FAKE,2870743175,238,2870743413,2882206934
2025-06-19 02:03:10,REAL,2870743413,483,2870743896,2882207417
2025-06-19 02:03:12,FAKE,2870743896,244,2870744140,2882207905
2025-06-19 02:03:14,REAL,2870744140,483,2870744623,2882208388
2025-06-19 02:03:16,FAKE,2870744623,244,2870744867,2882208866
2025-06-19 02:03:18,REAL,2870744867,479,2870745346,2882209345
2025-06-19 02:03:20,REAL,2870745346,485,2870745831,2882209830
2025-06-19 02:03:22,REAL,2870745831,481,2870746312,2882210311
2025-06-19 02:03:24,REAL,2870746312,483,2870746795,2882210794
2025-06-19 02:03:26,REAL,2870746795,492,2870747287,2882211286
2025-06-19 02:03:28,REAL,2870747287,490,2870747777,2882211776
2025-06-19 02:03:30,REAL,2870747777,491,2870748268,2882212267
2025-06-19 02:03:32,REAL,2870748268,484,2870748752,2882212751
2025-06-19 02:03:34,REAL,2870748752,493,2870749245,2882213244
2025-06-19 02:03:36,REAL,2870749245,486,2870749731,2882213730
2025-06-19 02:03:38,FAKE,2870749731,244,2870749975,2882214273
2025-06-19 02:03:40,FAKE,2870749975,238,2870750213,2882214814
2025-06-19 02:03:42,REAL,2870750213,482,2870750695,2882215296
2025-06-19 02:03:44,REAL,2870750695,4975,2870755670,2882220271
2025-06-19 02:03:46,FAKE,2870755670,244,2870755914,2882231512
2025-06-19 02:03:48,FAKE,2870755914,243,2870756157,2882241767
2025-06-19 02:03:50,REAL,2870756157,10257,2870766414,2882252024
2025-06-19 02:03:52,REAL,2870766414,10320,2870776734,2882262344
2025-06-19 02:03:54,REAL,2870776734,10257,2870786991,2882272601
2025-06-19 02:03:56,REAL,2870786991,10258,2870797249,2882282859
2025-06-19 02:03:58,REAL,2870797249,10313,2870807562,2882293172
2025-06-19 02:04:00,REAL,2870807562,1738,2870809300,2882294910
2025-06-19 02:04:02,FAKE,2870809300,243,2870809543,2882295391
2025-06-19 02:04:04,FAKE,2870809543,244,2870809787,2882295883
2025-06-19 02:04:06,REAL,2870809787,490,2870810277,2882296373
2025-06-19 02:04:08,REAL,2870810277,479,2870810756,2882296852
2025-06-19 02:04:10,FAKE,2870810756,243,2870810999,2882297338
2025-06-19 02:04:12,FAKE,2870810999,241,2870811240,2882297819
2025-06-19 02:04:14,FAKE,2870811240,243,2870811483,2882298311
2025-06-19 02:04:16,FAKE,2870811483,244,2870811727,2882303959
2025-06-19 02:04:18,FAKE,2870811727,238,2870811965,2882315268
2025-06-19 02:04:20,FAKE,2870811965,243,2870812208,2882325588
2025-06-19 02:04:22,REAL,2870812208,10316,2870822524,2882335904
2025-06-19 02:04:24,FAKE,2870822524,243,2870822767,2882346161
2025-06-19 02:04:26,REAL,2870822767,10317,2870833084,2882356478
2025-06-19 02:04:28,REAL,2870833084,10255,2870843339,2882366733
2025-06-19 02:04:30,REAL,2870843339,10309,2870853648,2882377042
2025-06-19 02:04:32,REAL,2870853648,1209,2870854857,2882378251
2025-06-19 02:04:34,REAL,2870854857,478,2870855335,2882378729
2025-06-19 02:04:36,REAL,2870855335,486,2870855821,2882379215
2025-06-19 02:04:38,REAL,2870855821,485,2870856306,2882379700
2025-06-19 02:04:40,REAL,2870856306,492,2870856798,2882380192
2025-06-19 02:04:42,FAKE,2870856798,243,2870857041,2882380685
2025-06-19 02:04:44,REAL,2870857041,490,2870857531,2882381175
2025-06-19 02:04:46,FAKE,2870857531,238,2870857769,2882381666
2025-06-19 02:04:48,REAL,2870857769,6163,2870863932,2882387829
2025-06-19 02:04:50,REAL,2870863932,11240,2870875172,2882399069
2025-06-19 02:04:52,REAL,2870875172,10315,2870885487,2882409384
2025-06-19 02:04:54,REAL,2870885487,10255,2870895742,2882419639
2025-06-19 02:04:56,REAL,2870895742,10250,2870905992,2882429889
2025-06-19 02:04:58,REAL,2870905992,10322,2870916314,2882440211
2025-06-19 02:05:00,REAL,2870916314,10261,2870926575,2882450472
2025-06-19 02:05:02,REAL,2870926575,10311,2870936886,2882460783
2025-06-19 02:05:04,FAKE,2870936886,241,2870937127,2882461274
2025-06-19 02:05:06,REAL,2870937127,492,2870937619,2882461766
2025-06-19 02:05:08,REAL,2870937619,474,2870938093,2882462240
2025-06-19 02:05:10,REAL,2870938093,480,2870938573,2882462720
2025-06-19 02:05:12,REAL,2870938573,481,2870939054,2882463201
2025-06-19 02:05:14,REAL,2870939054,491,2870939545,2882463692
2025-06-19 02:05:16,REAL,2870939545,476,2870940021,2882464168
2025-06-19 02:05:18,FAKE,2870940021,244,2870940265,2882464642
2025-06-19 02:05:20,REAL,2870940265,6820,2870947085,2882471462
2025-06-19 02:05:22,FAKE,2870947085,241,2870947326,2882482179
2025-06-19 02:05:24,REAL,2870947326,10256,2870957582,2882492435
2025-06-19 02:05:26,REAL,2870957582,10249,2870967831,2882502684
2025-06-19 02:05:28,REAL,2870967831,10317,2870978148,2882513001
2025-06-19 02:05:30,REAL,2870978148,10015,2870988163,2882523016
2025-06-19 02:05:32,FAKE,2870988163,238,2870988401,2882533336
2025-06-19 02:05:34,REAL,2870988401,9656,2870998057,2882542992
2025-06-19 02:05:36,REAL,2870998057,481,2870998538,2882543473
2025-06-19 02:05:38,REAL,2870998538,484,2870999022,2882543957
2025-06-19 02:05:40,REAL,2870999022,479,2870999501,2882544436
2025-06-19 02:05:42,REAL,2870999501,483,2870999984,2882544919
2025-06-19 02:05:44,REAL,2870999984,491,2871000475,2882545410
2025-06-19 02:05:46,REAL,2871000475,489,2871000964,2882545899
2025-06-19 02:05:48,REAL,2871000964,483,2871001447,2882546382
2025-06-19 02:05:50,REAL,2871001447,485,2871001932,2882546867
2025-06-19 02:05:52,REAL,2871001932,534,2871002466,2882547401
2025-06-19 02:05:54,REAL,2871002466,481,2871002947,2882547882
2025-06-19 02:05:56,REAL,2871002947,475,2871003422,2882548357
2025-06-19 02:05:58,REAL,2871003422,485,2871003907,2882548842
2025-06-19 02:06:00,FAKE,2871003907,238,2871004145,2882549328
2025-06-19 02:06:02,REAL,2871004145,474,2871004619,2882549802
2025-06-19 02:06:04,REAL,2871004619,486,2871005105,2882550288
2025-06-19 02:06:06,REAL,2871005105,490,2871005595,2882550778
2025-06-19 02:06:08,FAKE,2871005595,243,2871005838,2882551253
2025-06-19 02:06:10,REAL,2871005838,481,2871006319,2882551734
2025-06-19 02:06:12,FAKE,2871006319,241,2871006560,2882552272
2025-06-19 02:06:14,FAKE,2871006560,244,2871006804,2882552753
2025-06-19 02:06:16,REAL,2871006804,483,2871007287,2882553236
2025-06-19 02:06:18,REAL,2871007287,481,2871007768,2882553717
2025-06-19 02:06:20,REAL,2871007768,483,2871008251,2882554200
2025-06-19 02:06:22,REAL,2871008251,486,2871008737,2882554686
2025-06-19 02:06:24,REAL,2871008737,7888,2871016625,2882562574
2025-06-19 02:06:26,REAL,2871016625,10844,2871027469,2882573418
2025-06-19 02:06:28,FAKE,2871027469,244,2871027713,2882583668
2025-06-19 02:06:30,REAL,2871027713,10246,2871037959,2882593914
2025-06-19 02:06:32,FAKE,2871037959,238,2871038197,2882604162
2025-06-19 02:06:34,REAL,2871038197,10259,2871048456,2882614421
2025-06-19 02:06:36,REAL,2871048456,10261,2871058717,2882624682
2025-06-19 02:06:38,REAL,2871058717,8464,2871067181,2882633146
2025-06-19 02:06:40,REAL,2871067181,489,2871067670,2882633635
2025-06-19 02:06:42,FAKE,2871067670,244,2871067914,2882634118
2025-06-19 02:06:44,REAL,2871067914,489,2871068403,2882634607
2025-06-19 02:06:46,FAKE,2871068403,241,2871068644,2882635145
2025-06-19 02:06:48,REAL,2871068644,489,2871069133,2882635634
2025-06-19 02:06:50,REAL,2871069133,480,2871069613,2882636114
2025-06-19 02:06:52,REAL,2871069613,488,2871070101,2882636602
2025-06-19 02:06:54,FAKE,2871070101,238,2871070339,2882637091
2025-06-19 02:06:56,REAL,2871070339,8609,2871078948,2882645700
2025-06-19 02:06:58,REAL,2871078948,10654,2871089602,2882656354
2025-06-19 02:07:00,REAL,2871089602,10312,2871099914,2882666666
2025-06-19 02:07:02,REAL,2871099914,10251,2871110165,2882676917
2025-06-19 02:07:04,REAL,2871110165,10249,2871120414,2882687166
2025-06-19 02:07:06,FAKE,2871120414,244,2871120658,2882697478
2025-06-19 02:07:08,FAKE,2871120658,238,2871120896,2882707729
2025-06-19 02:07:10,REAL,2871120896,7804,2871128700,2882715533
2025-06-19 02:07:12,FAKE,2871128700,238,2871128938,2882716017
2025-06-19 02:07:14,REAL,2871128938,482,2871129420,2882716499
2025-06-19 02:07:16,REAL,2871129420,487,2871129907,2882716986
2025-06-19 02:07:18,REAL,2871129907,481,2871130388,2882717467
2025-06-19 02:07:20,REAL,2871130388,486,2871130874,2882717953
2025-06-19 02:07:22,REAL,2871130874,547,2871131421,2882718500
2025-06-19 02:07:24,REAL,2871131421,485,2871131906,2882718985
2025-06-19 02:07:26,REAL,2871131906,485,2871132391,2882719470
2025-06-19 02:07:28,REAL,2871132391,541,2871132932,2882720011
2025-06-19 02:07:30,FAKE,2871132932,241,2871133173,2882720486
2025-06-19 02:07:32,REAL,2871133173,478,2871133651,2882720964
2025-06-19 02:07:34,REAL,2871133651,482,2871134133,2882721446
2025-06-19 02:07:36,REAL,2871134133,481,2871134614,2882721927
2025-06-19 02:07:38,FAKE,2871134614,244,2871134858,2882722417
2025-06-19 02:07:40,REAL,2871134858,483,2871135341,2882722900
2025-06-19 02:07:42,REAL,2871135341,481,2871135822,2882723381
2025-06-19 02:07:44,FAKE,2871135822,238,2871136060,2882723861
2025-06-19 02:07:46,FAKE,2871136060,238,2871136298,2882724349
2025-06-19 02:07:48,REAL,2871136298,484,2871136782,2882724833
2025-06-19 02:07:50,REAL,2871136782,483,2871137265,2882725316
2025-06-19 02:07:52,REAL,2871137265,489,2871137754,2882725805
2025-06-19 02:07:54,REAL,2871137754,480,2871138234,2882726285
2025-06-19 02:07:56,FAKE,2871138234,238,2871138472,2882726817
2025-06-19 02:07:58,REAL,2871138472,487,2871138959,2882727304
2025-06-19 02:08:00,REAL,2871138959,13424,2871152383,2882740728
2025-06-19 02:08:02,REAL,2871152383,10581,2871162964,2882751309
2025-06-19 02:08:04,REAL,2871162964,10255,2871173219,2882761564
2025-06-19 02:08:06,REAL,2871173219,10254,2871183473,2882771818
2025-06-19 02:08:08,REAL,2871183473,10253,2871193726,2882782071
2025-06-19 02:08:10,REAL,2871193726,10254,2871203980,2882792325
2025-06-19 02:08:12,REAL,2871203980,10250,2871214230,2882802575
2025-06-19 02:08:14,FAKE,2871214230,238,2871214468,2882809139
2025-06-19 02:08:16,REAL,2871214468,484,2871214952,2882809623
2025-06-19 02:08:18,FAKE,2871214952,243,2871215195,2882810110
2025-06-19 02:08:20,FAKE,2871215195,243,2871215438,2882810594
2025-06-19 02:08:22,REAL,2871215438,485,2871215923,2882811079
2025-06-19 02:08:24,FAKE,2871215923,238,2871216161,2882811562
2025-06-19 02:08:26,REAL,2871216161,486,2871216647,2882812048
2025-06-19 02:08:28,REAL,2871216647,481,2871217128,2882812529
2025-06-19 02:08:30,FAKE,2871217128,241,2871217369,2882813016
2025-06-19 02:08:32,FAKE,2871217369,241,2871217610,2882813616
2025-06-19 02:08:34,REAL,2871217610,488,2871218098,2882814104
2025-06-19 02:08:36,REAL,2871218098,478,2871218576,2882814582
2025-06-19 02:08:38,REAL,2871218576,485,2871219061,2882815067
2025-06-19 02:08:40,REAL,2871219061,481,2871219542,2882815548
2025-06-19 02:08:42,REAL,2871219542,484,2871220026,2882816032
2025-06-19 02:08:44,REAL,2871220026,484,2871220510,2882816516
2025-06-19 02:08:46,REAL,2871220510,486,2871220996,2882817002
2025-06-19 02:08:48,FAKE,2871220996,238,2871221234,2882817480
2025-06-19 02:08:50,REAL,2871221234,480,2871221714,2882817960
2025-06-19 02:08:52,REAL,2871221714,482,2871222196,2882818442
2025-06-19 02:08:54,REAL,2871222196,488,2871222684,2882818930
2025-06-19 02:08:56,REAL,2871222684,484,2871223168,2882819414
2025-06-19 02:08:58,REAL,2871223168,481,2871223649,2882819895
2025-06-19 02:09:00,REAL,2871223649,479,2871224128,2882820374
2025-06-19 02:09:02,REAL,2871224128,481,2871224609,2882820855
2025-06-19 02:09:04,REAL,2871224609,11709,2871236318,2882832564
2025-06-19 02:09:06,REAL,2871236318,10326,2871246644,2882842890
2025-06-19 02:09:08,REAL,2871246644,10303,2871256947,2882853193
2025-06-19 02:09:10,REAL,2871256947,10251,2871267198,2882863444
2025-06-19 02:09:12,REAL,2871267198,10255,2871277453,2882873699
2025-06-19 02:09:14,REAL,2871277453,10319,2871287772,2882884018
2025-06-19 02:09:16,FAKE,2871287772,243,2871288015,2882894274
2025-06-19 02:09:18,REAL,2871288015,5298,2871293313,2882899572
2025-06-19 02:09:20,REAL,2871293313,490,2871293803,2882900062
2025-06-19 02:09:22,FAKE,2871293803,238,2871294041,2882900546
2025-06-19 02:09:24,FAKE,2871294041,243,2871294284,2882901034
2025-06-19 02:09:26,REAL,2871294284,487,2871294771,2882901521
2025-06-19 02:09:28,REAL,2871294771,490,2871295261,2882902011
2025-06-19 02:09:30,REAL,2871295261,484,2871295745,2882902495
2025-06-19 02:09:32,REAL,2871295745,486,2871296231,2882902981
2025-06-19 02:09:34,FAKE,2871296231,243,2871296474,2882904201
2025-06-19 02:09:36,REAL,2871296474,12164,2871308638,2882916365
2025-06-19 02:09:38,REAL,2871308638,10323,2871318961,2882926688
2025-06-19 02:09:40,FAKE,2871318961,238,2871319199,2882936948
2025-06-19 02:09:42,REAL,2871319199,10370,2871329569,2882947318
2025-06-19 02:09:44,FAKE,2871329569,244,2871329813,2882957571
2025-06-19 02:09:46,REAL,2871329813,10248,2871340061,2882967819
2025-06-19 02:09:48,REAL,2871340061,10246,2871350307,2882978065
2025-06-19 02:09:50,REAL,2871350307,4709,2871355016,2882982774
2025-06-19 02:09:52,FAKE,2871355016,243,2871355259,2882983254
2025-06-19 02:09:54,REAL,2871355259,490,2871355749,2882983744
2025-06-19 02:09:56,FAKE,2871355749,243,2871355992,2882984224
2025-06-19 02:09:58,FAKE,2871355992,243,2871356235,2882984705
2025-06-19 02:10:00,REAL,2871356235,485,2871356720,2882985190
2025-06-19 02:10:02,REAL,2871356720,487,2871357207,2882985677
2025-06-19 02:10:04,FAKE,2871357207,241,2871357448,2882986161
2025-06-19 02:10:06,FAKE,2871357448,244,2871357692,2882986650
2025-06-19 02:10:08,REAL,2871357692,490,2871358182,2882987140
2025-06-19 02:10:10,REAL,2871358182,539,2871358721,2882987679
2025-06-19 02:10:12,REAL,2871358721,488,2871359209,2882988167
2025-06-19 02:10:14,REAL,2871359209,478,2871359687,2882988645
2025-06-19 02:10:16,REAL,2871359687,485,2871360172,2882989130
2025-06-19 02:10:18,REAL,2871360172,539,2871360711,2882989669
2025-06-19 02:10:20,REAL,2871360711,478,2871361189,2882990147
2025-06-19 02:10:22,REAL,2871361189,488,2871361677,2882990635
2025-06-19 02:10:24,REAL,2871361677,479,2871362156,2882991114
2025-06-19 02:10:26,REAL,2871362156,486,2871362642,2882991600
2025-06-19 02:10:28,REAL,2871362642,480,2871363122,2882992080
2025-06-19 02:10:30,REAL,2871363122,485,2871363607,2882992565
2025-06-19 02:10:32,FAKE,2871363607,244,2871363851,2882993047
2025-06-19 02:10:34,FAKE,2871363851,244,2871364095,2882993531
2025-06-19 02:10:36,FAKE,2871364095,241,2871364336,2882994015
2025-06-19 02:10:38,REAL,2871364336,2674,2871367010,2882996689
2025-06-19 02:10:40,REAL,2871367010,11775,2871378785,2883008464
2025-06-19 02:10:42,REAL,2871378785,10313,2871389098,2883018777
2025-06-19 02:10:44,REAL,2871389098,10246,2871399344,2883029023
2025-06-19 02:10:46,REAL,2871399344,10245,2871409589,2883039268
2025-06-19 02:10:48,REAL,2871409589,10250,2871419839,2883049518
2025-06-19 02:10:50,FAKE,2871419839,243,2871420082,2883059841
2025-06-19 02:10:52,REAL,2871420082,10253,2871430335,2883070094
2025-06-19 02:10:54,REAL,2871430335,3383,2871433718,2883073477
2025-06-19 02:10:56,REAL,2871433718,484,2871434202,2883073961
2025-06-19 02:10:58,REAL,2871434202,489,2871434691,2883074450
2025-06-19 02:11:00,REAL,2871434691,477,2871435168,2883074927
2025-06-19 02:11:02,REAL,2871435168,485,2871435653,2883075412
2025-06-19 02:11:04,FAKE,2871435653,244,2871435897,2883075949
2025-06-19 02:11:06,REAL,2871435897,484,2871436381,2883076433
2025-06-19 02:11:08,FAKE,2871436381,238,2871436619,2883076911
2025-06-19 02:11:10,REAL,2871436619,490,2871437109,2883077401
2025-06-19 02:11:12,REAL,2871437109,482,2871437591,2883077883
2025-06-19 02:11:14,FAKE,2871437591,244,2871437835,2883078419
2025-06-19 02:11:16,FAKE,2871437835,238,2871438073,2883078911
2025-06-19 02:11:18,REAL,2871438073,483,2871438556,2883079394
2025-06-19 02:11:20,REAL,2871438556,490,2871439046,2883079884
2025-06-19 02:11:22,REAL,2871439046,486,2871439532,2883080370
2025-06-19 02:11:24,REAL,2871439532,479,2871440011,2883080849
2025-06-19 02:11:26,FAKE,2871440011,238,2871440249,2883081338
2025-06-19 02:11:28,FAKE,2871440249,238,2871440487,2883081826
2025-06-19 02:11:30,REAL,2871440487,484,2871440971,2883082310
2025-06-19 02:11:32,REAL,2871440971,484,2871441455,2883082794
2025-06-19 02:11:34,REAL,2871441455,481,2871441936,2883083275
2025-06-19 02:11:36,FAKE,2871441936,244,2871442180,2883083750
2025-06-19 02:11:38,REAL,2871442180,489,2871442669,2883084239
2025-06-19 02:11:40,REAL,2871442669,481,2871443150,2883084720
2025-06-19 02:11:42,REAL,2871443150,485,2871443635,2883085205
2025-06-19 02:11:44,REAL,2871443635,491,2871444126,2883085696
2025-06-19 02:11:46,FAKE,2871444126,244,2871444370,2883086179
2025-06-19 02:11:48,REAL,2871444370,485,2871444855,2883086664
2025-06-19 02:11:50,REAL,2871444855,594,2871445449,2883087258
2025-06-19 02:11:52,REAL,2871445449,479,2871445928,2883087737
2025-06-19 02:11:54,REAL,2871445928,492,2871446420,2883088229
2025-06-19 02:11:56,FAKE,2871446420,241,2871446661,2883088709
2025-06-19 02:11:58,REAL,2871446661,484,2871447145,2883089193
2025-06-19 02:12:00,FAKE,2871447145,238,2871447383,2883089675
2025-06-19 02:12:02,FAKE,2871447383,238,2871447621,2883093667
2025-06-19 02:12:04,REAL,2871447621,14615,2871462236,2883108282
2025-06-19 02:12:06,FAKE,2871462236,243,2871462479,2883118535
2025-06-19 02:12:08,REAL,2871462479,10319,2871472798,2883128854
2025-06-19 02:12:10,REAL,2871472798,10258,2871483056,2883139112
2025-06-19 02:12:12,REAL,2871483056,10318,2871493374,2883149430
2025-06-19 02:12:14,REAL,2871493374,10255,2871503629,2883159685
2025-06-19 02:12:16,REAL,2871503629,10248,2871513877,2883169933
2025-06-19 02:12:18,REAL,2871513877,2333,2871516210,2883172266
2025-06-19 02:12:20,REAL,2871516210,485,2871516695,2883172751
2025-06-19 02:12:22,REAL,2871516695,485,2871517180,2883173236
2025-06-19 02:12:24,REAL,2871517180,482,2871517662,2883173718
2025-06-19 02:12:26,REAL,2871517662,488,2871518150,2883174206
2025-06-19 02:12:28,FAKE,2871518150,244,2871518394,2883174691
2025-06-19 02:12:30,FAKE,2871518394,244,2871518638,2883175175
2025-06-19 02:12:32,FAKE,2871518638,241,2871518879,2883175656
2025-06-19 02:12:34,REAL,2871518879,5648,2871524527,2883181304
2025-06-19 02:12:36,REAL,2871524527,12416,2871536943,2883193720
2025-06-19 02:12:38,FAKE,2871536943,241,2871537184,2883204036
2025-06-19 02:12:40,REAL,2871537184,10253,2871547437,2883214289
2025-06-19 02:12:42,REAL,2871547437,10317,2871557754,2883224606
2025-06-19 02:12:44,FAKE,2871557754,244,2871557998,2883234855
2025-06-19 02:12:46,FAKE,2871557998,243,2871558241,2883245109
2025-06-19 02:12:48,REAL,2871558241,10312,2871568553,2883255421
2025-06-19 02:12:50,FAKE,2871568553,238,2871568791,2883257086
2025-06-19 02:12:52,REAL,2871568791,480,2871569271,2883257566
2025-06-19 02:12:54,REAL,2871569271,484,2871569755,2883258050
2025-06-19 02:12:56,REAL,2871569755,483,2871570238,2883258533
2025-06-19 02:12:58,FAKE,2871570238,241,2871570479,2883259023
2025-06-19 02:13:00,REAL,2871570479,485,2871570964,2883259508
2025-06-19 02:13:02,REAL,2871570964,475,2871571439,2883259983
2025-06-19 02:13:04,FAKE,2871571439,241,2871571680,2883260477
2025-06-19 02:13:06,REAL,2871571680,487,2871572167,2883260964
2025-06-19 02:13:08,FAKE,2871572167,238,2871572405,2883261449
2025-06-19 02:13:10,REAL,2871572405,539,2871572944,2883261988
2025-06-19 02:13:12,FAKE,2871572944,243,2871573187,2883262473
2025-06-19 02:13:14,REAL,2871573187,488,2871573675,2883262961
2025-06-19 02:13:16,REAL,2871573675,483,2871574158,2883263444
2025-06-19 02:13:18,REAL,2871574158,480,2871574638,2883263924
2025-06-19 02:13:20,REAL,2871574638,475,2871575113,2883264399
2025-06-19 02:13:22,FAKE,2871575113,238,2871575351,2883264886
2025-06-19 02:13:24,FAKE,2871575351,238,2871575589,2883265427
2025-06-19 02:13:26,REAL,2871575589,483,2871576072,2883265910
2025-06-19 02:13:28,REAL,2871576072,12256,2871588328,2883278166
2025-06-19 02:13:30,REAL,2871588328,10316,2871598644,2883288482
2025-06-19 02:13:32,REAL,2871598644,10261,2871608905,2883298743
2025-06-19 02:13:34,REAL,2871608905,10261,2871619166,2883309004
2025-06-19 02:13:36,FAKE,2871619166,241,2871619407,2883319317
2025-06-19 02:13:38,FAKE,2871619407,238,2871619645,2883329570
2025-06-19 02:13:40,REAL,2871619645,10254,2871629899,2883339824
2025-06-19 02:13:42,FAKE,2871629899,241,2871630140,2883345580
2025-06-19 02:13:44,REAL,2871630140,478,2871630618,2883346058
2025-06-19 02:13:46,REAL,2871630618,483,2871631101,2883346541
2025-06-19 02:13:48,REAL,2871631101,481,2871631582,2883347022
2025-06-19 02:13:50,FAKE,2871631582,241,2871631823,2883347506
2025-06-19 02:13:52,REAL,2871631823,484,2871632307,2883347990
2025-06-19 02:13:54,REAL,2871632307,479,2871632786,2883348469
2025-06-19 02:13:56,REAL,2871632786,480,2871633266,2883348949
2025-06-19 02:13:58,REAL,2871633266,1612,2871634878,2883350561
2025-06-19 02:14:00,REAL,2871634878,15012,2871649890,2883365573
2025-06-19 02:14:02,REAL,2871649890,10255,2871660145,2883375828
2025-06-19 02:14:04,REAL,2871660145,10244,2871670389,2883386072
2025-06-19 02:14:06,REAL,2871670389,10257,2871680646,2883396329
2025-06-19 02:14:08,REAL,2871680646,10254,2871690900,2883406583
2025-06-19 02:14:10,REAL,2871690900,10301,2871701201,2883416884
2025-06-19 02:14:12,REAL,2871701201,10311,2871711512,2883427195
2025-06-19 02:14:14,REAL,2871711512,5100,2871716612,2883432295
2025-06-19 02:14:16,REAL,2871716612,479,2871717091,2883432774
2025-06-19 02:14:18,REAL,2871717091,482,2871717573,2883433256
2025-06-19 02:14:20,REAL,2871717573,485,2871718058,2883433741
2025-06-19 02:14:22,REAL,2871718058,488,2871718546,2883434229
2025-06-19 02:14:24,REAL,2871718546,478,2871719024,2883434707
2025-06-19 02:14:26,FAKE,2871719024,244,2871719268,2883435191
2025-06-19 02:14:28,REAL,2871719268,493,2871719761,2883435684
2025-06-19 02:14:30,REAL,2871719761,1481,2871721242,2883437165
2025-06-19 02:14:32,REAL,2871721242,11379,2871732621,2883448544
2025-06-19 02:14:34,REAL,2871732621,10255,2871742876,2883458799
2025-06-19 02:14:36,REAL,2871742876,10318,2871753194,2883469117
2025-06-19 02:14:38,REAL,2871753194,10250,2871763444,2883479367
2025-06-19 02:14:40,REAL,2871763444,10251,2871773695,2883489618
2025-06-19 02:14:42,FAKE,2871773695,238,2871773933,2883499873
2025-06-19 02:14:44,REAL,2871773933,10317,2871784250,2883510190
2025-06-19 02:14:46,REAL,2871784250,4436,2871788686,2883514626
2025-06-19 02:14:48,REAL,2871788686,486,2871789172,2883515112
2025-06-19 02:14:50,FAKE,2871789172,241,2871789413,2883515595
2025-06-19 02:14:52,REAL,2871789413,484,2871789897,2883516079
2025-06-19 02:14:54,REAL,2871789897,482,2871790379,2883516561
2025-06-19 02:14:56,REAL,2871790379,481,2871790860,2883517042
2025-06-19 02:14:58,FAKE,2871790860,243,2871791103,2883517582
2025-06-19 02:15:00,REAL,2871791103,479,2871791582,2883518061
2025-06-19 02:15:02,REAL,2871791582,2140,2871793722,2883520201
2025-06-19 02:15:04,REAL,2871793722,14675,2871808397,2883534876
2025-06-19 02:15:06,REAL,2871808397,10244,2871818641,2883545120
2025-06-19 02:15:08,FAKE,2871818641,244,2871818885,2883555440
2025-06-19 02:15:10,FAKE,2871818885,244,2871819129,2883565759
2025-06-19 02:15:12,REAL,2871819129,10245,2871829374,2883576004
2025-06-19 02:15:14,REAL,2871829374,10312,2871839686,2883586316
2025-06-19 02:15:16,REAL,2871839686,10256,2871849942,2883596572
2025-06-19 02:15:18,REAL,2871849942,3844,2871853786,2883600416
2025-06-19 02:15:20,REAL,2871853786,476,2871854262,2883600892
2025-06-19 02:15:22,FAKE,2871854262,241,2871854503,2883601367
2025-06-19 02:15:24,REAL,2871854503,8740,2871863243,2883610107
2025-06-19 02:15:26,REAL,2871863243,10850,2871874093,2883620957
2025-06-19 02:15:28,REAL,2871874093,10314,2871884407,2883631271
2025-06-19 02:15:30,FAKE,2871884407,243,2871884650,2883641530
2025-06-19 02:15:32,REAL,2871884650,10315,2871894965,2883651845
2025-06-19 02:15:34,REAL,2871894965,10247,2871905212,2883662092
2025-06-19 02:15:36,REAL,2871905212,10327,2871915539,2883672419
2025-06-19 02:15:38,FAKE,2871915539,243,2871915782,2883680817
2025-06-19 02:15:40,REAL,2871915782,486,2871916268,2883681303
2025-06-19 02:15:42,REAL,2871916268,488,2871916756,2883681791
2025-06-19 02:15:44,REAL,2871916756,538,2871917294,2883682329
2025-06-19 02:15:46,FAKE,2871917294,243,2871917537,2883682874
2025-06-19 02:15:48,FAKE,2871917537,243,2871917780,2883683361
2025-06-19 02:15:50,FAKE,2871917780,241,2871918021,2883683849
2025-06-19 02:15:52,REAL,2871918021,484,2871918505,2883684333
2025-06-19 02:15:54,FAKE,2871918505,243,2871918748,2883684824
2025-06-19 02:15:56,FAKE,2871918748,238,2871918986,2883685312
2025-06-19 02:15:58,REAL,2871918986,475,2871919461,2883685787
2025-06-19 02:16:00,REAL,2871919461,489,2871919950,2883686276
2025-06-19 02:16:02,REAL,2871919950,484,2871920434,2883686760
2025-06-19 02:16:04,REAL,2871920434,483,2871920917,2883687243
2025-06-19 02:16:06,REAL,2871920917,489,2871921406,2883687732
2025-06-19 02:16:08,REAL,2871921406,490,2871921896,2883688222
2025-06-19 02:16:10,FAKE,2871921896,243,2871922139,2883688758
2025-06-19 02:16:12,REAL,2871922139,486,2871922625,2883689244
2025-06-19 02:16:14,FAKE,2871922625,244,2871922869,2883689784
2025-06-19 02:16:16,FAKE,2871922869,243,2871923112,2883690269
2025-06-19 02:16:18,REAL,2871923112,486,2871923598,2883690755
2025-06-19 02:16:20,REAL,2871923598,485,2871924083,2883691240
2025-06-19 02:16:22,REAL,2871924083,486,2871924569,2883691726
2025-06-19 02:16:24,REAL,2871924569,490,2871925059,2883692216
2025-06-19 02:16:26,REAL,2871925059,484,2871925543,2883692700
2025-06-19 02:16:28,REAL,2871925543,484,2871926027,2883693184
2025-06-19 02:16:30,REAL,2871926027,493,2871926520,2883693677
2025-06-19 02:16:32,REAL,2871926520,478,2871926998,2883694155
2025-06-19 02:16:34,REAL,2871926998,482,2871927480,2883694637
2025-06-19 02:16:36,REAL,2871927480,545,2871928025,2883695182
2025-06-19 02:16:38,FAKE,2871928025,243,2871928268,2883695674
2025-06-19 02:16:40,REAL,2871928268,480,2871928748,2883696154
2025-06-19 02:16:42,REAL,2871928748,545,2871929293,2883696699
2025-06-19 02:16:44,REAL,2871929293,477,2871929770,2883697176
2025-06-19 02:16:46,REAL,2871929770,483,2871930253,2883697659
2025-06-19 02:16:48,FAKE,2871930253,244,2871930497,2883702172
2025-06-19 02:16:50,FAKE,2871930497,244,2871930741,2883712944
2025-06-19 02:16:52,REAL,2871930741,10311,2871941052,2883723255
2025-06-19 02:16:54,FAKE,2871941052,238,2871941290,2883733499
2025-06-19 02:16:56,FAKE,2871941290,241,2871941531,2883743741
2025-06-19 02:16:58,REAL,2871941531,10320,2871951851,2883754061
2025-06-19 02:17:00,FAKE,2871951851,243,2871952094,2883764308
2025-06-19 02:17:02,REAL,2871952094,10246,2871962340,2883774554
2025-06-19 02:17:04,FAKE,2871962340,243,2871962583,2883776421
2025-06-19 02:17:06,REAL,2871962583,488,2871963071,2883776909
2025-06-19 02:17:08,REAL,2871963071,490,2871963561,2883777399
2025-06-19 02:17:10,REAL,2871963561,536,2871964097,2883777935
2025-06-19 02:17:12,REAL,2871964097,541,2871964638,2883778476
2025-06-19 02:17:14,REAL,2871964638,481,2871965119,2883778957
2025-06-19 02:17:16,REAL,2871965119,486,2871965605,2883779443
2025-06-19 02:17:18,REAL,2871965605,488,2871966093,2883779931
2025-06-19 02:17:20,FAKE,2871966093,241,2871966334,2883780420
2025-06-19 02:17:22,REAL,2871966334,484,2871966818,2883780904
2025-06-19 02:17:24,REAL,2871966818,489,2871967307,2883781393
2025-06-19 02:17:26,REAL,2871967307,489,2871967796,2883781882
2025-06-19 02:17:28,REAL,2871967796,494,2871968290,2883782376
2025-06-19 02:17:30,FAKE,2871968290,244,2871968534,2883782856
2025-06-19 02:17:32,REAL,2871968534,479,2871969013,2883783335
2025-06-19 02:17:34,FAKE,2871969013,238,2871969251,2883783869
2025-06-19 02:17:36,REAL,2871969251,480,2871969731,2883784349
2025-06-19 02:17:38,REAL,2871969731,484,2871970215,2883784833
2025-06-19 02:17:40,FAKE,2871970215,244,2871970459,2883785369
2025-06-19 02:17:42,REAL,2871970459,483,2871970942,2883785852
2025-06-19 02:17:44,REAL,2871970942,487,2871971429,2883786339
2025-06-19 02:17:46,REAL,2871971429,485,2871971914,2883786824
2025-06-19 02:17:48,REAL,2871971914,478,2871972392,2883787302
2025-06-19 02:17:50,REAL,2871972392,477,2871972869,2883787779
2025-06-19 02:17:52,FAKE,2871972869,244,2871973113,2883788261
2025-06-19 02:17:54,REAL,2871973113,482,2871973595,2883788743
2025-06-19 02:17:56,FAKE,2871973595,241,2871973836,2883789233
2025-06-19 02:17:58,REAL,2871973836,482,2871974318,2883789715
2025-06-19 02:18:00,REAL,2871974318,541,2871974859,2883790256
2025-06-19 02:18:02,REAL,2871974859,493,2871975352,2883790749
2025-06-19 02:18:04,REAL,2871975352,479,2871975831,2883791228
2025-06-19 02:18:06,REAL,2871975831,481,2871976312,2883791709
2025-06-19 02:18:08,REAL,2871976312,6560,2871982872,2883798269
2025-06-19 02:18:10,REAL,2871982872,11051,2871993923,2883809320
2025-06-19 02:18:12,REAL,2871993923,10260,2872004183,2883819580
2025-06-19 02:18:14,REAL,2872004183,10243,2872014426,2883829823
2025-06-19 02:18:16,REAL,2872014426,10316,2872024742,2883840139
2025-06-19 02:18:18,REAL,2872024742,10251,2872034993,2883850390
2025-06-19 02:18:20,REAL,2872034993,10244,2872045237,2883860634
2025-06-19 02:18:22,FAKE,2872045237,238,2872045475,2883870817
2025-06-19 02:18:24,REAL,2872045475,485,2872045960,2883871302
2025-06-19 02:18:26,REAL,2872045960,486,2872046446,2883871788
2025-06-19 02:18:28,FAKE,2872046446,238,2872046684,2883872270
2025-06-19 02:18:30,REAL,2872046684,540,2872047224,2883872810
2025-06-19 02:18:32,FAKE,2872047224,244,2872047468,2883873290
2025-06-19 02:18:34,REAL,2872047468,482,2872047950,2883873772
2025-06-19 02:18:36,REAL,2872047950,539,2872048489,2883874311
2025-06-19 02:18:38,FAKE,2872048489,238,2872048727,2883874795
2025-06-19 02:18:40,REAL,2872048727,482,2872049209,2883875277
2025-06-19 02:18:42,FAKE,2872049209,244,2872049453,2883875769
2025-06-19 02:18:44,FAKE,2872049453,243,2872049696,2883876253
2025-06-19 02:18:46,REAL,2872049696,492,2872050188,2883876745
2025-06-19 02:18:48,REAL,2872050188,478,2872050666,2883877223
2025-06-19 02:18:50,REAL,2872050666,482,2872051148,2883877705
2025-06-19 02:18:52,REAL,2872051148,482,2872051630,2883878187
2025-06-19 02:18:54,FAKE,2872051630,238,2872051868,2883878668
2025-06-19 02:18:56,REAL,2872051868,542,2872052410,2883879210
2025-06-19 02:18:58,REAL,2872052410,481,2872052891,2883879691
2025-06-19 02:19:00,REAL,2872052891,489,2872053380,2883880180
2025-06-19 02:19:02,REAL,2872053380,491,2872053871,2883880671
2025-06-19 02:19:04,REAL,2872053871,489,2872054360,2883881160
2025-06-19 02:19:06,REAL,2872054360,537,2872054897,2883881697
2025-06-19 02:19:08,REAL,2872054897,482,2872055379,2883882179
2025-06-19 02:19:10,FAKE,2872055379,244,2872055623,2883882671
2025-06-19 02:19:12,REAL,2872055623,486,2872056109,2883883157
2025-06-19 02:19:14,FAKE,2872056109,244,2872056353,2883883644
2025-06-19 02:19:16,FAKE,2872056353,243,2872056596,2883884133
2025-06-19 02:19:18,FAKE,2872056596,244,2872056840,2883884677
2025-06-19 02:19:20,FAKE,2872056840,244,2872057084,2883885167
2025-06-19 02:19:22,FAKE,2872057084,241,2872057325,2883885650
2025-06-19 02:19:24,REAL,2872057325,491,2872057816,2883886141
2025-06-19 02:19:26,REAL,2872057816,480,2872058296,2883886621
2025-06-19 02:19:28,REAL,2872058296,489,2872058785,2883887110
2025-06-19 02:19:30,REAL,2872058785,486,2872059271,2883887596
2025-06-19 02:19:32,FAKE,2872059271,241,2872059512,2883888081
2025-06-19 02:19:34,REAL,2872059512,536,2872060048,2883888617
2025-06-19 02:19:36,REAL,2872060048,478,2872060526,2883889095
2025-06-19 02:19:38,FAKE,2872060526,243,2872060769,2883889576
2025-06-19 02:19:40,FAKE,2872060769,241,2872061010,2883890063
2025-06-19 02:19:42,REAL,2872061010,537,2872061547,2883890600
2025-06-19 02:19:44,REAL,2872061547,477,2872062024,2883891077
2025-06-19 02:19:46,REAL,2872062024,481,2872062505,2883891558
2025-06-19 02:19:48,REAL,2872062505,2929,2872065434,2883894487
2025-06-19 02:19:50,REAL,2872065434,11700,2872077134,2883906187
2025-06-19 02:19:52,REAL,2872077134,10253,2872087387,2883916440
2025-06-19 02:19:54,FAKE,2872087387,238,2872087625,2883926691
2025-06-19 02:19:56,REAL,2872087625,10246,2872097871,2883936937
2025-06-19 02:19:58,FAKE,2872097871,241,2872098112,2883947251
2025-06-19 02:20:00,REAL,2872098112,10314,2872108426,2883957565
2025-06-19 02:20:02,REAL,2872108426,10257,2872118683,2883967822
2025-06-19 02:20:04,REAL,2872118683,3372,2872122055,2883971194
2025-06-19 02:20:06,FAKE,2872122055,243,2872122298,2883971677
2025-06-19 02:20:08,REAL,2872122298,483,2872122781,2883972160
2025-06-19 02:20:10,REAL,2872122781,486,2872123267,2883972646
2025-06-19 02:20:12,FAKE,2872123267,243,2872123510,2883973193
2025-06-19 02:20:14,REAL,2872123510,487,2872123997,2883973680
2025-06-19 02:20:16,REAL,2872123997,487,2872124484,2883974167
2025-06-19 02:20:18,REAL,2872124484,487,2872124971,2883974654
2025-06-19 02:20:20,REAL,2872124971,475,2872125446,2883975129
2025-06-19 02:20:22,FAKE,2872125446,244,2872125690,2883975615
2025-06-19 02:20:24,REAL,2872125690,479,2872126169,2883976094
2025-06-19 02:20:26,REAL,2872126169,483,2872126652,2883976577
2025-06-19 02:20:28,REAL,2872126652,474,2872127126,2883977051
2025-06-19 02:20:30,FAKE,2872127126,238,2872127364,2883980445
2025-06-19 02:20:32,FAKE,2872127364,244,2872127608,2883992131
2025-06-19 02:20:34,REAL,2872127608,10244,2872137852,2884002375
2025-06-19 02:20:36,REAL,2872137852,10255,2872148107,2884012630
2025-06-19 02:20:38,REAL,2872148107,10251,2872158358,2884022881
2025-06-19 02:20:40,REAL,2872158358,10254,2872168612,2884033135
2025-06-19 02:20:42,REAL,2872168612,10247,2872178859,2884043382
2025-06-19 02:20:44,REAL,2872178859,10319,2872189178,2884053701
2025-06-19 02:20:46,FAKE,2872189178,238,2872189416,2884056500
2025-06-19 02:20:48,REAL,2872189416,478,2872189894,2884056978
2025-06-19 02:20:50,FAKE,2872189894,244,2872190138,2884057458
2025-06-19 02:20:52,FAKE,2872190138,238,2872190376,2884067381
2025-06-19 02:20:54,FAKE,2872190376,241,2872190617,2884077826
2025-06-19 02:20:56,REAL,2872190617,10320,2872200937,2884088146
2025-06-19 02:20:58,REAL,2872200937,10252,2872211189,2884098398
2025-06-19 02:21:00,FAKE,2872211189,241,2872211430,2884108709
2025-06-19 02:21:02,REAL,2872211430,10256,2872221686,2884118965
2025-06-19 02:21:04,REAL,2872221686,10321,2872232007,2884129286
2025-06-19 02:21:06,FAKE,2872232007,244,2872232251,2884136562
2025-06-19 02:21:08,FAKE,2872232251,243,2872232494,2884137047
2025-06-19 02:21:10,REAL,2872232494,481,2872232975,2884137528
2025-06-19 02:21:12,REAL,2872232975,490,2872233465,2884138018
2025-06-19 02:21:14,REAL,2872233465,538,2872234003,2884138556
2025-06-19 02:21:16,FAKE,2872234003,241,2872234244,2884139044
2025-06-19 02:21:18,FAKE,2872234244,244,2872234488,2884139527
2025-06-19 02:21:20,REAL,2872234488,484,2872234972,2884140011
2025-06-19 02:21:22,REAL,2872234972,479,2872235451,2884140490
2025-06-19 02:21:24,REAL,2872235451,10520,2872245971,2884151010
2025-06-19 02:21:26,FAKE,2872245971,243,2872246214,2884161448
2025-06-19 02:21:28,FAKE,2872246214,241,2872246455,2884171773
2025-06-19 02:21:30,REAL,2872246455,10259,2872256714,2884182032
2025-06-19 02:21:32,FAKE,2872256714,238,2872256952,2884192417
2025-06-19 02:21:34,REAL,2872256952,10190,2872267142,2884202607
2025-06-19 02:21:36,FAKE,2872267142,243,2872267385,2884212862
2025-06-19 02:21:38,REAL,2872267385,6685,2872274070,2884219547
2025-06-19 02:21:40,REAL,2872274070,481,2872274551,2884220028
2025-06-19 02:21:42,FAKE,2872274551,244,2872274795,2884220517
2025-06-19 02:21:44,REAL,2872274795,480,2872275275,2884220997
2025-06-19 02:21:46,FAKE,2872275275,238,2872275513,2884221536
2025-06-19 02:21:48,FAKE,2872275513,243,2872275756,2884222020
2025-06-19 02:21:50,FAKE,2872275756,238,2872275994,2884222559
2025-06-19 02:21:52,FAKE,2872275994,243,2872276237,2884223043
2025-06-19 02:21:54,REAL,2872276237,480,2872276717,2884223523
2025-06-19 02:21:56,FAKE,2872276717,244,2872276961,2884237480
2025-06-19 02:21:58,FAKE,2872276961,241,2872277202,2884247927
2025-06-19 02:22:00,REAL,2872277202,10320,2872287522,2884258247
2025-06-19 02:22:02,REAL,2872287522,10248,2872297770,2884268495
2025-06-19 02:22:04,REAL,2872297770,10252,2872308022,2884278747
2025-06-19 02:22:06,REAL,2872308022,10256,2872318278,2884289003
2025-06-19 02:22:08,REAL,2872318278,10316,2872328594,2884299319
2025-06-19 02:22:10,REAL,2872328594,6094,2872334688,2884305413
2025-06-19 02:22:12,FAKE,2872334688,244,2872334932,2884305894
2025-06-19 02:22:14,REAL,2872334932,295,2872335227,2884306189
2025-06-19 02:22:16,FAKE,2872335227,241,2872335468,2884306674
2025-06-19 02:22:18,FAKE,2872335468,238,2872335706,2884307212
2025-06-19 02:22:20,FAKE,2872335706,238,2872335944,2884307701
2025-06-19 02:22:22,FAKE,2872335944,238,2872336182,2884308184
2025-06-19 02:22:24,REAL,2872336182,485,2872336667,2884308669
2025-06-19 02:22:26,REAL,2872336667,490,2872337157,2884309159
2025-06-19 02:22:28,FAKE,2872337157,241,2872337398,2884320688
2025-06-19 02:22:30,REAL,2872337398,10256,2872347654,2884330944
2025-06-19 02:22:32,FAKE,2872347654,243,2872347897,2884341201
2025-06-19 02:22:34,REAL,2872347897,10250,2872358147,2884351451
2025-06-19 02:22:36,REAL,2872358147,10322,2872368469,2884361773
2025-06-19 02:22:38,REAL,2872368469,10313,2872378782,2884372086
2025-06-19 02:22:40,FAKE,2872378782,238,2872379020,2884382404
2025-06-19 02:22:42,REAL,2872379020,5431,2872384451,2884387835
2025-06-19 02:22:44,FAKE,2872384451,243,2872384694,2884388317
2025-06-19 02:22:46,REAL,2872384694,480,2872385174,2884388797
2025-06-19 02:22:48,REAL,2872385174,483,2872385657,2884389280
2025-06-19 02:22:50,FAKE,2872385657,244,2872385901,2884389823
2025-06-19 02:22:52,REAL,2872385901,487,2872386388,2884390310
2025-06-19 02:22:54,REAL,2872386388,487,2872386875,2884390797
2025-06-19 02:22:56,REAL,2872386875,488,2872387363,2884391285
2025-06-19 02:22:58,REAL,2872387363,484,2872387847,2884391769
2025-06-19 02:23:00,FAKE,2872387847,244,2872388091,2884392260
2025-06-19 02:23:02,REAL,2872388091,476,2872388567,2884392736
2025-06-19 02:23:04,REAL,2872388567,544,2872389111,2884393280
2025-06-19 02:23:06,FAKE,2872389111,241,2872389352,2884393768
2025-06-19 02:23:08,FAKE,2872389352,238,2872389590,2884394257
2025-06-19 02:23:10,REAL,2872389590,490,2872390080,2884394747
2025-06-19 02:23:12,REAL,2872390080,482,2872390562,2884395229
2025-06-19 02:23:14,REAL,2872390562,544,2872391106,2884395773
2025-06-19 02:23:16,REAL,2872391106,487,2872391593,2884396260
2025-06-19 02:23:18,REAL,2872391593,482,2872392075,2884396742
2025-06-19 02:23:20,REAL,2872392075,485,2872392560,2884397227
2025-06-19 02:23:22,REAL,2872392560,486,2872393046,2884397713
2025-06-19 02:23:24,REAL,2872393046,486,2872393532,2884398199
2025-06-19 02:23:26,FAKE,2872393532,241,2872393773,2884398684
2025-06-19 02:23:28,FAKE,2872393773,243,2872394016,2884399227
2025-06-19 02:23:30,REAL,2872394016,1878,2872395894,2884401105
2025-06-19 02:23:32,REAL,2872395894,11897,2872407791,2884413002
2025-06-19 02:23:34,REAL,2872407791,9926,2872417717,2884422928
2025-06-19 02:23:36,REAL,2872417717,10248,2872427965,2884433176
2025-06-19 02:23:38,FAKE,2872427965,244,2872428209,2884443430
2025-06-19 02:23:40,FAKE,2872428209,241,2872428450,2884453754
2025-06-19 02:23:42,REAL,2872428450,10244,2872438694,2884463998
2025-06-19 02:23:44,REAL,2872438694,10255,2872448949,2884474253
2025-06-19 02:23:46,FAKE,2872448949,238,2872449187,2884478438
2025-06-19 02:23:48,REAL,2872449187,484,2872449671,2884478922
2025-06-19 02:23:50,REAL,2872449671,490,2872450161,2884479412
2025-06-19 02:23:52,FAKE,2872450161,243,2872450404,2884479945
2025-06-19 02:23:54,FAKE,2872450404,241,2872450645,2884480487
2025-06-19 02:23:56,FAKE,2872450645,238,2872450883,2884480981
2025-06-19 02:23:58,REAL,2872450883,481,2872451364,2884481462
2025-06-19 02:24:00,FAKE,2872451364,244,2872451608,2884481947
2025-06-19 02:24:02,REAL,2872451608,2528,2872454136,2884484475
2025-06-19 02:24:04,FAKE,2872454136,241,2872454377,2884498895
2025-06-19 02:24:06,FAKE,2872454377,244,2872454621,2884509219
2025-06-19 02:24:08,REAL,2872454621,10250,2872464871,2884519469
2025-06-19 02:24:10,REAL,2872464871,10257,2872475128,2884529726
2025-06-19 02:24:12,REAL,2872475128,10249,2872485377,2884539975
2025-06-19 02:24:14,FAKE,2872485377,241,2872485618,2884550227
2025-06-19 02:24:16,FAKE,2872485618,238,2872485856,2884560476
2025-06-19 02:24:18,FAKE,2872485856,238,2872486094,2884564051
2025-06-19 02:24:20,REAL,2872486094,477,2872486571,2884564528
2025-06-19 02:24:22,REAL,2872486571,484,2872487055,2884565012
2025-06-19 02:24:24,REAL,2872487055,481,2872487536,2884565493
2025-06-19 02:24:26,FAKE,2872487536,238,2872487774,2884566036
2025-06-19 02:24:28,REAL,2872487774,483,2872488257,2884566519
2025-06-19 02:24:30,FAKE,2872488257,243,2872488500,2884567009
2025-06-19 02:24:32,REAL,2872488500,482,2872488982,2884567491
2025-06-19 02:24:34,REAL,2872488982,3533,2872492515,2884571024
2025-06-19 02:24:36,REAL,2872492515,15337,2872507852,2884586361
2025-06-19 02:24:38,REAL,2872507852,10253,2872518105,2884596614
2025-06-19 02:24:40,REAL,2872518105,10323,2872528428,2884606937
2025-06-19 02:24:42,FAKE,2872528428,238,2872528666,2884617238
2025-06-19 02:24:44,REAL,2872528666,10250,2872538916,2884627488
2025-06-19 02:24:46,REAL,2872538916,10255,2872549171,2884637743
2025-06-19 02:24:48,REAL,2872549171,10316,2872559487,2884648059
2025-06-19 02:24:50,REAL,2872559487,2925,2872562412,2884650984
2025-06-19 02:24:52,FAKE,2872562412,241,2872562653,2884651464
2025-06-19 02:24:54,FAKE,2872562653,244,2872562897,2884651955
2025-06-19 02:24:56,REAL,2872562897,540,2872563437,2884652495
2025-06-19 02:24:58,REAL,2872563437,483,2872563920,2884652978
2025-06-19 02:25:00,FAKE,2872563920,241,2872564161,2884653470
2025-06-19 02:25:02,REAL,2872564161,487,2872564648,2884653957
2025-06-19 02:25:04,REAL,2872564648,486,2872565134,2884654443
2025-06-19 02:25:06,REAL,2872565134,543,2872565677,2884654986
2025-06-19 02:25:08,REAL,2872565677,478,2872566155,2884655464
2025-06-19 02:25:10,REAL,2872566155,488,2872566643,2884655952
2025-06-19 02:25:12,REAL,2872566643,485,2872567128,2884656437
2025-06-19 02:25:14,FAKE,2872567128,244,2872567372,2884656912
2025-06-19 02:25:16,REAL,2872567372,492,2872567864,2884657404
2025-06-19 02:25:18,REAL,2872567864,483,2872568347,2884657887
2025-06-19 02:25:20,REAL,2872568347,540,2872568887,2884658427
2025-06-19 02:25:22,REAL,2872568887,476,2872569363,2884658903
2025-06-19 02:25:24,FAKE,2872569363,243,2872569606,2884659391
2025-06-19 02:25:26,FAKE,2872569606,241,2872569847,2884659875
2025-06-19 02:25:28,FAKE,2872569847,243,2872570090,2884660357
2025-06-19 02:25:30,FAKE,2872570090,244,2872570334,2884660892
2025-06-19 02:25:32,FAKE,2872570334,238,2872570572,2884661375
2025-06-19 02:25:34,REAL,2872570572,480,2872571052,2884661855
2025-06-19 02:25:36,FAKE,2872571052,243,2872571295,2884662337
2025-06-19 02:25:38,REAL,2872571295,5105,2872576400,2884667442
2025-06-19 02:25:40,REAL,2872576400,13352,2872589752,2884680794
2025-06-19 02:25:42,FAKE,2872589752,243,2872589995,2884691111
2025-06-19 02:25:44,FAKE,2872589995,241,2872590236,2884701358
2025-06-19 02:25:46,REAL,2872590236,10321,2872600557,2884711679
2025-06-19 02:25:48,REAL,2872600557,10255,2872610812,2884721934
2025-06-19 02:25:50,FAKE,2872610812,244,2872611056,2884732258
2025-06-19 02:25:52,REAL,2872611056,10253,2872621309,2884742511
2025-06-19 02:25:54,REAL,2872621309,1672,2872622981,2884744183
2025-06-19 02:25:56,REAL,2872622981,477,2872623458,2884744660
2025-06-19 02:25:58,FAKE,2872623458,243,2872623701,2884745143
2025-06-19 02:26:00,REAL,2872623701,541,2872624242,2884745684
2025-06-19 02:26:02,FAKE,2872624242,243,2872624485,2884746177
2025-06-19 02:26:04,FAKE,2872624485,241,2872624726,2884746662
2025-06-19 02:26:06,REAL,2872624726,483,2872625209,2884747145
2025-06-19 02:26:08,REAL,2872625209,484,2872625693,2884747629
2025-06-19 02:26:10,REAL,2872625693,538,2872626231,2884748167
2025-06-19 02:26:12,REAL,2872626231,487,2872626718,2884748654
2025-06-19 02:26:14,FAKE,2872626718,244,2872626962,2884749143
2025-06-19 02:26:16,REAL,2872626962,479,2872627441,2884749622
2025-06-19 02:26:18,FAKE,2872627441,243,2872627684,2884750103
2025-06-19 02:26:20,REAL,2872627684,479,2872628163,2884750582
2025-06-19 02:26:22,REAL,2872628163,484,2872628647,2884751066
2025-06-19 02:26:24,FAKE,2872628647,244,2872628891,2884751607
2025-06-19 02:26:26,FAKE,2872628891,244,2872629135,2884752098
2025-06-19 02:26:28,FAKE,2872629135,243,2872629378,2884752584
2025-06-19 02:26:30,FAKE,2872629378,241,2872629619,2884753072
2025-06-19 02:26:32,REAL,2872629619,12047,2872641666,2884765119
2025-06-19 02:26:34,REAL,2872641666,10326,2872651992,2884775445
2025-06-19 02:26:36,REAL,2872651992,10243,2872662235,2884785688
2025-06-19 02:26:38,REAL,2872662235,10253,2872672488,2884795941
2025-06-19 02:26:40,FAKE,2872672488,241,2872672729,2884806267
2025-06-19 02:26:42,REAL,2872672729,10246,2872682975,2884816513
2025-06-19 02:26:44,FAKE,2872682975,241,2872683216,2884826833
2025-06-19 02:26:46,REAL,2872683216,5567,2872688783,2884832400
2025-06-19 02:26:48,REAL,2872688783,544,2872689327,2884832944
2025-06-19 02:26:50,REAL,2872689327,479,2872689806,2884833423
2025-06-19 02:26:52,REAL,2872689806,481,2872690287,2884833904
2025-06-19 02:26:54,FAKE,2872690287,241,2872690528,2884834451
2025-06-19 02:26:56,REAL,2872690528,479,2872691007,2884834930
2025-06-19 02:26:58,REAL,2872691007,485,2872691492,2884835415
2025-06-19 02:27:00,REAL,2872691492,484,2872691976,2884835899
2025-06-19 02:27:02,REAL,2872691976,479,2872692455,2884836378
2025-06-19 02:27:04,REAL,2872692455,486,2872692941,2884836864
2025-06-19 02:27:06,REAL,2872692941,482,2872693423,2884837346
2025-06-19 02:27:08,REAL,2872693423,479,2872693902,2884837825
2025-06-19 02:27:10,FAKE,2872693902,241,2872694143,2884838305
2025-06-19 02:27:12,FAKE,2872694143,244,2872694387,2884838792
2025-06-19 02:27:14,FAKE,2872694387,238,2872694625,2884839266
2025-06-19 02:27:16,REAL,2872694625,534,2872695159,2884839800
2025-06-19 02:27:18,FAKE,2872695159,243,2872695402,2884840280
2025-06-19 02:27:20,REAL,2872695402,489,2872695891,2884840769
2025-06-19 02:27:22,FAKE,2872695891,238,2872696129,2884841252
2025-06-19 02:27:24,FAKE,2872696129,238,2872696367,2884841729
2025-06-19 02:27:26,REAL,2872696367,481,2872696848,2884842210
2025-06-19 02:27:28,REAL,2872696848,539,2872697387,2884842749
2025-06-19 02:27:30,REAL,2872697387,483,2872697870,2884843232
2025-06-19 02:27:32,FAKE,2872697870,241,2872698111,2884843716
2025-06-19 02:27:34,REAL,2872698111,487,2872698598,2884844203
2025-06-19 02:27:36,FAKE,2872698598,241,2872698839,2884844686
2025-06-19 02:27:38,FAKE,2872698839,241,2872699080,2884845163
2025-06-19 02:27:40,REAL,2872699080,536,2872699616,2884845699
2025-06-19 02:27:42,REAL,2872699616,479,2872700095,2884846178
2025-06-19 02:27:44,REAL,2872700095,480,2872700575,2884846658
2025-06-19 02:27:46,FAKE,2872700575,244,2872700819,2884847141
2025-06-19 02:27:48,REAL,2872700819,479,2872701298,2884847620
2025-06-19 02:27:50,REAL,2872701298,2009,2872703307,2884849629
2025-06-19 02:27:52,FAKE,2872703307,243,2872703550,2884861329
2025-06-19 02:27:54,REAL,2872703550,10317,2872713867,2884871646
2025-06-19 02:27:56,REAL,2872713867,10252,2872724119,2884881898
2025-06-19 02:27:58,REAL,2872724119,10311,2872734430,2884892209
2025-06-19 02:28:00,REAL,2872734430,10253,2872744683,2884902462
2025-06-19 02:28:02,FAKE,2872744683,241,2872744924,2884912778
2025-06-19 02:28:04,FAKE,2872744924,243,2872745167,2884923094
2025-06-19 02:28:06,REAL,2872745167,4043,2872749210,2884927137
2025-06-19 02:28:08,REAL,2872749210,484,2872749694,2884927621
2025-06-19 02:28:10,FAKE,2872749694,244,2872749938,2884928107
2025-06-19 02:28:12,REAL,2872749938,9988,2872759926,2884938095
2025-06-19 02:28:14,REAL,2872759926,10775,2872770701,2884948870
2025-06-19 02:28:16,FAKE,2872770701,244,2872770945,2884959182
2025-06-19 02:28:18,REAL,2872770945,10244,2872781189,2884969426
2025-06-19 02:28:20,REAL,2872781189,10246,2872791435,2884979672
2025-06-19 02:28:22,REAL,2872791435,10314,2872801749,2884989986
2025-06-19 02:28:24,REAL,2872801749,10255,2872812004,2885000241
2025-06-19 02:28:26,REAL,2872812004,8608,2872820612,2885008849
2025-06-19 02:28:28,FAKE,2872820612,244,2872820856,2885009340
2025-06-19 02:28:30,FAKE,2872820856,243,2872821099,2885009834
2025-06-19 02:28:32,REAL,2872821099,476,2872821575,2885010310
2025-06-19 02:28:34,FAKE,2872821575,244,2872821819,2885010841
2025-06-19 02:28:36,REAL,2872821819,484,2872822303,2885011325
2025-06-19 02:28:38,FAKE,2872822303,238,2872822541,2885011812
2025-06-19 02:28:40,REAL,2872822541,484,2872823025,2885012296
2025-06-19 02:28:42,REAL,2872823025,484,2872823509,2885012780
2025-06-19 02:28:44,REAL,2872823509,8931,2872832440,2885021711
2025-06-19 02:28:46,REAL,2872832440,10639,2872843079,2885032350
2025-06-19 02:28:48,REAL,2872843079,10308,2872853387,2885042658
2025-06-19 02:28:50,FAKE,2872853387,238,2872853625,2885052972
2025-06-19 02:28:52,FAKE,2872853625,238,2872853863,2885063225
2025-06-19 02:28:54,FAKE,2872853863,241,2872854104,2885073485
2025-06-19 02:28:56,REAL,2872854104,10319,2872864423,2885083804
2025-06-19 02:28:58,FAKE,2872864423,244,2872864667,2885091739
2025-06-19 02:29:00,REAL,2872864667,481,2872865148,2885092220
2025-06-19 02:29:02,REAL,2872865148,477,2872865625,2885092697
2025-06-19 02:29:04,FAKE,2872865625,241,2872865866,2885097278
2025-06-19 02:29:06,REAL,2872865866,10925,2872876791,2885108203
2025-06-19 02:29:08,REAL,2872876791,10317,2872887108,2885118520
2025-06-19 02:29:10,FAKE,2872887108,244,2872887352,2885128777
2025-06-19 02:29:12,REAL,2872887352,10251,2872897603,2885139028
2025-06-19 02:29:14,REAL,2872897603,10317,2872907920,2885149345
2025-06-19 02:29:16,REAL,2872907920,10261,2872918181,2885159606
2025-06-19 02:29:18,REAL,2872918181,10322,2872928503,2885169928
2025-06-19 02:29:20,FAKE,2872928503,244,2872928747,2885172599
2025-06-19 02:29:22,FAKE,2872928747,238,2872928985,2885173079
2025-06-19 02:29:24,REAL,2872928985,486,2872929471,2885173565
2025-06-19 02:29:26,FAKE,2872929471,244,2872929715,2885174100
2025-06-19 02:29:28,REAL,2872929715,546,2872930261,2885174646
2025-06-19 02:29:30,REAL,2872930261,480,2872930741,2885175126
2025-06-19 02:29:32,REAL,2872930741,481,2872931222,2885175607
2025-06-19 02:29:34,FAKE,2872931222,244,2872931466,2885176088
2025-06-19 02:29:36,REAL,2872931466,4847,2872936313,2885180935
2025-06-19 02:29:38,REAL,2872936313,11179,2872947492,2885192114
2025-06-19 02:29:40,REAL,2872947492,10252,2872957744,2885202366
2025-06-19 02:29:42,REAL,2872957744,10313,2872968057,2885212679
2025-06-19 02:29:44,REAL,2872968057,10259,2872978316,2885222938
2025-06-19 02:29:46,FAKE,2872978316,238,2872978554,2885233195
2025-06-19 02:29:48,FAKE,2872978554,244,2872978798,2885243519
2025-06-19 02:29:50,FAKE,2872978798,241,2872979039,2885253767
2025-06-19 02:29:52,REAL,2872979039,2066,2872981105,2885255833
2025-06-19 02:29:54,REAL,2872981105,488,2872981593,2885256321
2025-06-19 02:29:56,REAL,2872981593,481,2872982074,2885256802
2025-06-19 02:29:58,FAKE,2872982074,238,2872982312,2885257337
2025-06-19 02:30:00,FAKE,2872982312,238,2872982550,2885257817
2025-06-19 02:30:02,FAKE,2872982550,243,2872982793,2885258303
2025-06-19 02:30:04,REAL,2872982793,477,2872983270,2885258780
2025-06-19 02:30:06,REAL,2872983270,480,2872983750,2885259260
2025-06-19 02:30:08,FAKE,2872983750,244,2872983994,2885259749
2025-06-19 02:30:10,REAL,2872983994,537,2872984531,2885260286
2025-06-19 02:30:12,REAL,2872984531,485,2872985016,2885260771
2025-06-19 02:30:14,REAL,2872985016,480,2872985496,2885261251
2025-06-19 02:30:16,FAKE,2872985496,244,2872985740,2885261740
2025-06-19 02:30:18,REAL,2872985740,479,2872986219,2885262219
2025-06-19 02:30:20,FAKE,2872986219,243,2872986462,2885262763
2025-06-19 02:30:22,REAL,2872986462,480,2872986942,2885263243
2025-06-19 02:30:24,FAKE,2872986942,244,2872987186,2885263726
2025-06-19 02:30:26,REAL,2872987186,484,2872987670,2885264210
2025-06-19 02:30:28,FAKE,2872987670,241,2872987911,2885264688
2025-06-19 02:30:30,REAL,2872987911,475,2872988386,2885265163
2025-06-19 02:30:32,REAL,2872988386,478,2872988864,2885265641
2025-06-19 02:30:34,FAKE,2872988864,241,2872989105,2885266130
2025-06-19 02:30:36,REAL,2872989105,484,2872989589,2885266614
2025-06-19 02:30:38,FAKE,2872989589,238,2872989827,2885267096
2025-06-19 02:30:40,REAL,2872989827,482,2872990309,2885267578
2025-06-19 02:30:42,REAL,2872990309,482,2872990791,2885268060
2025-06-19 02:30:44,FAKE,2872990791,241,2872991032,2885268537
2025-06-19 02:30:46,REAL,2872991032,475,2872991507,2885269012
2025-06-19 02:30:48,REAL,2872991507,490,2872991997,2885269502
2025-06-19 02:30:50,FAKE,2872991997,238,2872992235,2885274871
2025-06-19 02:30:52,REAL,2872992235,11113,2873003348,2885285984
2025-06-19 02:30:54,REAL,2873003348,10247,2873013595,2885296231
2025-06-19 02:30:56,REAL,2873013595,10248,2873023843,2885306479
2025-06-19 02:30:58,FAKE,2873023843,238,2873024081,2885316726
2025-06-19 02:31:00,REAL,2873024081,10325,2873034406,2885327051
2025-06-19 02:31:02,FAKE,2873034406,238,2873034644,2885337311
2025-06-19 02:31:04,REAL,2873034644,10253,2873044897,2885347564
2025-06-19 02:31:06,REAL,2873044897,941,2873045838,2885348505
2025-06-19 02:31:08,REAL,2873045838,483,2873046321,2885348988
2025-06-19 02:31:10,REAL,2873046321,483,2873046804,2885349471
2025-06-19 02:31:12,REAL,2873046804,481,2873047285,2885349952
2025-06-19 02:31:14,FAKE,2873047285,243,2873047528,2885350430
2025-06-19 02:31:16,FAKE,2873047528,244,2873047772,2885350916
2025-06-19 02:31:18,REAL,2873047772,487,2873048259,2885351403
2025-06-19 02:31:20,FAKE,2873048259,238,2873048497,2885351886
2025-06-19 02:31:22,REAL,2873048497,481,2873048978,2885352367
2025-06-19 02:31:24,FAKE,2873048978,238,2873049216,2885352851
2025-06-19 02:31:26,REAL,2873049216,481,2873049697,2885353332
2025-06-19 02:31:28,FAKE,2873049697,238,2873049935,2885353810
2025-06-19 02:31:30,REAL,2873049935,492,2873050427,2885354302
2025-06-19 02:31:32,FAKE,2873050427,243,2873050670,2885354781
2025-06-19 02:31:34,REAL,2873050670,483,2873051153,2885355264
2025-06-19 02:31:36,FAKE,2873051153,244,2873051397,2885355745
2025-06-19 02:31:38,REAL,2873051397,481,2873051878,2885356226
2025-06-19 02:31:40,REAL,2873051878,592,2873052470,2885356818
2025-06-19 02:31:42,REAL,2873052470,481,2873052951,2885357299
2025-06-19 02:31:44,REAL,2873052951,483,2873053434,2885357782
2025-06-19 02:31:46,FAKE,2873053434,244,2873053678,2885358261
2025-06-19 02:31:48,FAKE,2873053678,238,2873053916,2885358749
2025-06-19 02:31:50,REAL,2873053916,478,2873054394,2885359227
2025-06-19 02:31:52,REAL,2873054394,479,2873054873,2885359706
2025-06-19 02:31:54,FAKE,2873054873,243,2873055116,2885360197
2025-06-19 02:31:56,REAL,2873055116,477,2873055593,2885360674
2025-06-19 02:31:58,REAL,2873055593,486,2873056079,2885361160
2025-06-19 02:32:00,REAL,2873056079,480,2873056559,2885361640
2025-06-19 02:32:02,REAL,2873056559,477,2873057036,2885362117
2025-06-19 02:32:04,REAL,2873057036,478,2873057514,2885362595
2025-06-19 02:32:06,FAKE,2873057514,244,2873057758,2885363074
2025-06-19 02:32:08,REAL,2873057758,480,2873058238,2885363554
2025-06-19 02:32:10,FAKE,2873058238,244,2873058482,2885364038
2025-06-19 02:32:12,FAKE,2873058482,244,2873058726,2885364527
2025-06-19 02:32:14,REAL,2873058726,1619,2873060345,2885366146
2025-06-19 02:32:16,FAKE,2873060345,241,2873060586,2885380559
2025-06-19 02:32:18,FAKE,2873060586,241,2873060827,2885390804
2025-06-19 02:32:20,FAKE,2873060827,238,2873061065,2885401128
2025-06-19 02:32:22,REAL,2873061065,10251,2873071316,2885411379
2025-06-19 02:32:24,REAL,2873071316,10323,2873081639,2885421702
2025-06-19 02:32:26,FAKE,2873081639,241,2873081880,2885431958
2025-06-19 02:32:28,REAL,2873081880,10315,2873092195,2885442273
2025-06-19 02:32:30,FAKE,2873092195,244,2873092439,2885446654
2025-06-19 02:32:32,REAL,2873092439,492,2873092931,2885447146
2025-06-19 02:32:34,REAL,2873092931,484,2873093415,2885447630
2025-06-19 02:32:36,FAKE,2873093415,244,2873093659,2885448109
2025-06-19 02:32:38,REAL,2873093659,487,2873094146,2885448596
2025-06-19 02:32:40,REAL,2873094146,483,2873094629,2885449079
2025-06-19 02:32:42,FAKE,2873094629,244,2873094873,2885449561
2025-06-19 02:32:44,REAL,2873094873,489,2873095362,2885450050
2025-06-19 02:32:46,REAL,2873095362,2604,2873097966,2885452654
2025-06-19 02:32:48,REAL,2873097966,11709,2873109675,2885464363
2025-06-19 02:32:50,FAKE,2873109675,238,2873109913,2885474610
2025-06-19 02:32:52,REAL,2873109913,10321,2873120234,2885484931
2025-06-19 02:32:54,REAL,2873120234,10262,2873130496,2885495193
2025-06-19 02:32:56,REAL,2873130496,10245,2873140741,2885505438
2025-06-19 02:32:58,REAL,2873140741,10255,2873150996,2885515693
2025-06-19 02:33:00,REAL,2873150996,10251,2873161247,2885525944
2025-06-19 02:33:02,REAL,2873161247,3658,2873164905,2885529602
2025-06-19 02:33:04,REAL,2873164905,479,2873165384,2885530081
2025-06-19 02:33:06,FAKE,2873165384,244,2873165628,2885530560
2025-06-19 02:33:08,REAL,2873165628,483,2873166111,2885531043
2025-06-19 02:33:10,REAL,2873166111,491,2873166602,2885531534
2025-06-19 02:33:12,REAL,2873166602,478,2873167080,2885532012
2025-06-19 02:33:14,REAL,2873167080,486,2873167566,2885532498
2025-06-19 02:33:16,REAL,2873167566,489,2873168055,2885532987
2025-06-19 02:33:18,FAKE,2873168055,243,2873168298,2885533519
2025-06-19 02:33:20,REAL,2873168298,491,2873168789,2885534010
2025-06-19 02:33:22,REAL,2873168789,476,2873169265,2885534486
2025-06-19 02:33:24,FAKE,2873169265,241,2873169506,2885534965
2025-06-19 02:33:26,REAL,2873169506,481,2873169987,2885535446
2025-06-19 02:33:28,REAL,2873169987,486,2873170473,2885535932
2025-06-19 02:33:30,REAL,2873170473,480,2873170953,2885536412
2025-06-19 02:33:32,REAL,2873170953,482,2873171435,2885536894
2025-06-19 02:33:34,REAL,2873171435,485,2873171920,2885537379
2025-06-19 02:33:36,FAKE,2873171920,241,2873172161,2885537864
2025-06-19 02:33:38,REAL,2873172161,536,2873172697,2885538400
2025-06-19 02:33:40,FAKE,2873172697,243,2873172940,2885538889
2025-06-19 02:33:42,FAKE,2873172940,244,2873173184,2885539378
2025-06-19 02:33:44,REAL,2873173184,490,2873173674,2885539868
2025-06-19 02:33:46,REAL,2873173674,478,2873174152,2885540346
2025-06-19 02:33:48,REAL,2873174152,483,2873174635,2885540829
2025-06-19 02:33:50,FAKE,2873174635,243,2873174878,2885545223
2025-06-19 02:33:52,FAKE,2873174878,238,2873175116,2885556535
2025-06-19 02:33:54,FAKE,2873175116,238,2873175354,2885566785
2025-06-19 02:33:56,REAL,2873175354,10313,2873185667,2885577098
2025-06-19 02:33:58,REAL,2873185667,10252,2873195919,2885587350
2025-06-19 02:34:00,FAKE,2873195919,243,2873196162,2885597668
2025-06-19 02:34:02,REAL,2873196162,10254,2873206416,2885607922
2025-06-19 02:34:04,REAL,2873206416,10253,2873216669,2885618175
2025-06-19 02:34:06,FAKE,2873216669,244,2873216913,2885620695
2025-06-19 02:34:08,REAL,2873216913,492,2873217405,2885621187
2025-06-19 02:34:10,FAKE,2873217405,243,2873217648,2885621675
2025-06-19 02:34:12,REAL,2873217648,485,2873218133,2885622160
2025-06-19 02:34:14,REAL,2873218133,476,2873218609,2885622636
2025-06-19 02:34:16,FAKE,2873218609,238,2873218847,2885623119
2025-06-19 02:34:18,REAL,2873218847,480,2873219327,2885623599
2025-06-19 02:34:20,FAKE,2873219327,244,2873219571,2885624082
2025-06-19 02:34:22,FAKE,2873219571,243,2873219814,2885624568
2025-06-19 02:34:24,REAL,2873219814,486,2873220300,2885625054
2025-06-19 02:34:26,FAKE,2873220300,238,2873220538,2885625539
2025-06-19 02:34:28,REAL,2873220538,489,2873221027,2885626028
2025-06-19 02:34:30,REAL,2873221027,481,2873221508,2885626509
2025-06-19 02:34:32,FAKE,2873221508,241,2873221749,2885626988
2025-06-19 02:34:34,REAL,2873221749,482,2873222231,2885627470
2025-06-19 02:34:36,REAL,2873222231,477,2873222708,2885627947
2025-06-19 02:34:38,REAL,2873222708,483,2873223191,2885628430
2025-06-19 02:34:40,REAL,2873223191,541,2873223732,2885628971
2025-06-19 02:34:42,REAL,2873223732,478,2873224210,2885629449
2025-06-19 02:34:44,REAL,2873224210,485,2873224695,2885629934
2025-06-19 02:34:46,REAL,2873224695,477,2873225172,2885630411
2025-06-19 02:34:48,REAL,2873225172,488,2873225660,2885630899
2025-06-19 02:34:50,REAL,2873225660,488,2873226148,2885631387
2025-06-19 02:34:52,REAL,2873226148,481,2873226629,2885631868
2025-06-19 02:34:54,REAL,2873226629,487,2873227116,2885632355
2025-06-19 02:34:56,REAL,2873227116,540,2873227656,2885632895
2025-06-19 02:34:58,REAL,2873227656,483,2873228139,2885633378
2025-06-19 02:35:00,REAL,2873228139,494,2873228633,2885633872
2025-06-19 02:35:02,REAL,2873228633,483,2873229116,2885634355
2025-06-19 02:35:04,REAL,2873229116,485,2873229601,2885634840
2025-06-19 02:35:06,REAL,2873229601,492,2873230093,2885635332
2025-06-19 02:35:08,REAL,2873230093,484,2873230577,2885635816
2025-06-19 02:35:10,REAL,2873230577,481,2873231058,2885636297
2025-06-19 02:35:12,REAL,2873231058,484,2873231542,2885636781
2025-06-19 02:35:14,REAL,2873231542,486,2873232028,2885637267
2025-06-19 02:35:16,REAL,2873232028,15220,2873247248,2885652487
2025-06-19 02:35:18,REAL,2873247248,10253,2873257501,2885662740
2025-06-19 02:35:20,REAL,2873257501,10317,2873267818,2885673057
2025-06-19 02:35:22,REAL,2873267818,10247,2873278065,2885683304
2025-06-19 02:35:24,FAKE,2873278065,238,2873278303,2885693624
2025-06-19 02:35:26,REAL,2873278303,10248,2873288551,2885703872
2025-06-19 02:35:28,REAL,2873288551,10255,2873298806,2885714127
2025-06-19 02:35:30,REAL,2873298806,5759,2873304565,2885719886
2025-06-19 02:35:32,FAKE,2873304565,244,2873304809,2885720371
2025-06-19 02:35:34,REAL,2873304809,487,2873305296,2885720858
2025-06-19 02:35:36,FAKE,2873305296,243,2873305539,2885721347
2025-06-19 02:35:38,FAKE,2873305539,241,2873305780,2885721830
2025-06-19 02:35:40,REAL,2873305780,483,2873306263,2885722313
2025-06-19 02:35:42,FAKE,2873306263,243,2873306506,2885722797
2025-06-19 02:35:44,REAL,2873306506,538,2873307044,2885723335
2025-06-19 02:35:46,REAL,2873307044,482,2873307526,2885723817
2025-06-19 02:35:48,REAL,2873307526,476,2873308002,2885724293
2025-06-19 02:35:50,FAKE,2873308002,238,2873308240,2885724776
2025-06-19 02:35:52,REAL,2873308240,534,2873308774,2885725310
2025-06-19 02:35:54,FAKE,2873308774,241,2873309015,2885725788
2025-06-19 02:35:56,FAKE,2873309015,244,2873309259,2885726277
2025-06-19 02:35:58,REAL,2873309259,476,2873309735,2885726753
2025-06-19 02:36:00,FAKE,2873309735,241,2873309976,2885727240
2025-06-19 02:36:02,FAKE,2873309976,241,2873310217,2885727727
2025-06-19 02:36:04,FAKE,2873310217,244,2873310461,2885728202
2025-06-19 02:36:06,REAL,2873310461,491,2873310952,2885728693
2025-06-19 02:36:08,REAL,2873310952,6559,2873317511,2885735252
2025-06-19 02:36:10,REAL,2873317511,10971,2873328482,2885746223
2025-06-19 02:36:12,REAL,2873328482,10253,2873338735,2885756476
2025-06-19 02:36:14,REAL,2873338735,10248,2873348983,2885766724
2025-06-19 02:36:16,FAKE,2873348983,244,2873349227,2885777042
2025-06-19 02:36:18,REAL,2873349227,10249,2873359476,2885787291
2025-06-19 02:36:20,REAL,2873359476,10318,2873369794,2885797609
2025-06-19 02:36:22,FAKE,2873369794,241,2873370035,2885807264
2025-06-19 02:36:24,REAL,2873370035,482,2873370517,2885807746
2025-06-19 02:36:26,FAKE,2873370517,243,2873370760,2885808226
2025-06-19 02:36:28,REAL,2873370760,480,2873371240,2885808706
2025-06-19 02:36:30,REAL,2873371240,489,2873371729,2885809195
2025-06-19 02:36:32,REAL,2873371729,483,2873372212,2885809678
2025-06-19 02:36:34,REAL,2873372212,542,2873372754,2885810220
2025-06-19 02:36:36,REAL,2873372754,483,2873373237,2885810703
2025-06-19 02:36:38,REAL,2873373237,491,2873373728,2885811194
2025-06-19 02:36:40,REAL,2873373728,481,2873374209,2885811675
2025-06-19 02:36:42,FAKE,2873374209,238,2873374447,2885812159
2025-06-19 02:36:44,REAL,2873374447,482,2873374929,2885812641
2025-06-19 02:36:46,REAL,2873374929,530,2873375459,2885813171
2025-06-19 02:36:48,REAL,2873375459,490,2873375949,2885813661
2025-06-19 02:36:50,FAKE,2873375949,238,2873376187,2885814143
2025-06-19 02:36:52,REAL,2873376187,484,2873376671,2885814627
2025-06-19 02:36:54,FAKE,2873376671,241,2873376912,2885815115
2025-06-19 02:36:56,REAL,2873376912,483,2873377395,2885815598
2025-06-19 02:36:58,FAKE,2873377395,238,2873377633,2885816087
2025-06-19 02:37:00,REAL,2873377633,487,2873378120,2885816574
2025-06-19 02:37:02,REAL,2873378120,479,2873378599,2885817053
2025-06-19 02:37:04,REAL,2873378599,492,2873379091,2885817545
2025-06-19 02:37:06,REAL,2873379091,494,2873379585,2885818039
2025-06-19 02:37:08,FAKE,2873379585,243,2873379828,2885818527
2025-06-19 02:37:10,REAL,2873379828,492,2873380320,2885819019
2025-06-19 02:37:12,REAL,2873380320,489,2873380809,2885819508
2025-06-19 02:37:14,REAL,2873380809,541,2873381350,2885820049
2025-06-19 02:37:16,REAL,2873381350,484,2873381834,2885820533
2025-06-19 02:37:18,FAKE,2873381834,238,2873382072,2885821014
2025-06-19 02:37:20,REAL,2873382072,486,2873382558,2885821500
2025-06-19 02:37:22,FAKE,2873382558,243,2873382801,2885822046
2025-06-19 02:37:24,REAL,2873382801,488,2873383289,2885822534
2025-06-19 02:37:26,FAKE,2873383289,244,2873383533,2885823017
2025-06-19 02:37:28,REAL,2873383533,478,2873384011,2885823495
2025-06-19 02:37:30,REAL,2873384011,494,2873384505,2885823989
2025-06-19 02:37:32,FAKE,2873384505,243,2873384748,2885824465
2025-06-19 02:37:34,REAL,2873384748,476,2873385224,2885824941
2025-06-19 02:37:36,FAKE,2873385224,244,2873385468,2885825421
2025-06-19 02:37:38,REAL,2873385468,475,2873385943,2885825896
2025-06-19 02:37:40,FAKE,2873385943,238,2873386181,2885826386
2025-06-19 02:37:42,REAL,2873386181,477,2873386658,2885826863
2025-06-19 02:37:44,REAL,2873386658,481,2873387139,2885827344
2025-06-19 02:37:46,FAKE,2873387139,241,2873387380,2885827829
2025-06-19 02:37:48,REAL,2873387380,480,2873387860,2885828309
2025-06-19 02:37:50,REAL,2873387860,485,2873388345,2885828794
2025-06-19 02:37:52,FAKE,2873388345,244,2873388589,2885829281
2025-06-19 02:37:54,REAL,2873388589,484,2873389073,2885829765
2025-06-19 02:37:56,REAL,2873389073,533,2873389606,2885830298
2025-06-19 02:37:58,FAKE,2873389606,241,2873389847,2885830789
2025-06-19 02:38:00,REAL,2873389847,484,2873390331,2885831273
2025-06-19 02:38:02,REAL,2873390331,535,2873390866,2885831808
2025-06-19 02:38:04,REAL,2873390866,9144,2873400010,2885840952
2025-06-19 02:38:06,FAKE,2873400010,243,2873400253,2885851532
2025-06-19 02:38:08,REAL,2873400253,10248,2873410501,2885861780
2025-06-19 02:38:10,REAL,2873410501,10321,2873420822,2885872101
2025-06-19 02:38:12,REAL,2873420822,10244,2873431066,2885882345
2025-06-19 02:38:14,REAL,2873431066,10256,2873441322,2885892601
2025-06-19 02:38:16,REAL,2873441322,10318,2873451640,2885902919
2025-06-19 02:38:18,FAKE,2873451640,238,2873451878,2885910658
2025-06-19 02:38:20,REAL,2873451878,485,2873452363,2885911143
2025-06-19 02:38:22,REAL,2873452363,484,2873452847,2885911627
2025-06-19 02:38:24,REAL,2873452847,484,2873453331,2885912111
2025-06-19 02:38:26,FAKE,2873453331,243,2873453574,2885912598
2025-06-19 02:38:28,FAKE,2873453574,241,2873453815,2885913072
2025-06-19 02:38:30,REAL,2873453815,482,2873454297,2885913554
2025-06-19 02:38:32,REAL,2873454297,484,2873454781,2885914038
2025-06-19 02:38:34,FAKE,2873454781,238,2873455019,2885914526
2025-06-19 02:38:36,REAL,2873455019,9998,2873465017,2885924524
2025-06-19 02:38:38,REAL,2873465017,10574,2873475591,2885935098
2025-06-19 02:38:40,FAKE,2873475591,238,2873475829,2885945480
2025-06-19 02:38:42,REAL,2873475829,10252,2873486081,2885955732
2025-06-19 02:38:44,REAL,2873486081,10251,2873496332,2885965983
2025-06-19 02:38:46,FAKE,2873496332,243,2873496575,2885976300
2025-06-19 02:38:48,FAKE,2873496575,238,2873496813,2885986551
2025-06-19 02:38:50,FAKE,2873496813,243,2873497056,2885993698
2025-06-19 02:38:52,FAKE,2873497056,238,2873497294,2885994179
2025-06-19 02:38:54,REAL,2873497294,480,2873497774,2885994659
2025-06-19 02:38:56,REAL,2873497774,477,2873498251,2885995136
2025-06-19 02:38:58,REAL,2873498251,482,2873498733,2885995618
2025-06-19 02:39:00,FAKE,2873498733,244,2873498977,2885995856
2025-06-19 02:39:02,FAKE,2873498977,244,2873499221,2885996336
2025-06-19 02:39:04,REAL,2873499221,481,2873499702,2885996817
2025-06-19 02:39:06,FAKE,2873499702,244,2873499946,2885997302
2025-06-19 02:39:08,FAKE,2873499946,243,2873500189,2886010657
2025-06-19 02:39:10,FAKE,2873500189,243,2873500432,2886021437
2025-06-19 02:39:12,FAKE,2873500432,241,2873500673,2886031752
2025-06-19 02:39:14,REAL,2873500673,10255,2873510928,2886042007
2025-06-19 02:39:16,FAKE,2873510928,244,2873511172,2886052257
2025-06-19 02:39:18,FAKE,2873511172,243,2873511415,2886062565
2025-06-19 02:39:20,REAL,2873511415,10320,2873521735,2886072885
2025-06-19 02:39:22,REAL,2873521735,6496,2873528231,2886079381
2025-06-19 02:39:24,FAKE,2873528231,244,2873528475,2886079866
2025-06-19 02:39:26,REAL,2873528475,475,2873528950,2886080341
2025-06-19 02:39:28,FAKE,2873528950,238,2873529188,2886080820
2025-06-19 02:39:30,REAL,2873529188,480,2873529668,2886081300
2025-06-19 02:39:32,FAKE,2873529668,241,2873529909,2886081788
2025-06-19 02:39:34,REAL,2873529909,483,2873530392,2886082271
2025-06-19 02:39:36,FAKE,2873530392,243,2873530635,2886082758
2025-06-19 02:39:38,REAL,2873530635,728,2873531363,2886083486
2025-06-19 02:39:40,REAL,2873531363,10886,2873542249,2886094372
2025-06-19 02:39:42,REAL,2873542249,10321,2873552570,2886104693
2025-06-19 02:39:44,REAL,2873552570,10248,2873562818,2886114941
2025-06-19 02:39:46,REAL,2873562818,10254,2873573072,2886125195
2025-06-19 02:39:48,FAKE,2873573072,243,2873573315,2886135513
2025-06-19 02:39:50,FAKE,2873573315,244,2873573559,2886145768
2025-06-19 02:39:52,FAKE,2873573559,241,2873573800,2886156023
2025-06-19 02:39:54,REAL,2873573800,5888,2873579688,2886161911
2025-06-19 02:39:56,REAL,2873579688,486,2873580174,2886162397
2025-06-19 02:39:58,REAL,2873580174,481,2873580655,2886162878
2025-06-19 02:40:00,REAL,2873580655,546,2873581201,2886163424
2025-06-19 02:40:02,FAKE,2873581201,241,2873581442,2886163902
2025-06-19 02:40:04,FAKE,2873581442,241,2873581683,2886164387
2025-06-19 02:40:06,REAL,2873581683,482,2873582165,2886164869
2025-06-19 02:40:08,FAKE,2873582165,241,2873582406,2886165351
2025-06-19 02:40:10,FAKE,2873582406,243,2873582649,2886165830
2025-06-19 02:40:12,REAL,2873582649,481,2873583130,2886166311
2025-06-19 02:40:14,FAKE,2873583130,241,2873583371,2886166801
2025-06-19 02:40:16,REAL,2873583371,6953,2873590324,2886173754
2025-06-19 02:40:18,REAL,2873590324,13292,2873603616,2886187046
2025-06-19 02:40:20,FAKE,2873603616,244,2873603860,2886197296
2025-06-19 02:40:22,REAL,2873603860,10314,2873614174,2886207610
2025-06-19 02:40:24,REAL,2873614174,10255,2873624429,2886217865
2025-06-19 02:40:26,REAL,2873624429,10251,2873634680,2886228116
2025-06-19 02:40:28,REAL,2873634680,10318,2873644998,2886238434
2025-06-19 02:40:30,REAL,2873644998,10115,2873655113,2886248549
2025-06-19 02:40:32,REAL,2873655113,7954,2873663067,2886256503
2025-06-19 02:40:34,FAKE,2873663067,241,2873663308,2886268799
2025-06-19 02:40:36,REAL,2873663308,10252,2873673560,2886279051
2025-06-19 02:40:38,REAL,2873673560,10311,2873683871,2886289362
2025-06-19 02:40:40,FAKE,2873683871,238,2873684109,2886299616
2025-06-19 02:40:42,FAKE,2873684109,243,2873684352,2886309917
2025-06-19 02:40:44,FAKE,2873684352,243,2873684595,2886320243
2025-06-19 02:40:46,REAL,2873684595,9796,2873694391,2886330039
2025-06-19 02:40:48,REAL,2873694391,7683,2873702074,2886337722
2025-06-19 02:40:50,REAL,2873702074,10651,2873712725,2886348373
2025-06-19 02:40:52,FAKE,2873712725,241,2873712966,2886358617
2025-06-19 02:40:54,FAKE,2873712966,238,2873713204,2886368876
2025-06-19 02:40:56,REAL,2873713204,10255,2873723459,2886379131
2025-06-19 02:40:58,REAL,2873723459,10318,2873733777,2886389449
2025-06-19 02:41:00,REAL,2873733777,10251,2873744028,2886399700
2025-06-19 02:41:02,REAL,2873744028,9522,2873753550,2886409222
2025-06-19 02:41:04,REAL,2873753550,482,2873754032,2886409704
2025-06-19 02:41:06,REAL,2873754032,483,2873754515,2886410187
2025-06-19 02:41:08,REAL,2873754515,490,2873755005,2886410677
2025-06-19 02:41:10,FAKE,2873755005,238,2873755243,2886411154
2025-06-19 02:41:12,REAL,2873755243,481,2873755724,2886411635
2025-06-19 02:41:14,FAKE,2873755724,241,2873755965,2886412125
2025-06-19 02:41:16,REAL,2873755965,489,2873756454,2886412614
2025-06-19 02:41:18,REAL,2873756454,479,2873756933,2886413093
2025-06-19 02:41:20,FAKE,2873756933,243,2873757176,2886423153
2025-06-19 02:41:22,REAL,2873757176,11579,2873768755,2886434732
2025-06-19 02:41:24,REAL,2873768755,10254,2873779009,2886444986
2025-06-19 02:41:26,REAL,2873779009,10312,2873789321,2886455298
2025-06-19 02:41:28,REAL,2873789321,10319,2873799640,2886465617
2025-06-19 02:41:30,REAL,2873799640,10254,2873809894,2886475871
2025-06-19 02:41:32,FAKE,2873809894,244,2873810138,2886486124
2025-06-19 02:41:34,FAKE,2873810138,241,2873810379,2886494998
2025-06-19 02:41:36,REAL,2873810379,494,2873810873,2886495492
2025-06-19 02:41:38,REAL,2873810873,487,2873811360,2886495979
2025-06-19 02:41:40,FAKE,2873811360,243,2873811603,2886496456
2025-06-19 02:41:42,FAKE,2873811603,243,2873811846,2886496941
2025-06-19 02:41:44,REAL,2873811846,487,2873812333,2886497428
2025-06-19 02:41:46,REAL,2873812333,543,2873812876,2886497971
2025-06-19 02:41:48,REAL,2873812876,490,2873813366,2886498461
2025-06-19 02:41:50,REAL,2873813366,483,2873813849,2886498944
2025-06-19 02:41:52,FAKE,2873813849,241,2873814090,2886499428
2025-06-19 02:41:54,FAKE,2873814090,241,2873814331,2886499905
2025-06-19 02:41:56,FAKE,2873814331,238,2873814569,2886500388
2025-06-19 02:41:58,REAL,2873814569,486,2873815055,2886500874
2025-06-19 02:42:00,REAL,2873815055,488,2873815543,2886501362
2025-06-19 02:42:02,REAL,2873815543,544,2873816087,2886501906
2025-06-19 02:42:04,REAL,2873816087,492,2873816579,2886502398
2025-06-19 02:42:06,REAL,2873816579,479,2873817058,2886502877
2025-06-19 02:42:08,REAL,2873817058,539,2873817597,2886503416
2025-06-19 02:42:10,FAKE,2873817597,241,2873817838,2886503898
2025-06-19 02:42:12,FAKE,2873817838,241,2873818079,2886504377
2025-06-19 02:42:14,REAL,2873818079,478,2873818557,2886504855
2025-06-19 02:42:16,REAL,2873818557,483,2873819040,2886505338
2025-06-19 02:42:18,REAL,2873819040,483,2873819523,2886505821
2025-06-19 02:42:20,REAL,2873819523,482,2873820005,2886506303
2025-06-19 02:42:22,REAL,2873820005,477,2873820482,2886506780
2025-06-19 02:42:24,FAKE,2873820482,244,2873820726,2886507267
2025-06-19 02:42:26,REAL,2873820726,485,2873821211,2886507752
2025-06-19 02:42:28,REAL,2873821211,3786,2873824997,2886511538
2025-06-19 02:42:30,REAL,2873824997,11518,2873836515,2886523056
2025-06-19 02:42:32,REAL,2873836515,10261,2873846776,2886533317
2025-06-19 02:42:34,REAL,2873846776,10246,2873857022,2886543563
2025-06-19 02:42:36,REAL,2873857022,10327,2873867349,2886553890
2025-06-19 02:42:38,FAKE,2873867349,238,2873867587,2886564144
2025-06-19 02:42:40,REAL,2873867587,10260,2873877847,2886574404
2025-06-19 02:42:42,REAL,2873877847,10244,2873888091,2886584648
2025-06-19 02:42:44,FAKE,2873888091,241,2873888332,2886587380
2025-06-19 02:42:46,FAKE,2873888332,243,2873888575,2886587864
2025-06-19 02:42:48,FAKE,2873888575,238,2873888813,2886588345
2025-06-19 02:42:50,REAL,2873888813,537,2873889350,2886588882
2025-06-19 02:42:52,FAKE,2873889350,241,2873889591,2886589362
2025-06-19 02:42:54,FAKE,2873889591,243,2873889834,2886589844
2025-06-19 02:42:56,FAKE,2873889834,243,2873890077,2886590326
2025-06-19 02:42:58,REAL,2873890077,477,2873890554,2886590803
2025-06-19 02:43:00,REAL,2873890554,4322,2873894876,2886595125
2025-06-19 02:43:02,REAL,2873894876,11366,2873906242,2886606491
2025-06-19 02:43:04,REAL,2873906242,10253,2873916495,2886616744
2025-06-19 02:43:06,REAL,2873916495,10255,2873926750,2886626999
2025-06-19 02:43:08,REAL,2873926750,10313,2873937063,2886637312
2025-06-19 02:43:10,REAL,2873937063,10300,2873947363,2886647612
2025-06-19 02:43:12,REAL,2873947363,10250,2873957613,2886657862
2025-06-19 02:43:14,FAKE,2873957613,244,2873957857,2886668115
2025-06-19 02:43:16,REAL,2873957857,2067,2873959924,2886670182
2025-06-19 02:43:18,REAL,2873959924,480,2873960404,2886670662
2025-06-19 02:43:20,REAL,2873960404,481,2873960885,2886671143
2025-06-19 02:43:22,REAL,2873960885,484,2873961369,2886671627
2025-06-19 02:43:24,REAL,2873961369,486,2873961855,2886672113
2025-06-19 02:43:26,FAKE,2873961855,241,2873962096,2886672589
2025-06-19 02:43:28,REAL,2873962096,487,2873962583,2886673076
2025-06-19 02:43:30,REAL,2873962583,482,2873963065,2886673558
2025-06-19 02:43:32,REAL,2873963065,536,2873963601,2886674094
2025-06-19 02:43:34,REAL,2873963601,481,2873964082,2886674575
2025-06-19 02:43:36,REAL,2873964082,487,2873964569,2886675062
2025-06-19 02:43:38,FAKE,2873964569,241,2873964810,2886675551
2025-06-19 02:43:40,REAL,2873964810,482,2873965292,2886676033
2025-06-19 02:43:42,REAL,2873965292,537,2873965829,2886676570
2025-06-19 02:43:44,FAKE,2873965829,238,2873966067,2886677051
2025-06-19 02:43:46,REAL,2873966067,478,2873966545,2886677529
2025-06-19 02:43:48,REAL,2873966545,492,2873967037,2886678021
2025-06-19 02:43:50,FAKE,2873967037,241,2873967278,2886678505
2025-06-19 02:43:52,REAL,2873967278,546,2873967824,2886679051
2025-06-19 02:43:54,REAL,2873967824,488,2873968312,2886679539
2025-06-19 02:43:56,REAL,2873968312,478,2873968790,2886680017
2025-06-19 02:43:58,FAKE,2873968790,238,2873969028,2886680495
2025-06-19 02:44:00,FAKE,2873969028,244,2873969272,2886680983
2025-06-19 02:44:02,FAKE,2873969272,238,2873969510,2886681459
2025-06-19 02:44:04,FAKE,2873969510,238,2873969748,2886681944
2025-06-19 02:44:06,FAKE,2873969748,244,2873969992,2886682424
2025-06-19 02:44:08,FAKE,2873969992,243,2873970235,2886682912
2025-06-19 02:44:10,REAL,2873970235,11191,2873981426,2886694103
2025-06-19 02:44:12,REAL,2873981426,10250,2873991676,2886704353
2025-06-19 02:44:14,REAL,2873991676,10311,2874001987,2886714664
2025-06-19 02:44:16,REAL,2874001987,10323,2874012310,2886724987
2025-06-19 02:44:18,REAL,2874012310,10256,2874022566,2886735243
2025-06-19 02:44:20,FAKE,2874022566,241,2874022807,2886745496
2025-06-19 02:44:22,REAL,2874022807,10248,2874033055,2886755744
2025-06-19 02:44:24,REAL,2874033055,5834,2874038889,2886761578
2025-06-19 02:44:26,REAL,2874038889,481,2874039370,2886762059
2025-06-19 02:44:28,REAL,2874039370,485,2874039855,2886762544
2025-06-19 02:44:30,REAL,2874039855,483,2874040338,2886763027
2025-06-19 02:44:32,REAL,2874040338,479,2874040817,2886763506
2025-06-19 02:44:34,REAL,2874040817,534,2874041351,2886764040
2025-06-19 02:44:36,REAL,2874041351,487,2874041838,2886764527
2025-06-19 02:44:38,REAL,2874041838,480,2874042318,2886765007
2025-06-19 02:44:40,REAL,2874042318,484,2874042802,2886765491
2025-06-19 02:44:42,REAL,2874042802,488,2874043290,2886765979
2025-06-19 02:44:44,REAL,2874043290,479,2874043769,2886766458
2025-06-19 02:44:46,REAL,2874043769,6494,2874050263,2886772952
2025-06-19 02:44:48,FAKE,2874050263,244,2874050507,2886784065
2025-06-19 02:44:50,REAL,2874050507,10247,2874060754,2886794312
2025-06-19 02:44:52,REAL,2874060754,10366,2874071120,2886804678
2025-06-19 02:44:54,REAL,2874071120,10256,2874081376,2886814934
2025-06-19 02:44:56,FAKE,2874081376,244,2874081620,2886825243
2025-06-19 02:44:58,FAKE,2874081620,238,2874081858,2886835557
2025-06-19 02:45:00,REAL,2874081858,9979,2874091837,2886845536
2025-06-19 02:45:02,FAKE,2874091837,243,2874092080,2886846016
2025-06-19 02:45:04,FAKE,2874092080,243,2874092323,2886846500
2025-06-19 02:45:06,REAL,2874092323,490,2874092813,2886846990
2025-06-19 02:45:08,REAL,2874092813,485,2874093298,2886847475
2025-06-19 02:45:10,FAKE,2874093298,243,2874093541,2886847960
2025-06-19 02:45:12,REAL,2874093541,488,2874094029,2886848448
2025-06-19 02:45:14,FAKE,2874094029,241,2874094270,2886848935
2025-06-19 02:45:16,FAKE,2874094270,238,2874094508,2886849484
2025-06-19 02:45:18,REAL,2874094508,6762,2874101270,2886856246
2025-06-19 02:45:20,REAL,2874101270,10777,2874112047,2886867023
2025-06-19 02:45:22,REAL,2874112047,10260,2874122307,2886877283
2025-06-19 02:45:24,FAKE,2874122307,238,2874122545,2886887601
2025-06-19 02:45:26,REAL,2874122545,10252,2874132797,2886897853
2025-06-19 02:45:28,REAL,2874132797,10259,2874143056,2886908112
2025-06-19 02:45:30,REAL,2874143056,10317,2874153373,2886918429
2025-06-19 02:45:32,REAL,2874153373,9402,2874162775,2886927831
2025-06-19 02:45:34,FAKE,2874162775,244,2874163019,2886928310
2025-06-19 02:45:36,FAKE,2874163019,241,2874163260,2886928794
2025-06-19 02:45:38,REAL,2874163260,537,2874163797,2886929331
2025-06-19 02:45:40,REAL,2874163797,487,2874164284,2886929818
2025-06-19 02:45:42,REAL,2874164284,483,2874164767,2886930301
2025-06-19 02:45:44,REAL,2874164767,486,2874165253,2886930787
2025-06-19 02:45:46,REAL,2874165253,480,2874165733,2886931267
2025-06-19 02:45:48,REAL,2874165733,491,2874166224,2886931758
2025-06-19 02:45:50,FAKE,2874166224,241,2874166465,2886939584
2025-06-19 02:45:52,REAL,2874166465,11117,2874177582,2886950701
2025-06-19 02:45:54,REAL,2874177582,10254,2874187836,2886960955
2025-06-19 02:45:56,FAKE,2874187836,238,2874188074,2886971202
2025-06-19 02:45:58,REAL,2874188074,10305,2874198379,2886981507
2025-06-19 02:46:00,REAL,2874198379,10322,2874208701,2886991829
2025-06-19 02:46:02,FAKE,2874208701,241,2874208942,2887002085
2025-06-19 02:46:04,REAL,2874208942,8808,2874217750,2887010893
2025-06-19 02:46:06,REAL,2874217750,488,2874218238,2887011381
2025-06-19 02:46:08,FAKE,2874218238,243,2874218481,2887011861
2025-06-19 02:46:10,FAKE,2874218481,244,2874218725,2887012344
2025-06-19 02:46:12,REAL,2874218725,482,2874219207,2887012826
2025-06-19 02:46:14,FAKE,2874219207,238,2874219445,2887013310
2025-06-19 02:46:16,FAKE,2874219445,241,2874219686,2887013791
2025-06-19 02:46:18,REAL,2874219686,488,2874220174,2887014279
2025-06-19 02:46:20,FAKE,2874220174,238,2874220412,2887014759
2025-06-19 02:46:22,REAL,2874220412,489,2874220901,2887015248
2025-06-19 02:46:24,REAL,2874220901,481,2874221382,2887015729
2025-06-19 02:46:26,REAL,2874221382,487,2874221869,2887016216
2025-06-19 02:46:28,FAKE,2874221869,238,2874222107,2887016753
2025-06-19 02:46:30,REAL,2874222107,490,2874222597,2887017243
2025-06-19 02:46:32,REAL,2874222597,554,2874223151,2887017797
2025-06-19 02:46:34,REAL,2874223151,488,2874223639,2887018285
2025-06-19 02:46:36,FAKE,2874223639,244,2874223883,2887018819
2025-06-19 02:46:38,FAKE,2874223883,241,2874224124,2887019299
2025-06-19 02:46:40,FAKE,2874224124,241,2874224365,2887019776
2025-06-19 02:46:42,REAL,2874224365,479,2874224844,2887020255
2025-06-19 02:46:44,FAKE,2874224844,243,2874225087,2887020737
2025-06-19 02:46:46,FAKE,2874225087,238,2874225325,2887021219
2025-06-19 02:46:48,REAL,2874225325,483,2874225808,2887021702
2025-06-19 02:46:50,FAKE,2874225808,238,2874226046,2887022186
2025-06-19 02:46:52,REAL,2874226046,487,2874226533,2887022673
2025-06-19 02:46:54,REAL,2874226533,486,2874227019,2887023159
2025-06-19 02:46:56,FAKE,2874227019,243,2874227262,2887023648
2025-06-19 02:46:58,FAKE,2874227262,243,2874227505,2887024134
2025-06-19 02:47:00,FAKE,2874227505,243,2874227748,2887024623
2025-06-19 02:47:02,FAKE,2874227748,243,2874227991,2887025103
2025-06-19 02:47:04,REAL,2874227991,537,2874228528,2887025640
2025-06-19 02:47:06,REAL,2874228528,486,2874229014,2887026126
2025-06-19 02:47:08,FAKE,2874229014,244,2874229258,2887026602
2025-06-19 02:47:10,FAKE,2874229258,238,2874229496,2887027090
2025-06-19 02:47:12,REAL,2874229496,492,2874229988,2887027582
2025-06-19 02:47:14,FAKE,2874229988,238,2874230226,2887031820
2025-06-19 02:47:16,REAL,2874230226,13549,2874243775,2887045369
2025-06-19 02:47:18,REAL,2874243775,10255,2874254030,2887055624
2025-06-19 02:47:20,REAL,2874254030,10316,2874264346,2887065940
2025-06-19 02:47:22,FAKE,2874264346,241,2874264587,2887076197
2025-06-19 02:47:24,REAL,2874264587,10247,2874274834,2887086444
2025-06-19 02:47:26,FAKE,2874274834,243,2874275077,2887096693
2025-06-19 02:47:28,REAL,2874275077,10311,2874285388,2887107004
2025-06-19 02:47:30,FAKE,2874285388,244,2874285632,2887109274
2025-06-19 02:47:32,FAKE,2874285632,241,2874285873,2887109766
2025-06-19 02:47:34,FAKE,2874285873,241,2874286114,2887110240
2025-06-19 02:47:36,REAL,2874286114,10129,2874296243,2887120369
2025-06-19 02:47:38,REAL,2874296243,10393,2874306636,2887130762
2025-06-19 02:47:40,REAL,2874306636,10320,2874316956,2887141082
2025-06-19 02:47:42,FAKE,2874316956,238,2874317194,2887151339
2025-06-19 02:47:44,FAKE,2874317194,241,2874317435,2887161585
2025-06-19 02:47:46,FAKE,2874317435,241,2874317676,2887171899
2025-06-19 02:47:48,REAL,2874317676,10258,2874327934,2887182157
2025-06-19 02:47:50,REAL,2874327934,6874,2874334808,2887189031
2025-06-19 02:47:52,REAL,2874334808,476,2874335284,2887189507
2025-06-19 02:47:54,REAL,2874335284,482,2874335766,2887189989
2025-06-19 02:47:56,FAKE,2874335766,243,2874336009,2887190481
2025-06-19 02:47:58,REAL,2874336009,483,2874336492,2887190964
2025-06-19 02:48:00,REAL,2874336492,474,2874336966,2887191438
2025-06-19 02:48:02,REAL,2874336966,475,2874337441,2887191913
2025-06-19 02:48:04,REAL,2874337441,491,2874337932,2887192404
2025-06-19 02:48:06,FAKE,2874337932,243,2874338175,2887192884
2025-06-19 02:48:08,REAL,2874338175,11641,2874349816,2887204525
2025-06-19 02:48:10,REAL,2874349816,10248,2874360064,2887214773
2025-06-19 02:48:12,FAKE,2874360064,238,2874360302,2887225089
2025-06-19 02:48:14,REAL,2874360302,10250,2874370552,2887235339
2025-06-19 02:48:16,FAKE,2874370552,244,2874370796,2887245649
2025-06-19 02:48:18,REAL,2874370796,10252,2874381048,2887255901
2025-06-19 02:48:20,REAL,2874381048,10312,2874391360,2887266213
2025-06-19 02:48:22,REAL,2874391360,6161,2874397521,2887272374
2025-06-19 02:48:24,REAL,2874397521,481,2874398002,2887272855
2025-06-19 02:48:26,REAL,2874398002,543,2874398545,2887273398
2025-06-19 02:48:28,REAL,2874398545,484,2874399029,2887273882
2025-06-19 02:48:30,REAL,2874399029,481,2874399510,2887274363
2025-06-19 02:48:32,REAL,2874399510,484,2874399994,2887274847
2025-06-19 02:48:34,REAL,2874399994,490,2874400484,2887275337
2025-06-19 02:48:36,FAKE,2874400484,243,2874400727,2887275815
2025-06-19 02:48:38,REAL,2874400727,490,2874401217,2887276305
2025-06-19 02:48:40,REAL,2874401217,11722,2874412939,2887288027
2025-06-19 02:48:42,REAL,2874412939,10244,2874423183,2887298271
2025-06-19 02:48:44,REAL,2874423183,10373,2874433556,2887308644
2025-06-19 02:48:46,REAL,2874433556,10255,2874443811,2887318899
2025-06-19 02:48:48,REAL,2874443811,10250,2874454061,2887329149
2025-06-19 02:48:50,REAL,2874454061,10321,2874464382,2887339470
2025-06-19 02:48:52,REAL,2874464382,10252,2874474634,2887349722
2025-06-19 02:48:54,FAKE,2874474634,238,2874474872,2887355286
2025-06-19 02:48:56,REAL,2874474872,484,2874475356,2887355770
2025-06-19 02:48:58,REAL,2874475356,483,2874475839,2887356253
2025-06-19 02:49:00,REAL,2874475839,482,2874476321,2887356735
2025-06-19 02:49:02,FAKE,2874476321,241,2874476562,2887357215
2025-06-19 02:49:04,REAL,2874476562,542,2874477104,2887357757
2025-06-19 02:49:06,FAKE,2874477104,241,2874477345,2887358246
2025-06-19 02:49:08,FAKE,2874477345,244,2874477589,2887358732
2025-06-19 02:49:10,FAKE,2874477589,243,2874477832,2887359353
2025-06-19 02:49:12,REAL,2874477832,15071,2874492903,2887374424
2025-06-19 02:49:14,REAL,2874492903,10252,2874503155,2887384676
2025-06-19 02:49:16,REAL,2874503155,10257,2874513412,2887394933
2025-06-19 02:49:18,REAL,2874513412,10247,2874523659,2887405180
2025-06-19 02:49:20,REAL,2874523659,10254,2874533913,2887415434
2025-06-19 02:49:22,REAL,2874533913,10256,2874544169,2887425690
2025-06-19 02:49:24,FAKE,2874544169,238,2874544407,2887435944
2025-06-19 02:49:26,REAL,2874544407,4980,2874549387,2887440924
2025-06-19 02:49:28,REAL,2874549387,480,2874549867,2887441404
2025-06-19 02:49:30,REAL,2874549867,486,2874550353,2887441890
2025-06-19 02:49:32,FAKE,2874550353,244,2874550597,2887442376
2025-06-19 02:49:34,FAKE,2874550597,243,2874550840,2887442861
2025-06-19 02:49:36,REAL,2874550840,483,2874551323,2887443344
2025-06-19 02:49:38,REAL,2874551323,487,2874551810,2887443831
2025-06-19 02:49:40,FAKE,2874551810,243,2874552053,2887444369
2025-06-19 02:49:42,REAL,2874552053,1749,2874553802,2887446118
2025-06-19 02:49:44,FAKE,2874553802,238,2874554040,2887457898
2025-06-19 02:49:46,REAL,2874554040,10253,2874564293,2887468151
2025-06-19 02:49:48,FAKE,2874564293,243,2874564536,2887478400
2025-06-19 02:49:50,FAKE,2874564536,244,2874564780,2887488714
2025-06-19 02:49:52,FAKE,2874564780,238,2874565018,2887498975
2025-06-19 02:49:54,REAL,2874565018,10325,2874575343,2887509300
2025-06-19 02:49:56,FAKE,2874575343,243,2874575586,2887519558
2025-06-19 02:49:58,REAL,2874575586,4314,2874579900,2887523872
2025-06-19 02:50:00,REAL,2874579900,491,2874580391,2887524363
2025-06-19 02:50:02,REAL,2874580391,480,2874580871,2887524843
2025-06-19 02:50:04,REAL,2874580871,487,2874581358,2887525330
2025-06-19 02:50:06,FAKE,2874581358,244,2874581602,2887525817
2025-06-19 02:50:08,REAL,2874581602,483,2874582085,2887526300
2025-06-19 02:50:10,REAL,2874582085,478,2874582563,2887526778
2025-06-19 02:50:12,REAL,2874582563,482,2874583045,2887527260
2025-06-19 02:50:14,REAL,2874583045,2477,2874585522,2887529737
2025-06-19 02:50:16,REAL,2874585522,14485,2874600007,2887544222
2025-06-19 02:50:18,REAL,2874600007,10304,2874610311,2887554526
2025-06-19 02:50:20,FAKE,2874610311,243,2874610554,2887564842
2025-06-19 02:50:22,FAKE,2874610554,238,2874610792,2887575100
2025-06-19 02:50:24,FAKE,2874610792,241,2874611033,2887585362
2025-06-19 02:50:26,FAKE,2874611033,244,2874611277,2887595681
2025-06-19 02:50:28,FAKE,2874611277,243,2874611520,2887605930
2025-06-19 02:50:30,FAKE,2874611520,244,2874611764,2887609581
2025-06-19 02:50:32,REAL,2874611764,482,2874612246,2887610063
2025-06-19 02:50:34,REAL,2874612246,488,2874612734,2887610551
2025-06-19 02:50:36,REAL,2874612734,484,2874613218,2887611035
2025-06-19 02:50:38,REAL,2874613218,477,2874613695,2887611512
2025-06-19 02:50:40,FAKE,2874613695,244,2874613939,2887611991
2025-06-19 02:50:42,REAL,2874613939,484,2874614423,2887612475
2025-06-19 02:50:44,REAL,2874614423,485,2874614908,2887612960
2025-06-19 02:50:46,REAL,2874614908,488,2874615396,2887613448
2025-06-19 02:50:48,REAL,2874615396,482,2874615878,2887613930
2025-06-19 02:50:50,REAL,2874615878,485,2874616363,2887614415
2025-06-19 02:50:52,FAKE,2874616363,243,2874616606,2887614896
2025-06-19 02:50:54,REAL,2874616606,540,2874617146,2887615436
2025-06-19 02:50:56,REAL,2874617146,476,2874617622,2887615912
2025-06-19 02:50:58,FAKE,2874617622,244,2874617866,2887616404
2025-06-19 02:51:00,REAL,2874617866,479,2874618345,2887616883
2025-06-19 02:51:02,REAL,2874618345,487,2874618832,2887617370
2025-06-19 02:51:04,REAL,2874618832,490,2874619322,2887617860
2025-06-19 02:51:06,FAKE,2874619322,241,2874619563,2887618403
2025-06-19 02:51:08,REAL,2874619563,477,2874620040,2887618880
2025-06-19 02:51:10,FAKE,2874620040,244,2874620284,2887619364
2025-06-19 02:51:12,FAKE,2874620284,244,2874620528,2887619854
2025-06-19 02:51:14,REAL,2874620528,481,2874621009,2887620335
2025-06-19 02:51:16,REAL,2874621009,482,2874621491,2887620817
2025-06-19 02:51:18,REAL,2874621491,4252,2874625743,2887625069
2025-06-19 02:51:20,REAL,2874625743,14672,2874640415,2887639741
2025-06-19 02:51:22,REAL,2874640415,10249,2874650664,2887649990
2025-06-19 02:51:24,FAKE,2874650664,238,2874650902,2887660237
2025-06-19 02:51:26,REAL,2874650902,10322,2874661224,2887670559
2025-06-19 02:51:28,FAKE,2874661224,241,2874661465,2887680812
2025-06-19 02:51:30,REAL,2874661465,10247,2874671712,2887691059
2025-06-19 02:51:32,REAL,2874671712,10319,2874682031,2887701378
2025-06-19 02:51:34,REAL,2874682031,2520,2874684551,2887703898
2025-06-19 02:51:36,FAKE,2874684551,243,2874684794,2887704381
2025-06-19 02:51:38,REAL,2874684794,494,2874685288,2887704875
2025-06-19 02:51:40,REAL,2874685288,490,2874685778,2887705365
2025-06-19 02:51:42,REAL,2874685778,481,2874686259,2887705846
2025-06-19 02:51:44,FAKE,2874686259,241,2874686500,2887706335
2025-06-19 02:51:46,REAL,2874686500,484,2874686984,2887706819
2025-06-19 02:51:48,REAL,2874686984,490,2874687474,2887707309
2025-06-19 02:51:50,REAL,2874687474,493,2874687967,2887707802
2025-06-19 02:51:52,REAL,2874687967,486,2874688453,2887708288
2025-06-19 02:51:54,REAL,2874688453,481,2874688934,2887708769
2025-06-19 02:51:56,REAL,2874688934,494,2874689428,2887709263
2025-06-19 02:51:58,FAKE,2874689428,238,2874689666,2887709743
2025-06-19 02:52:00,FAKE,2874689666,243,2874689909,2887710230
2025-06-19 02:52:02,REAL,2874689909,494,2874690403,2887710724
2025-06-19 02:52:04,FAKE,2874690403,238,2874690641,2887711206
2025-06-19 02:52:06,REAL,2874690641,478,2874691119,2887711684
2025-06-19 02:52:08,REAL,2874691119,483,2874691602,2887712167
2025-06-19 02:52:10,REAL,2874691602,540,2874692142,2887712707
2025-06-19 02:52:12,FAKE,2874692142,243,2874692385,2887713190
2025-06-19 02:52:14,FAKE,2874692385,244,2874692629,2887713677
2025-06-19 02:52:16,REAL,2874692629,548,2874693177,2887714225
2025-06-19 02:52:18,REAL,2874693177,487,2874693664,2887714712
2025-06-19 02:52:20,FAKE,2874693664,243,2874693907,2887715199
2025-06-19 02:52:22,REAL,2874693907,482,2874694389,2887715681
2025-06-19 02:52:24,REAL,2874694389,490,2874694879,2887716171
2025-06-19 02:52:26,FAKE,2874694879,243,2874695122,2887716664
2025-06-19 02:52:28,REAL,2874695122,488,2874695610,2887717152
2025-06-19 02:52:30,REAL,2874695610,488,2874696098,2887717640
2025-06-19 02:52:32,REAL,2874696098,487,2874696585,2887718127
2025-06-19 02:52:34,REAL,2874696585,481,2874697066,2887718608
2025-06-19 02:52:36,FAKE,2874697066,238,2874697304,2887719098
2025-06-19 02:52:38,REAL,2874697304,6761,2874704065,2887725859
2025-06-19 02:52:40,FAKE,2874704065,241,2874704306,2887739102
2025-06-19 02:52:42,REAL,2874704306,10246,2874714552,2887749348
2025-06-19 02:52:44,REAL,2874714552,10315,2874724867,2887759663
2025-06-19 02:52:46,REAL,2874724867,10258,2874735125,2887769921
2025-06-19 02:52:48,REAL,2874735125,10250,2874745375,2887780171
2025-06-19 02:52:50,FAKE,2874745375,241,2874745616,2887790483
2025-06-19 02:52:52,FAKE,2874745616,238,2874745854,2887800734
2025-06-19 02:52:54,REAL,2874745854,886,2874746740,2887801620
2025-06-19 02:52:56,FAKE,2874746740,241,2874746981,2887802109
2025-06-19 02:52:58,REAL,2874746981,547,2874747528,2887802656
2025-06-19 02:53:00,REAL,2874747528,479,2874748007,2887803135
2025-06-19 02:53:02,REAL,2874748007,477,2874748484,2887803612
2025-06-19 02:53:04,REAL,2874748484,483,2874748967,2887804095
2025-06-19 02:53:06,REAL,2874748967,479,2874749446,2887804574
2025-06-19 02:53:08,REAL,2874749446,488,2874749934,2887805062
2025-06-19 02:53:10,REAL,2874749934,7884,2874757818,2887812946
2025-06-19 02:53:12,REAL,2874757818,12826,2874770644,2887825772
2025-06-19 02:53:14,REAL,2874770644,10313,2874780957,2887836085
2025-06-19 02:53:16,REAL,2874780957,10255,2874791212,2887846340
2025-06-19 02:53:18,REAL,2874791212,10253,2874801465,2887856593
2025-06-19 02:53:20,REAL,2874801465,10318,2874811783,2887866911
2025-06-19 02:53:22,FAKE,2874811783,243,2874812026,2887877163
2025-06-19 02:53:24,FAKE,2874812026,241,2874812267,2887887150
2025-06-19 02:53:26,REAL,2874812267,486,2874812753,2887887636
2025-06-19 02:53:28,REAL,2874812753,482,2874813235,2887888118
2025-06-19 02:53:30,REAL,2874813235,482,2874813717,2887888600
2025-06-19 02:53:32,REAL,2874813717,479,2874814196,2887889079
2025-06-19 02:53:34,REAL,2874814196,480,2874814676,2887889559
2025-06-19 02:53:36,FAKE,2874814676,243,2874814919,2887890049
2025-06-19 02:53:38,REAL,2874814919,533,2874815452,2887890582
2025-06-19 02:53:40,REAL,2874815452,487,2874815939,2887891069
2025-06-19 02:53:42,REAL,2874815939,7371,2874823310,2887898440
2025-06-19 02:53:44,FAKE,2874823310,238,2874823548,2887909552
2025-06-19 02:53:46,REAL,2874823548,10316,2874833864,2887919868
2025-06-19 02:53:48,FAKE,2874833864,243,2874834107,2887930125
2025-06-19 02:53:50,FAKE,2874834107,243,2874834350,2887940436
2025-06-19 02:53:52,REAL,2874834350,10259,2874844609,2887950695
2025-06-19 02:53:54,FAKE,2874844609,243,2874844852,2887961016
2025-06-19 02:53:56,REAL,2874844852,9391,2874854243,2887970407
2025-06-19 02:53:58,REAL,2874854243,486,2874854729,2887970893
2025-06-19 02:54:00,FAKE,2874854729,244,2874854973,2887971379
2025-06-19 02:54:02,REAL,2874854973,486,2874855459,2887971865
2025-06-19 02:54:04,FAKE,2874855459,243,2874855702,2887972343
2025-06-19 02:54:06,REAL,2874855702,490,2874856192,2887972833
2025-06-19 02:54:08,FAKE,2874856192,243,2874856435,2887973324
2025-06-19 02:54:10,REAL,2874856435,479,2874856914,2887973803
2025-06-19 02:54:12,REAL,2874856914,474,2874857388,2887974277
2025-06-19 02:54:14,REAL,2874857388,478,2874857866,2887974755
2025-06-19 02:54:16,REAL,2874857866,487,2874858353,2887975242
2025-06-19 02:54:18,REAL,2874858353,540,2874858893,2887975782
2025-06-19 02:54:20,REAL,2874858893,491,2874859384,2887976273
2025-06-19 02:54:22,REAL,2874859384,480,2874859864,2887976753
2025-06-19 02:54:24,REAL,2874859864,482,2874860346,2887977235
2025-06-19 02:54:26,REAL,2874860346,489,2874860835,2887977724
2025-06-19 02:54:28,FAKE,2874860835,244,2874861079,2887978209
2025-06-19 02:54:30,FAKE,2874861079,244,2874861323,2887978698
2025-06-19 02:54:32,REAL,2874861323,484,2874861807,2887979182
2025-06-19 02:54:34,FAKE,2874861807,244,2874862051,2887981773
2025-06-19 02:54:36,REAL,2874862051,11373,2874873424,2887993146
2025-06-19 02:54:38,FAKE,2874873424,238,2874873662,2888003466
2025-06-19 02:54:40,FAKE,2874873662,238,2874873900,2888013724
2025-06-19 02:54:42,REAL,2874873900,10255,2874884155,2888023979
2025-06-19 02:54:44,REAL,2874884155,10247,2874894402,2888034226
2025-06-19 02:54:46,REAL,2874894402,10255,2874904657,2888044481
2025-06-19 02:54:48,REAL,2874904657,10252,2874914909,2888054733
2025-06-19 02:54:50,REAL,2874914909,3716,2874918625,2888058449
2025-06-19 02:54:52,REAL,2874918625,487,2874919112,2888058936
2025-06-19 02:54:54,REAL,2874919112,489,2874919601,2888059425
2025-06-19 02:54:56,FAKE,2874919601,244,2874919845,2888059905
2025-06-19 02:54:58,FAKE,2874919845,244,2874920089,2888060394
2025-06-19 02:55:00,REAL,2874920089,544,2874920633,2888060938
2025-06-19 02:55:02,REAL,2874920633,481,2874921114,2888061419
2025-06-19 02:55:04,FAKE,2874921114,241,2874921355,2888061902
2025-06-19 02:55:06,REAL,2874921355,484,2874921839,2888062386
2025-06-19 02:55:08,REAL,2874921839,486,2874922325,2888062872
2025-06-19 02:55:10,REAL,2874922325,489,2874922814,2888063361
2025-06-19 02:55:12,REAL,2874922814,489,2874923303,2888063850
2025-06-19 02:55:14,FAKE,2874923303,241,2874923544,2888064329
2025-06-19 02:55:16,REAL,2874923544,484,2874924028,2888064813
2025-06-19 02:55:18,REAL,2874924028,484,2874924512,2888065297
2025-06-19 02:55:20,REAL,2874924512,483,2874924995,2888065780
2025-06-19 02:55:22,REAL,2874924995,494,2874925489,2888066274
2025-06-19 02:55:24,FAKE,2874925489,241,2874925730,2888066756
2025-06-19 02:55:26,REAL,2874925730,545,2874926275,2888067301
2025-06-19 02:55:28,FAKE,2874926275,241,2874926516,2888078893
2025-06-19 02:55:30,REAL,2874926516,11248,2874937764,2888090141
2025-06-19 02:55:32,REAL,2874937764,10258,2874948022,2888100399
2025-06-19 02:55:34,REAL,2874948022,10255,2874958277,2888110654
2025-06-19 02:55:36,REAL,2874958277,10252,2874968529,2888120906
2025-06-19 02:55:38,REAL,2874968529,10252,2874978781,2888131158
2025-06-19 02:55:40,REAL,2874978781,10007,2874988788,2888141165
2025-06-19 02:55:42,REAL,2874988788,7673,2874996461,2888148838
2025-06-19 02:55:44,REAL,2874996461,486,2874996947,2888149324
2025-06-19 02:55:46,FAKE,2874996947,241,2874997188,2888149805
2025-06-19 02:55:48,REAL,2874997188,490,2874997678,2888150295
2025-06-19 02:55:50,REAL,2874997678,481,2874998159,2888150776
2025-06-19 02:55:52,REAL,2874998159,489,2874998648,2888151265
2025-06-19 02:55:54,REAL,2874998648,483,2874999131,2888151748
2025-06-19 02:55:56,FAKE,2874999131,243,2874999374,2888152240
2025-06-19 02:55:58,REAL,2874999374,483,2874999857,2888152723
2025-06-19 02:56:00,FAKE,2874999857,241,2875000098,2888163836
2025-06-19 02:56:02,REAL,2875000098,10316,2875010414,2888174152
2025-06-19 02:56:04,FAKE,2875010414,238,2875010652,2888184408
2025-06-19 02:56:06,REAL,2875010652,10313,2875020965,2888194721
2025-06-19 02:56:08,REAL,2875020965,10251,2875031216,2888204972
2025-06-19 02:56:10,REAL,2875031216,10255,2875041471,2888215227
2025-06-19 02:56:12,REAL,2875041471,10251,2875051722,2888225478
2025-06-19 02:56:14,REAL,2875051722,7019,2875058741,2888232497
2025-06-19 02:56:16,FAKE,2875058741,243,2875058984,2888232985
2025-06-19 02:56:18,REAL,2875058984,482,2875059466,2888233467
2025-06-19 02:56:20,REAL,2875059466,478,2875059944,2888233945
2025-06-19 02:56:22,REAL,2875059944,538,2875060482,2888234483
2025-06-19 02:56:24,FAKE,2875060482,241,2875060723,2888234975
2025-06-19 02:56:26,REAL,2875060723,480,2875061203,2888235455
2025-06-19 02:56:28,REAL,2875061203,493,2875061696,2888235948
2025-06-19 02:56:30,REAL,2875061696,481,2875062177,2888236429
2025-06-19 02:56:32,FAKE,2875062177,238,2875062415,2888236910
2025-06-19 02:56:34,REAL,2875062415,479,2875062894,2888237389
2025-06-19 02:56:36,FAKE,2875062894,243,2875063137,2888237871
2025-06-19 02:56:38,FAKE,2875063137,241,2875063378,2888238347
2025-06-19 02:56:40,REAL,2875063378,490,2875063868,2888238837
2025-06-19 02:56:42,FAKE,2875063868,244,2875064112,2888239373
2025-06-19 02:56:44,REAL,2875064112,480,2875064592,2888239853
2025-06-19 02:56:46,REAL,2875064592,476,2875065068,2888240329
2025-06-19 02:56:48,REAL,2875065068,479,2875065547,2888240808
2025-06-19 02:56:50,FAKE,2875065547,238,2875065785,2888241290
2025-06-19 02:56:52,REAL,2875065785,488,2875066273,2888241778
2025-06-19 02:56:54,FAKE,2875066273,241,2875066514,2888242267
2025-06-19 02:56:56,REAL,2875066514,485,2875066999,2888242752
2025-06-19 02:56:58,REAL,2875066999,481,2875067480,2888243233
2025-06-19 02:57:00,FAKE,2875067480,244,2875067724,2888243721
2025-06-19 02:57:02,REAL,2875067724,538,2875068262,2888244259
2025-06-19 02:57:04,FAKE,2875068262,241,2875068503,2888259209
2025-06-19 02:57:06,REAL,2875068503,10248,2875078751,2888269457
2025-06-19 02:57:08,FAKE,2875078751,244,2875078995,2888279701
2025-06-19 02:57:10,REAL,2875078995,10328,2875089323,2888290029
2025-06-19 02:57:12,REAL,2875089323,10257,2875099580,2888300286
2025-06-19 02:57:14,REAL,2875099580,10251,2875109831,2888310537
2025-06-19 02:57:16,FAKE,2875109831,241,2875110072,2888320789
2025-06-19 02:57:18,REAL,2875110072,5706,2875115778,2888326495
2025-06-19 02:57:20,FAKE,2875115778,241,2875116019,2888326980
2025-06-19 02:57:22,REAL,2875116019,487,2875116506,2888327467
2025-06-19 02:57:24,REAL,2875116506,6437,2875122943,2888333904
2025-06-19 02:57:26,REAL,2875122943,11105,2875134048,2888345009
2025-06-19 02:57:28,REAL,2875134048,10245,2875144293,2888355254
2025-06-19 02:57:30,REAL,2875144293,10319,2875154612,2888365573
2025-06-19 02:57:32,REAL,2875154612,10252,2875164864,2888375825
2025-06-19 02:57:34,REAL,2875164864,10244,2875175108,2888386069
2025-06-19 02:57:36,REAL,2875175108,10252,2875185360,2888396321
2025-06-19 02:57:38,REAL,2875185360,10321,2875195681,2888406642
2025-06-19 02:57:40,REAL,2875195681,537,2875196218,2888407179
2025-06-19 02:57:42,REAL,2875196218,486,2875196704,2888407665
2025-06-19 02:57:44,REAL,2875196704,488,2875197192,2888408153
2025-06-19 02:57:46,REAL,2875197192,478,2875197670,2888408631
2025-06-19 02:57:48,FAKE,2875197670,243,2875197913,2888409117
2025-06-19 02:57:50,FAKE,2875197913,241,2875198154,2888409606
2025-06-19 02:57:52,FAKE,2875198154,243,2875198397,2888410089
2025-06-19 02:57:54,REAL,2875198397,487,2875198884,2888410576
2025-06-19 02:57:56,REAL,2875198884,488,2875199372,2888411064
2025-06-19 02:57:58,REAL,2875199372,487,2875199859,2888411551
2025-06-19 02:58:00,REAL,2875199859,482,2875200341,2888412033
2025-06-19 02:58:02,REAL,2875200341,488,2875200829,2888412521
2025-06-19 02:58:04,REAL,2875200829,477,2875201306,2888412998
2025-06-19 02:58:06,REAL,2875201306,544,2875201850,2888413542
2025-06-19 02:58:08,REAL,2875201850,486,2875202336,2888414028
2025-06-19 02:58:10,REAL,2875202336,479,2875202815,2888414507
2025-06-19 02:58:12,REAL,2875202815,475,2875203290,2888414982
2025-06-19 02:58:14,REAL,2875203290,491,2875203781,2888415473
2025-06-19 02:58:16,REAL,2875203781,1484,2875205265,2888416957
2025-06-19 02:58:18,FAKE,2875205265,243,2875205508,2888429138
2025-06-19 02:58:20,REAL,2875205508,10311,2875215819,2888439449
2025-06-19 02:58:22,REAL,2875215819,10243,2875226062,2888449692
2025-06-19 02:58:24,FAKE,2875226062,243,2875226305,2888460011
2025-06-19 02:58:26,FAKE,2875226305,243,2875226548,2888470258
2025-06-19 02:58:28,REAL,2875226548,10259,2875236807,2888480517
2025-06-19 02:58:30,REAL,2875236807,10313,2875247120,2888490830
2025-06-19 02:58:32,REAL,2875247120,4381,2875251501,2888495211
2025-06-19 02:58:34,REAL,2875251501,486,2875251987,2888495697
2025-06-19 02:58:36,FAKE,2875251987,244,2875252231,2888496183
2025-06-19 02:58:38,FAKE,2875252231,238,2875252469,2888496668
2025-06-19 02:58:40,REAL,2875252469,480,2875252949,2888497148
2025-06-19 02:58:42,REAL,2875252949,480,2875253429,2888497628
2025-06-19 02:58:44,REAL,2875253429,484,2875253913,2888498112
2025-06-19 02:58:46,REAL,2875253913,490,2875254403,2888498602
2025-06-19 02:58:48,FAKE,2875254403,238,2875254641,2888499086
2025-06-19 02:58:50,FAKE,2875254641,243,2875254884,2888499569
2025-06-19 02:58:52,REAL,2875254884,476,2875255360,2888500045
2025-06-19 02:58:54,REAL,2875255360,485,2875255845,2888500530
2025-06-19 02:58:56,REAL,2875255845,485,2875256330,2888501015
2025-06-19 02:58:58,REAL,2875256330,593,2875256923,2888501608
2025-06-19 02:59:00,REAL,2875256923,481,2875257404,2888502089
2025-06-19 02:59:02,FAKE,2875257404,243,2875257647,2888502577
2025-06-19 02:59:04,FAKE,2875257647,243,2875257890,2888503065
2025-06-19 02:59:06,REAL,2875257890,485,2875258375,2888503550
2025-06-19 02:59:08,REAL,2875258375,478,2875258853,2888504028
2025-06-19 02:59:10,REAL,2875258853,483,2875259336,2888504511
2025-06-19 02:59:12,FAKE,2875259336,238,2875259574,2888504995
2025-06-19 02:59:14,REAL,2875259574,487,2875260061,2888505482
2025-06-19 02:59:16,REAL,2875260061,484,2875260545,2888505966
2025-06-19 02:59:18,REAL,2875260545,479,2875261024,2888506445
2025-06-19 02:59:20,REAL,2875261024,485,2875261509,2888506930
2025-06-19 02:59:22,REAL,2875261509,479,2875261988,2888507409
2025-06-19 02:59:24,REAL,2875261988,490,2875262478,2888507899
2025-06-19 02:59:26,REAL,2875262478,484,2875262962,2888508383
2025-06-19 02:59:28,FAKE,2875262962,238,2875263200,2888508860
2025-06-19 02:59:30,REAL,2875263200,486,2875263686,2888509346
2025-06-19 02:59:32,REAL,2875263686,486,2875264172,2888509832
2025-06-19 02:59:34,REAL,2875264172,488,2875264660,2888510320
2025-06-19 02:59:36,FAKE,2875264660,243,2875264903,2888510857
2025-06-19 02:59:38,REAL,2875264903,537,2875265440,2888511394
2025-06-19 02:59:40,REAL,2875265440,494,2875265934,2888511888
2025-06-19 02:59:42,REAL,2875265934,475,2875266409,2888512363
2025-06-19 02:59:44,REAL,2875266409,482,2875266891,2888512845
2025-06-19 02:59:46,REAL,2875266891,485,2875267376,2888513330
2025-06-19 02:59:48,REAL,2875267376,477,2875267853,2888513807
2025-06-19 02:59:50,REAL,2875267853,485,2875268338,2888514292
2025-06-19 02:59:52,REAL,2875268338,491,2875268829,2888514783
2025-06-19 02:59:54,REAL,2875268829,491,2875269320,2888515274
2025-06-19 02:59:56,FAKE,2875269320,238,2875269558,2888515757
2025-06-19 02:59:58,REAL,2875269558,487,2875270045,2888516244
2025-06-19 03:00:00,REAL,2875270045,493,2875270538,2888516737
2025-06-19 03:00:02,REAL,2875270538,487,2875271025,2888517224
2025-06-19 03:00:04,FAKE,2875271025,243,2875271268,2888517701
2025-06-19 03:00:06,REAL,2875271268,482,2875271750,2888518183
2025-06-19 03:00:08,FAKE,2875271750,238,2875271988,2888518658
2025-06-19 03:00:10,REAL,2875271988,482,2875272470,2888519140
2025-06-19 03:00:12,FAKE,2875272470,244,2875272714,2888519625
2025-06-19 03:00:14,REAL,2875272714,484,2875273198,2888520109
2025-06-19 03:00:16,REAL,2875273198,535,2875273733,2888520644
2025-06-19 03:00:18,REAL,2875273733,484,2875274217,2888521128
2025-06-19 03:00:20,REAL,2875274217,539,2875274756,2888521667
2025-06-19 03:00:22,REAL,2875274756,483,2875275239,2888522150
2025-06-19 03:00:24,REAL,2875275239,480,2875275719,2888522630
2025-06-19 03:00:26,REAL,2875275719,481,2875276200,2888523111
2025-06-19 03:00:28,FAKE,2875276200,241,2875276441,2888523601
2025-06-19 03:00:30,FAKE,2875276441,241,2875276682,2888524087
2025-06-19 03:00:32,REAL,2875276682,488,2875277170,2888524575
2025-06-19 03:00:34,FAKE,2875277170,243,2875277413,2888525057
2025-06-19 03:00:36,FAKE,2875277413,244,2875277657,2888525547
2025-06-19 03:00:38,REAL,2875277657,482,2875278139,2888526029
2025-06-19 03:00:40,REAL,2875278139,486,2875278625,2888526515
2025-06-19 03:00:42,REAL,2875278625,489,2875279114,2888527004
2025-06-19 03:00:44,REAL,2875279114,483,2875279597,2888527487
2025-06-19 03:00:46,REAL,2875279597,479,2875280076,2888527966
2025-06-19 03:00:48,REAL,2875280076,490,2875280566,2888528456
2025-06-19 03:00:50,FAKE,2875280566,243,2875280809,2888528944
2025-06-19 03:00:52,REAL,2875280809,482,2875281291,2888529426
2025-06-19 03:00:54,FAKE,2875281291,244,2875281535,2888529965
2025-06-19 03:00:56,FAKE,2875281535,238,2875281773,2888530448
2025-06-19 03:00:58,REAL,2875281773,481,2875282254,2888530929
2025-06-19 03:01:00,REAL,2875282254,481,2875282735,2888531410
2025-06-19 03:01:02,FAKE,2875282735,243,2875282978,2888531944
2025-06-19 03:01:04,REAL,2875282978,482,2875283460,2888532426
2025-06-19 03:01:06,REAL,2875283460,485,2875283945,2888532911
2025-06-19 03:01:08,REAL,2875283945,483,2875284428,2888533394
2025-06-19 03:01:10,FAKE,2875284428,243,2875284671,2888533881
2025-06-19 03:01:12,FAKE,2875284671,244,2875284915,2888534361
2025-06-19 03:01:14,FAKE,2875284915,241,2875285156,2888534853
2025-06-19 03:01:16,REAL,2875285156,4975,2875290131,2888539828
2025-06-19 03:01:18,FAKE,2875290131,244,2875290375,2888551209
2025-06-19 03:01:20,REAL,2875290375,10257,2875300632,2888561466
2025-06-19 03:01:22,REAL,2875300632,10315,2875310947,2888571781
2025-06-19 03:01:24,FAKE,2875310947,238,2875311185,2888582025
2025-06-19 03:01:26,REAL,2875311185,10246,2875321431,2888592271
2025-06-19 03:01:28,FAKE,2875321431,243,2875321674,2888602584
2025-06-19 03:01:30,FAKE,2875321674,244,2875321918,2888612838
2025-06-19 03:01:32,REAL,2875321918,1408,2875323326,2888614246
2025-06-19 03:01:34,REAL,2875323326,545,2875323871,2888614791
2025-06-19 03:01:36,FAKE,2875323871,238,2875324109,2888615267
2025-06-19 03:01:38,FAKE,2875324109,241,2875324350,2888615749
2025-06-19 03:01:40,REAL,2875324350,490,2875324840,2888616239
2025-06-19 03:01:42,REAL,2875324840,481,2875325321,2888616720
2025-06-19 03:01:44,REAL,2875325321,480,2875325801,2888617200
2025-06-19 03:01:46,REAL,2875325801,476,2875326277,2888617676
2025-06-19 03:01:48,FAKE,2875326277,238,2875326515,2888623591
2025-06-19 03:01:50,REAL,2875326515,11045,2875337560,2888634636
2025-06-19 03:01:52,REAL,2875337560,10309,2875347869,2888644945
2025-06-19 03:01:54,REAL,2875347869,10259,2875358128,2888655204
2025-06-19 03:01:56,REAL,2875358128,10251,2875368379,2888665455
2025-06-19 03:01:58,REAL,2875368379,10323,2875378702,2888675778
2025-06-19 03:02:00,FAKE,2875378702,243,2875378945,2888686021
2025-06-19 03:02:02,REAL,2875378945,10257,2875389202,2888696278
2025-06-19 03:02:04,REAL,2875389202,804,2875390006,2888697082
2025-06-19 03:02:06,REAL,2875390006,538,2875390544,2888697620
2025-06-19 03:02:08,REAL,2875390544,484,2875391028,2888698104
2025-06-19 03:02:10,REAL,2875391028,478,2875391506,2888698582
2025-06-19 03:02:12,FAKE,2875391506,243,2875391749,2888699061
2025-06-19 03:02:14,REAL,2875391749,483,2875392232,2888699544
2025-06-19 03:02:16,REAL,2875392232,486,2875392718,2888700030
2025-06-19 03:02:18,REAL,2875392718,483,2875393201,2888700513
2025-06-19 03:02:20,REAL,2875393201,477,2875393678,2888700990
2025-06-19 03:02:22,REAL,2875393678,488,2875394166,2888701478
2025-06-19 03:02:24,FAKE,2875394166,243,2875394409,2888701961
2025-06-19 03:02:26,REAL,2875394409,479,2875394888,2888702440
2025-06-19 03:02:28,REAL,2875394888,541,2875395429,2888702981
2025-06-19 03:02:30,REAL,2875395429,486,2875395915,2888703467
2025-06-19 03:02:32,REAL,2875395915,477,2875396392,2888703944
2025-06-19 03:02:34,REAL,2875396392,487,2875396879,2888704431
2025-06-19 03:02:36,FAKE,2875396879,244,2875397123,2888704918
2025-06-19 03:02:38,REAL,2875397123,546,2875397669,2888705464
2025-06-19 03:02:40,FAKE,2875397669,244,2875397913,2888705944
2025-06-19 03:02:42,REAL,2875397913,486,2875398399,2888706430
2025-06-19 03:02:44,REAL,2875398399,481,2875398880,2888706911
2025-06-19 03:02:46,REAL,2875398880,482,2875399362,2888707393
2025-06-19 03:02:48,REAL,2875399362,483,2875399845,2888707876
2025-06-19 03:02:50,FAKE,2875399845,244,2875400089,2888708365
2025-06-19 03:02:52,REAL,2875400089,8020,2875408109,2888716385
2025-06-19 03:02:54,REAL,2875408109,11110,2875419219,2888727495
2025-06-19 03:02:56,REAL,2875419219,10255,2875429474,2888737750
2025-06-19 03:02:58,FAKE,2875429474,244,2875429718,2888748068
2025-06-19 03:03:00,REAL,2875429718,10248,2875439966,2888758316
2025-06-19 03:03:02,REAL,2875439966,10257,2875450223,2888768573
2025-06-19 03:03:04,FAKE,2875450223,241,2875450464,2888778898
2025-06-19 03:03:06,FAKE,2875450464,238,2875450702,2888788165
2025-06-19 03:03:08,FAKE,2875450702,241,2875450943,2888788653
2025-06-19 03:03:10,REAL,2875450943,485,2875451428,2888789138
2025-06-19 03:03:12,FAKE,2875451428,243,2875451671,2888789685
2025-06-19 03:03:14,FAKE,2875451671,238,2875451909,2888790173
2025-06-19 03:03:16,REAL,2875451909,481,2875452390,2888790654
2025-06-19 03:03:18,REAL,2875452390,479,2875452869,2888791133
2025-06-19 03:03:20,REAL,2875452869,485,2875453354,2888791618
2025-06-19 03:03:22,REAL,2875453354,488,2875453842,2888792106
2025-06-19 03:03:24,REAL,2875453842,489,2875454331,2888792595
2025-06-19 03:03:26,FAKE,2875454331,243,2875454574,2888793075
2025-06-19 03:03:28,REAL,2875454574,487,2875455061,2888793562
2025-06-19 03:03:30,FAKE,2875455061,241,2875455302,2888794050
2025-06-19 03:03:32,REAL,2875455302,488,2875455790,2888794538
2025-06-19 03:03:34,FAKE,2875455790,243,2875456033,2888795077
2025-06-19 03:03:36,REAL,2875456033,481,2875456514,2888795558
2025-06-19 03:03:38,FAKE,2875456514,243,2875456757,2888796045
2025-06-19 03:03:40,REAL,2875456757,481,2875457238,2888796526
2025-06-19 03:03:42,FAKE,2875457238,241,2875457479,2888797016
2025-06-19 03:03:44,FAKE,2875457479,244,2875457723,2888799809
2025-06-19 03:03:46,REAL,2875457723,11523,2875469246,2888811332
2025-06-19 03:03:48,FAKE,2875469246,238,2875469484,2888821578
2025-06-19 03:03:50,FAKE,2875469484,238,2875469722,2888831830
2025-06-19 03:03:52,FAKE,2875469722,238,2875469960,2888842156
2025-06-19 03:03:54,FAKE,2875469960,244,2875470204,2888852413
2025-06-19 03:03:56,REAL,2875470204,10245,2875480449,2888862658
2025-06-19 03:03:58,FAKE,2875480449,241,2875480690,2888872975
2025-06-19 03:04:00,FAKE,2875480690,238,2875480928,2888876358
2025-06-19 03:04:02,REAL,2875480928,483,2875481411,2888876841
2025-06-19 03:04:04,REAL,2875481411,476,2875481887,2888877317
2025-06-19 03:04:06,REAL,2875481887,479,2875482366,2888877796
2025-06-19 03:04:08,REAL,2875482366,485,2875482851,2888878281
2025-06-19 03:04:10,FAKE,2875482851,244,2875483095,2888878767
2025-06-19 03:04:12,REAL,2875483095,476,2875483571,2888879243
2025-06-19 03:04:14,REAL,2875483571,488,2875484059,2888879731
2025-06-19 03:04:16,FAKE,2875484059,241,2875484300,2888883122
2025-06-19 03:04:18,REAL,2875484300,14065,2875498365,2888897187
2025-06-19 03:04:20,FAKE,2875498365,243,2875498608,2888907439
2025-06-19 03:04:22,REAL,2875498608,10315,2875508923,2888917754
2025-06-19 03:04:24,REAL,2875508923,10249,2875519172,2888928003
2025-06-19 03:04:26,FAKE,2875519172,244,2875519416,2888938319
2025-06-19 03:04:28,REAL,2875519416,10257,2875529673,2888948576
2025-06-19 03:04:30,REAL,2875529673,10313,2875539986,2888958889
2025-06-19 03:04:32,FAKE,2875539986,244,2875540230,2888961752
2025-06-19 03:04:34,FAKE,2875540230,243,2875540473,2888962240
2025-06-19 03:04:36,REAL,2875540473,482,2875540955,2888962722
2025-06-19 03:04:38,REAL,2875540955,482,2875541437,2888963204
2025-06-19 03:04:40,REAL,2875541437,493,2875541930,2888963697
2025-06-19 03:04:42,REAL,2875541930,482,2875542412,2888964179
2025-06-19 03:04:44,REAL,2875542412,483,2875542895,2888964662
2025-06-19 03:04:46,REAL,2875542895,483,2875543378,2888965145
2025-06-19 03:04:48,REAL,2875543378,476,2875543854,2888965621
2025-06-19 03:04:50,REAL,2875543854,535,2875544389,2888966156
2025-06-19 03:04:52,REAL,2875544389,479,2875544868,2888966635
2025-06-19 03:04:54,REAL,2875544868,475,2875545343,2888967110
2025-06-19 03:04:56,REAL,2875545343,478,2875545821,2888967588
2025-06-19 03:04:58,FAKE,2875545821,243,2875546064,2888968122
2025-06-19 03:05:00,REAL,2875546064,486,2875546550,2888968608
2025-06-19 03:05:02,FAKE,2875546550,244,2875546794,2888969095
2025-06-19 03:05:04,REAL,2875546794,490,2875547284,2888969585
2025-06-19 03:05:06,FAKE,2875547284,244,2875547528,2888970070
2025-06-19 03:05:08,REAL,2875547528,476,2875548004,2888970546
2025-06-19 03:05:10,REAL,2875548004,484,2875548488,2888971030
2025-06-19 03:05:12,REAL,2875548488,486,2875548974,2888971516
2025-06-19 03:05:14,REAL,2875548974,483,2875549457,2888971999
2025-06-19 03:05:16,REAL,2875549457,483,2875549940,2888972482
2025-06-19 03:05:18,REAL,2875549940,490,2875550430,2888972972
2025-06-19 03:05:20,REAL,2875550430,492,2875550922,2888973464
2025-06-19 03:05:22,REAL,2875550922,547,2875551469,2888974011
2025-06-19 03:05:24,REAL,2875551469,475,2875551944,2888974486
2025-06-19 03:05:26,REAL,2875551944,486,2875552430,2888974972
2025-06-19 03:05:28,REAL,2875552430,475,2875552905,2888975447
2025-06-19 03:05:30,FAKE,2875552905,238,2875553143,2888975937
2025-06-19 03:05:32,FAKE,2875553143,241,2875553384,2888976423
2025-06-19 03:05:34,REAL,2875553384,486,2875553870,2888976909
2025-06-19 03:05:36,FAKE,2875553870,244,2875554114,2888977383
2025-06-19 03:05:38,REAL,2875554114,545,2875554659,2888977928
2025-06-19 03:05:40,REAL,2875554659,481,2875555140,2888978409
2025-06-19 03:05:42,REAL,2875555140,480,2875555620,2888978889
2025-06-19 03:05:44,REAL,2875555620,488,2875556108,2888979377
2025-06-19 03:05:46,REAL,2875556108,481,2875556589,2888979858
2025-06-19 03:05:48,FAKE,2875556589,241,2875556830,2888980334
2025-06-19 03:05:50,FAKE,2875556830,243,2875557073,2888980812
2025-06-19 03:05:52,FAKE,2875557073,238,2875557311,2888981293
2025-06-19 03:05:54,REAL,2875557311,486,2875557797,2888981779
2025-06-19 03:05:56,REAL,2875557797,538,2875558335,2888982317
2025-06-19 03:05:58,FAKE,2875558335,244,2875558579,2888982808
2025-06-19 03:06:00,FAKE,2875558579,238,2875558817,2888983292
2025-06-19 03:06:02,REAL,2875558817,485,2875559302,2888983777
2025-06-19 03:06:04,FAKE,2875559302,243,2875559545,2888984270
2025-06-19 03:06:06,FAKE,2875559545,238,2875559783,2888984752
2025-06-19 03:06:08,FAKE,2875559783,238,2875560021,2888985237
2025-06-19 03:06:10,FAKE,2875560021,238,2875560259,2888985721
2025-06-19 03:06:12,REAL,2875560259,477,2875560736,2888986198
2025-06-19 03:06:14,REAL,2875560736,482,2875561218,2888986680
2025-06-19 03:06:16,FAKE,2875561218,243,2875561461,2888987174
2025-06-19 03:06:18,FAKE,2875561461,244,2875561705,2888987667
2025-06-19 03:06:20,FAKE,2875561705,241,2875561946,2888988207
2025-06-19 03:06:22,REAL,2875561946,483,2875562429,2888988690
2025-06-19 03:06:24,REAL,2875562429,484,2875562913,2888989174
2025-06-19 03:06:26,REAL,2875562913,477,2875563390,2888989651
2025-06-19 03:06:28,FAKE,2875563390,241,2875563631,2888990128
2025-06-19 03:06:30,REAL,2875563631,477,2875564108,2888990605
2025-06-19 03:06:32,FAKE,2875564108,238,2875564346,2888991087
2025-06-19 03:06:34,REAL,2875564346,485,2875564831,2888991572
2025-06-19 03:06:36,REAL,2875564831,487,2875565318,2888992059
2025-06-19 03:06:38,FAKE,2875565318,238,2875565556,2888992597
2025-06-19 03:06:40,REAL,2875565556,488,2875566044,2888993085
2025-06-19 03:06:42,FAKE,2875566044,244,2875566288,2888993569
2025-06-19 03:06:44,REAL,2875566288,483,2875566771,2888994052
2025-06-19 03:06:46,REAL,2875566771,484,2875567255,2888994536
2025-06-19 03:06:48,REAL,2875567255,477,2875567732,2888995013
2025-06-19 03:06:50,FAKE,2875567732,238,2875567970,2888995506
2025-06-19 03:06:52,REAL,2875567970,479,2875568449,2888995985
2025-06-19 03:06:54,REAL,2875568449,485,2875568934,2888996470
2025-06-19 03:06:56,FAKE,2875568934,238,2875569172,2888997010
2025-06-19 03:06:58,REAL,2875569172,485,2875569657,2888997495
2025-06-19 03:07:00,REAL,2875569657,492,2875570149,2888997987
2025-06-19 03:07:02,REAL,2875570149,485,2875570634,2888998472
2025-06-19 03:07:04,REAL,2875570634,484,2875571118,2888998956
2025-06-19 03:07:06,FAKE,2875571118,244,2875571362,2888999445
2025-06-19 03:07:08,REAL,2875571362,478,2875571840,2888999923
2025-06-19 03:07:10,REAL,2875571840,820,2875572660,2889000743
2025-06-19 03:07:12,REAL,2875572660,15419,2875588079,2889016162
2025-06-19 03:07:14,REAL,2875588079,10327,2875598406,2889026489
2025-06-19 03:07:16,REAL,2875598406,10251,2875608657,2889036740
2025-06-19 03:07:18,REAL,2875608657,10309,2875618966,2889047049
2025-06-19 03:07:20,REAL,2875618966,10247,2875629213,2889057296
2025-06-19 03:07:22,REAL,2875629213,10370,2875639583,2889067666
2025-06-19 03:07:24,REAL,2875639583,10257,2875649840,2889077923
2025-06-19 03:07:26,REAL,2875649840,4772,2875654612,2889082695
2025-06-19 03:07:28,REAL,2875654612,485,2875655097,2889083180
2025-06-19 03:07:30,REAL,2875655097,484,2875655581,2889083664
2025-06-19 03:07:32,REAL,2875655581,491,2875656072,2889084155
2025-06-19 03:07:34,REAL,2875656072,481,2875656553,2889084636
2025-06-19 03:07:36,REAL,2875656553,486,2875657039,2889085122
2025-06-19 03:07:38,REAL,2875657039,479,2875657518,2889085601
2025-06-19 03:07:40,REAL,2875657518,486,2875658004,2889086087
2025-06-19 03:07:42,REAL,2875658004,1808,2875659812,2889087895
2025-06-19 03:07:44,FAKE,2875659812,243,2875660055,2889099731
2025-06-19 03:07:46,REAL,2875660055,10255,2875670310,2889109986
2025-06-19 03:07:48,REAL,2875670310,10258,2875680568,2889120244
2025-06-19 03:07:50,REAL,2875680568,10316,2875690884,2889130560
2025-06-19 03:07:52,FAKE,2875690884,241,2875691125,2889140810
2025-06-19 03:07:54,REAL,2875691125,10318,2875701443,2889151128
2025-06-19 03:07:56,FAKE,2875701443,244,2875701687,2889161390
2025-06-19 03:07:58,REAL,2875701687,4184,2875705871,2889165574
2025-06-19 03:08:00,REAL,2875705871,480,2875706351,2889166054
2025-06-19 03:08:02,REAL,2875706351,487,2875706838,2889166541
2025-06-19 03:08:04,REAL,2875706838,539,2875707377,2889167080
2025-06-19 03:08:06,FAKE,2875707377,241,2875707618,2889167568
2025-06-19 03:08:08,REAL,2875707618,492,2875708110,2889168060
2025-06-19 03:08:10,REAL,2875708110,485,2875708595,2889168545
2025-06-19 03:08:12,FAKE,2875708595,244,2875708839,2889169028
2025-06-19 03:08:14,REAL,2875708839,484,2875709323,2889169512
2025-06-19 03:08:16,FAKE,2875709323,244,2875709567,2889169998
2025-06-19 03:08:18,REAL,2875709567,543,2875710110,2889170541
2025-06-19 03:08:20,REAL,2875710110,490,2875710600,2889171031
2025-06-19 03:08:22,FAKE,2875710600,243,2875710843,2889171523
2025-06-19 03:08:24,REAL,2875710843,476,2875711319,2889171999
2025-06-19 03:08:26,REAL,2875711319,489,2875711808,2889172488
2025-06-19 03:08:28,FAKE,2875711808,243,2875712051,2889172979
2025-06-19 03:08:30,FAKE,2875712051,238,2875712289,2889173463
2025-06-19 03:08:32,REAL,2875712289,485,2875712774,2889173948
2025-06-19 03:08:34,REAL,2875712774,480,2875713254,2889174428
2025-06-19 03:08:36,REAL,2875713254,481,2875713735,2889174909
2025-06-19 03:08:38,FAKE,2875713735,238,2875713973,2889175389
2025-06-19 03:08:40,REAL,2875713973,481,2875714454,2889175870
2025-06-19 03:08:42,FAKE,2875714454,244,2875714698,2889176358
2025-06-19 03:08:44,REAL,2875714698,491,2875715189,2889176849
2025-06-19 03:08:46,REAL,2875715189,482,2875715671,2889177331
2025-06-19 03:08:48,REAL,2875715671,544,2875716215,2889177875
2025-06-19 03:08:50,REAL,2875716215,491,2875716706,2889178366
2025-06-19 03:08:52,FAKE,2875716706,243,2875716949,2889178846
2025-06-19 03:08:54,REAL,2875716949,536,2875717485,2889179382
2025-06-19 03:08:56,REAL,2875717485,476,2875717961,2889179858
2025-06-19 03:08:58,REAL,2875717961,487,2875718448,2889180345
2025-06-19 03:09:00,REAL,2875718448,486,2875718934,2889180831
2025-06-19 03:09:02,FAKE,2875718934,243,2875719177,2889181324
2025-06-19 03:09:04,FAKE,2875719177,238,2875719415,2889181798
2025-06-19 03:09:06,FAKE,2875719415,241,2875719656,2889182287
2025-06-19 03:09:08,REAL,2875719656,477,2875720133,2889182764
2025-06-19 03:09:10,REAL,2875720133,482,2875720615,2889183246
2025-06-19 03:09:12,FAKE,2875720615,244,2875720859,2889183739
2025-06-19 03:09:14,REAL,2875720859,489,2875721348,2889184228
2025-06-19 03:09:16,REAL,2875721348,484,2875721832,2889184712
2025-06-19 03:09:18,REAL,2875721832,485,2875722317,2889185197
2025-06-19 03:09:20,REAL,2875722317,489,2875722806,2889185686
2025-06-19 03:09:22,REAL,2875722806,489,2875723295,2889186175
2025-06-19 03:09:24,FAKE,2875723295,238,2875723533,2889186659
2025-06-19 03:09:26,FAKE,2875723533,243,2875723776,2889187137
2025-06-19 03:09:28,REAL,2875723776,4121,2875727897,2889191258
2025-06-19 03:09:30,REAL,2875727897,14416,2875742313,2889205674
2025-06-19 03:09:32,REAL,2875742313,10373,2875752686,2889216047
2025-06-19 03:09:34,REAL,2875752686,10253,2875762939,2889226300
2025-06-19 03:09:36,REAL,2875762939,10313,2875773252,2889236613
2025-06-19 03:09:38,FAKE,2875773252,244,2875773496,2889246865
2025-06-19 03:09:40,REAL,2875773496,10255,2875783751,2889257120
2025-06-19 03:09:42,FAKE,2875783751,244,2875783995,2889267364
2025-06-19 03:09:44,REAL,2875783995,2200,2875786195,2889269564
2025-06-19 03:09:46,REAL,2875786195,490,2875786685,2889270054
2025-06-19 03:09:48,REAL,2875786685,483,2875787168,2889270537
2025-06-19 03:09:50,REAL,2875787168,478,2875787646,2889271015
2025-06-19 03:09:52,REAL,2875787646,483,2875788129,2889271498
2025-06-19 03:09:54,REAL,2875788129,488,2875788617,2889271986
2025-06-19 03:09:56,FAKE,2875788617,243,2875788860,2889272467
2025-06-19 03:09:58,REAL,2875788860,487,2875789347,2889272954
2025-06-19 03:10:00,REAL,2875789347,5705,2875795052,2889278659
2025-06-19 03:10:02,REAL,2875795052,10790,2875805842,2889289449
2025-06-19 03:10:04,REAL,2875805842,10251,2875816093,2889299700
2025-06-19 03:10:06,FAKE,2875816093,238,2875816331,2889309951
2025-06-19 03:10:08,REAL,2875816331,10254,2875826585,2889320205
2025-06-19 03:10:10,REAL,2875826585,10316,2875836901,2889330521
2025-06-19 03:10:12,REAL,2875836901,10252,2875847153,2889340773
2025-06-19 03:10:14,REAL,2875847153,10299,2875857452,2889351072
2025-06-19 03:10:16,REAL,2875857452,1611,2875859063,2889352683
2025-06-19 03:10:18,REAL,2875859063,488,2875859551,2889353171
2025-06-19 03:10:20,REAL,2875859551,486,2875860037,2889353657
2025-06-19 03:10:22,REAL,2875860037,491,2875860528,2889354148
2025-06-19 03:10:24,REAL,2875860528,478,2875861006,2889354626
2025-06-19 03:10:26,FAKE,2875861006,244,2875861250,2889355106
2025-06-19 03:10:28,REAL,2875861250,484,2875861734,2889355590
2025-06-19 03:10:30,FAKE,2875861734,238,2875861972,2889356077
2025-06-19 03:10:32,REAL,2875861972,486,2875862458,2889356563
2025-06-19 03:10:34,FAKE,2875862458,244,2875862702,2889357106
2025-06-19 03:10:36,REAL,2875862702,490,2875863192,2889357596
2025-06-19 03:10:38,REAL,2875863192,483,2875863675,2889358079
2025-06-19 03:10:40,REAL,2875863675,478,2875864153,2889358557
2025-06-19 03:10:42,REAL,2875864153,491,2875864644,2889359048
2025-06-19 03:10:44,REAL,2875864644,485,2875865129,2889359533
2025-06-19 03:10:46,FAKE,2875865129,241,2875865370,2889360021
2025-06-19 03:10:48,REAL,2875865370,480,2875865850,2889360501
2025-06-19 03:10:50,FAKE,2875865850,243,2875866093,2889360980
2025-06-19 03:10:52,REAL,2875866093,486,2875866579,2889361466
2025-06-19 03:10:54,REAL,2875866579,11510,2875878089,2889372976
2025-06-19 03:10:56,REAL,2875878089,10325,2875888414,2889383301
2025-06-19 03:10:58,FAKE,2875888414,243,2875888657,2889393604
2025-06-19 03:11:00,REAL,2875888657,10253,2875898910,2889403857
2025-06-19 03:11:02,FAKE,2875898910,243,2875899153,2889414178
2025-06-19 03:11:04,REAL,2875899153,10250,2875909403,2889424428
2025-06-19 03:11:06,REAL,2875909403,10318,2875919721,2889434746
2025-06-19 03:11:08,FAKE,2875919721,243,2875919964,2889440186
2025-06-19 03:11:10,REAL,2875919964,483,2875920447,2889440669
2025-06-19 03:11:12,REAL,2875920447,481,2875920928,2889441150
2025-06-19 03:11:14,FAKE,2875920928,238,2875921166,2889441630
2025-06-19 03:11:16,REAL,2875921166,482,2875921648,2889442112
2025-06-19 03:11:18,REAL,2875921648,484,2875922132,2889442596
2025-06-19 03:11:20,FAKE,2875922132,244,2875922376,2889443075
2025-06-19 03:11:22,REAL,2875922376,491,2875922867,2889443566
2025-06-19 03:11:24,REAL,2875922867,683,2875923550,2889444249
2025-06-19 03:11:26,REAL,2875923550,13014,2875936564,2889457263
2025-06-19 03:11:28,REAL,2875936564,10252,2875946816,2889467515
2025-06-19 03:11:30,REAL,2875946816,10254,2875957070,2889477769
2025-06-19 03:11:32,FAKE,2875957070,243,2875957313,2889488092
2025-06-19 03:11:34,REAL,2875957313,10250,2875967563,2889498342
2025-06-19 03:11:36,FAKE,2875967563,244,2875967807,2889508600
2025-06-19 03:11:38,REAL,2875967807,10311,2875978118,2889518911
2025-06-19 03:11:40,REAL,2875978118,4896,2875983014,2889523807
2025-06-19 03:11:42,REAL,2875983014,480,2875983494,2889524287
2025-06-19 03:11:44,FAKE,2875983494,238,2875983732,2889524774
2025-06-19 03:11:46,FAKE,2875983732,241,2875983973,2889525259
2025-06-19 03:11:48,REAL,2875983973,483,2875984456,2889525742
2025-06-19 03:11:50,FAKE,2875984456,238,2875984694,2889526231
2025-06-19 03:11:52,FAKE,2875984694,244,2875984938,2889526711
2025-06-19 03:11:54,FAKE,2875984938,238,2875985176,2889527188
2025-06-19 03:11:56,FAKE,2875985176,238,2875985414,2889529005
2025-06-19 03:11:58,REAL,2875985414,12095,2875997509,2889541100
2025-06-19 03:12:00,REAL,2875997509,10316,2876007825,2889551416
2025-06-19 03:12:02,FAKE,2876007825,238,2876008063,2889561666
2025-06-19 03:12:04,REAL,2876008063,10243,2876018306,2889571909
2025-06-19 03:12:06,FAKE,2876018306,238,2876018544,2889582229
2025-06-19 03:12:08,FAKE,2876018544,238,2876018782,2889592484
2025-06-19 03:12:10,FAKE,2876018782,238,2876019020,2889602804
2025-06-19 03:12:12,FAKE,2876019020,243,2876019263,2889607054
2025-06-19 03:12:14,REAL,2876019263,482,2876019745,2889607536
2025-06-19 03:12:16,FAKE,2876019745,243,2876019988,2889608021
2025-06-19 03:12:18,REAL,2876019988,488,2876020476,2889608509
2025-06-19 03:12:20,REAL,2876020476,539,2876021015,2889609048
2025-06-19 03:12:22,REAL,2876021015,490,2876021505,2889609538
2025-06-19 03:12:24,FAKE,2876021505,243,2876021748,2889610016
2025-06-19 03:12:26,REAL,2876021748,482,2876022230,2889610498
2025-06-19 03:12:28,FAKE,2876022230,241,2876022471,2889613044
2025-06-19 03:12:30,REAL,2876022471,14882,2876037353,2889627926
2025-06-19 03:12:32,REAL,2876037353,10318,2876047671,2889638244
2025-06-19 03:12:34,REAL,2876047671,10254,2876057925,2889648498
2025-06-19 03:12:36,REAL,2876057925,10322,2876068247,2889658820
2025-06-19 03:12:38,FAKE,2876068247,243,2876068490,2889669078
2025-06-19 03:12:40,REAL,2876068490,10321,2876078811,2889679399
2025-06-19 03:12:42,FAKE,2876078811,241,2876079052,2889689404
2025-06-19 03:12:44,REAL,2876079052,3585,2876082637,2889692989
2025-06-19 03:12:46,REAL,2876082637,486,2876083123,2889693475
2025-06-19 03:12:48,FAKE,2876083123,243,2876083366,2889693956
2025-06-19 03:12:50,REAL,2876083366,490,2876083856,2889694446
2025-06-19 03:12:52,FAKE,2876083856,244,2876084100,2889694933
2025-06-19 03:12:54,REAL,2876084100,486,2876084586,2889695419
2025-06-19 03:12:56,FAKE,2876084586,243,2876084829,2889695900
2025-06-19 03:12:58,REAL,2876084829,486,2876085315,2889696386
2025-06-19 03:13:00,REAL,2876085315,3058,2876088373,2889699444
2025-06-19 03:13:02,REAL,2876088373,15124,2876103497,2889714568
2025-06-19 03:13:04,REAL,2876103497,10247,2876113744,2889724815
2025-06-19 03:13:06,FAKE,2876113744,238,2876113982,2889735063
2025-06-19 03:13:08,REAL,2876113982,10312,2876124294,2889745375
2025-06-19 03:13:10,REAL,2876124294,10253,2876134547,2889755628
2025-06-19 03:13:12,FAKE,2876134547,238,2876134785,2889765873
2025-06-19 03:13:14,REAL,2876134785,10321,2876145106,2889776194
2025-06-19 03:13:16,REAL,2876145106,2996,2876148102,2889779190
2025-06-19 03:13:18,FAKE,2876148102,244,2876148346,2889779674
2025-06-19 03:13:20,REAL,2876148346,483,2876148829,2889780157
2025-06-19 03:13:22,FAKE,2876148829,244,2876149073,2889780645
2025-06-19 03:13:24,FAKE,2876149073,244,2876149317,2889781127
2025-06-19 03:13:26,REAL,2876149317,490,2876149807,2889781617
2025-06-19 03:13:28,FAKE,2876149807,238,2876150045,2889782095
2025-06-19 03:13:30,FAKE,2876150045,244,2876150289,2889782579
2025-06-19 03:13:32,REAL,2876150289,4320,2876154609,2889786899
2025-06-19 03:13:34,FAKE,2876154609,243,2876154852,2889798278
2025-06-19 03:13:36,FAKE,2876154852,243,2876155095,2889808525
2025-06-19 03:13:38,FAKE,2876155095,238,2876155333,2889818782
2025-06-19 03:13:40,REAL,2876155333,10248,2876165581,2889829030
2025-06-19 03:13:42,REAL,2876165581,10305,2876175886,2889839335
2025-06-19 03:13:44,FAKE,2876175886,241,2876176127,2889849589
2025-06-19 03:13:46,REAL,2876176127,10259,2876186386,2889859848
2025-06-19 03:13:48,REAL,2876186386,2396,2876188782,2889862244
2025-06-19 03:13:50,FAKE,2876188782,244,2876189026,2889862726
2025-06-19 03:13:52,REAL,2876189026,483,2876189509,2889863209
2025-06-19 03:13:54,REAL,2876189509,492,2876190001,2889863701
2025-06-19 03:13:56,REAL,2876190001,484,2876190485,2889864185
2025-06-19 03:13:58,REAL,2876190485,484,2876190969,2889864669
2025-06-19 03:14:00,REAL,2876190969,489,2876191458,2889865158
2025-06-19 03:14:02,REAL,2876191458,483,2876191941,2889865641
2025-06-19 03:14:04,REAL,2876191941,485,2876192426,2889866126
2025-06-19 03:14:06,FAKE,2876192426,241,2876192667,2889866611
2025-06-19 03:14:08,FAKE,2876192667,244,2876192911,2889867098
2025-06-19 03:14:10,FAKE,2876192911,243,2876193154,2889867580
2025-06-19 03:14:12,REAL,2876193154,484,2876193638,2889868064
2025-06-19 03:14:14,FAKE,2876193638,243,2876193881,2889868541
2025-06-19 03:14:16,REAL,2876193881,488,2876194369,2889869029
2025-06-19 03:14:18,REAL,2876194369,535,2876194904,2889869564
2025-06-19 03:14:20,REAL,2876194904,480,2876195384,2889870044
2025-06-19 03:14:22,REAL,2876195384,477,2876195861,2889870521
2025-06-19 03:14:24,REAL,2876195861,542,2876196403,2889871063
2025-06-19 03:14:26,FAKE,2876196403,238,2876196641,2889871544
2025-06-19 03:14:28,REAL,2876196641,479,2876197120,2889872023
2025-06-19 03:14:30,REAL,2876197120,479,2876197599,2889872502
2025-06-19 03:14:32,REAL,2876197599,485,2876198084,2889872987
2025-06-19 03:14:34,FAKE,2876198084,241,2876198325,2889873465
2025-06-19 03:14:36,FAKE,2876198325,238,2876198563,2889873954
2025-06-19 03:14:38,FAKE,2876198563,243,2876198806,2889874429
2025-06-19 03:14:40,REAL,2876198806,485,2876199291,2889874914
2025-06-19 03:14:42,FAKE,2876199291,238,2876199529,2889875402
2025-06-19 03:14:44,REAL,2876199529,489,2876200018,2889875891
2025-06-19 03:14:46,FAKE,2876200018,243,2876200261,2889876380
2025-06-19 03:14:48,REAL,2876200261,483,2876200744,2889876863
2025-06-19 03:14:50,FAKE,2876200744,244,2876200988,2889877346
2025-06-19 03:14:52,FAKE,2876200988,241,2876201229,2889877825
2025-06-19 03:14:54,FAKE,2876201229,241,2876201470,2889878307
2025-06-19 03:14:56,FAKE,2876201470,241,2876201711,2889878787
2025-06-19 03:14:58,FAKE,2876201711,243,2876201954,2889879270
2025-06-19 03:15:00,REAL,2876201954,480,2876202434,2889879750
2025-06-19 03:15:02,REAL,2876202434,482,2876202916,2889880232
2025-06-19 03:15:04,REAL,2876202916,595,2876203511,2889880827
2025-06-19 03:15:06,REAL,2876203511,482,2876203993,2889881309
2025-06-19 03:15:08,REAL,2876203993,486,2876204479,2889881795
2025-06-19 03:15:10,REAL,2876204479,487,2876204966,2889882282
2025-06-19 03:15:12,REAL,2876204966,477,2876205443,2889882759
2025-06-19 03:15:14,FAKE,2876205443,243,2876205686,2889883247
2025-06-19 03:15:16,REAL,2876205686,488,2876206174,2889883735
2025-06-19 03:15:18,FAKE,2876206174,243,2876206417,2889884210
2025-06-19 03:15:20,REAL,2876206417,482,2876206899,2889884692
2025-06-19 03:15:22,FAKE,2876206899,243,2876207142,2889885177
2025-06-19 03:15:24,REAL,2876207142,479,2876207621,2889885656
2025-06-19 03:15:26,REAL,2876207621,482,2876208103,2889886138
2025-06-19 03:15:28,FAKE,2876208103,238,2876208341,2889886692
2025-06-19 03:15:30,FAKE,2876208341,244,2876208585,2889898921
2025-06-19 03:15:32,FAKE,2876208585,238,2876208823,2889909167
2025-06-19 03:15:34,REAL,2876208823,10311,2876219134,2889919478
2025-06-19 03:15:36,REAL,2876219134,10256,2876229390,2889929734
2025-06-19 03:15:38,FAKE,2876229390,244,2876229634,2889939979
2025-06-19 03:15:40,FAKE,2876229634,244,2876229878,2889950230
2025-06-19 03:15:42,REAL,2876229878,10321,2876240199,2889960551
2025-06-19 03:15:44,REAL,2876240199,4969,2876245168,2889965520
2025-06-19 03:15:46,REAL,2876245168,489,2876245657,2889966009
2025-06-19 03:15:48,FAKE,2876245657,241,2876245898,2889966544
2025-06-19 03:15:50,REAL,2876245898,7023,2876252921,2889973567
2025-06-19 03:15:52,FAKE,2876252921,244,2876253165,2889984623
2025-06-19 03:15:54,REAL,2876253165,10253,2876263418,2889994876
2025-06-19 03:15:56,REAL,2876263418,10252,2876273670,2890005128
2025-06-19 03:15:58,FAKE,2876273670,238,2876273908,2890015384
2025-06-19 03:16:00,FAKE,2876273908,244,2876274152,2890025693
2025-06-19 03:16:02,REAL,2876274152,10245,2876284397,2890035938
2025-06-19 03:16:04,REAL,2876284397,9522,2876293919,2890045460
2025-06-19 03:16:06,REAL,2876293919,491,2876294410,2890045951
2025-06-19 03:16:08,FAKE,2876294410,238,2876294648,2890046433
2025-06-19 03:16:10,REAL,2876294648,480,2876295128,2890046913
2025-06-19 03:16:12,REAL,2876295128,485,2876295613,2890047398
2025-06-19 03:16:14,REAL,2876295613,481,2876296094,2890047879
2025-06-19 03:16:16,REAL,2876296094,487,2876296581,2890048366
2025-06-19 03:16:18,FAKE,2876296581,238,2876296819,2890048852
2025-06-19 03:16:20,REAL,2876296819,486,2876297305,2890049338
2025-06-19 03:16:22,FAKE,2876297305,241,2876297546,2890056690
2025-06-19 03:16:24,FAKE,2876297546,238,2876297784,2890067484
2025-06-19 03:16:26,FAKE,2876297784,241,2876298025,2890077808
2025-06-19 03:16:28,REAL,2876298025,10244,2876308269,2890088052
2025-06-19 03:16:30,REAL,2876308269,10306,2876318575,2890098358
2025-06-19 03:16:32,REAL,2876318575,10320,2876328895,2890108678
2025-06-19 03:16:34,FAKE,2876328895,241,2876329136,2890118936
2025-06-19 03:16:36,REAL,2876329136,8934,2876338070,2890127870
2025-06-19 03:16:38,REAL,2876338070,491,2876338561,2890128361
2025-06-19 03:16:40,FAKE,2876338561,243,2876338804,2890128838
2025-06-19 03:16:42,REAL,2876338804,488,2876339292,2890129326
2025-06-19 03:16:44,FAKE,2876339292,244,2876339536,2890129811
2025-06-19 03:16:46,FAKE,2876339536,238,2876339774,2890130287
2025-06-19 03:16:48,FAKE,2876339774,244,2876340018,2890130771
2025-06-19 03:16:50,FAKE,2876340018,238,2876340256,2890131253
2025-06-19 03:16:52,FAKE,2876340256,238,2876340494,2890131741
2025-06-19 03:16:54,REAL,2876340494,10538,2876351032,2890142279
2025-06-19 03:16:56,REAL,2876351032,11770,2876362802,2890154049
2025-06-19 03:16:58,FAKE,2876362802,238,2876363040,2890164369
2025-06-19 03:17:00,FAKE,2876363040,244,2876363284,2890174616
2025-06-19 03:17:02,REAL,2876363284,10255,2876373539,2890184871
2025-06-19 03:17:04,REAL,2876373539,10322,2876383861,2890195193
2025-06-19 03:17:06,REAL,2876383861,10309,2876394170,2890205502
2025-06-19 03:17:08,REAL,2876394170,8275,2876402445,2890213777
2025-06-19 03:17:10,FAKE,2876402445,241,2876402686,2890214260
2025-06-19 03:17:12,FAKE,2876402686,244,2876402930,2890214746
2025-06-19 03:17:14,REAL,2876402930,483,2876403413,2890215229
2025-06-19 03:17:16,REAL,2876403413,481,2876403894,2890215710
2025-06-19 03:17:18,REAL,2876403894,484,2876404378,2890216194
2025-06-19 03:17:20,FAKE,2876404378,243,2876404621,2890216673
2025-06-19 03:17:22,REAL,2876404621,488,2876405109,2890217161
2025-06-19 03:17:24,FAKE,2876405109,238,2876405347,2890217641
2025-06-19 03:17:26,REAL,2876405347,486,2876405833,2890218127
2025-06-19 03:17:28,REAL,2876405833,490,2876406323,2890218617
2025-06-19 03:17:30,FAKE,2876406323,244,2876406567,2890219107
2025-06-19 03:17:32,REAL,2876406567,476,2876407043,2890219583
2025-06-19 03:17:34,REAL,2876407043,489,2876407532,2890220072
2025-06-19 03:17:36,FAKE,2876407532,241,2876407773,2890220557
2025-06-19 03:17:38,REAL,2876407773,478,2876408251,2890221035
2025-06-19 03:17:40,REAL,2876408251,543,2876408794,2890221578
2025-06-19 03:17:42,REAL,2876408794,539,2876409333,2890222117
2025-06-19 03:17:44,REAL,2876409333,485,2876409818,2890222602
2025-06-19 03:17:46,FAKE,2876409818,244,2876410062,2890223078
2025-06-19 03:17:48,REAL,2876410062,482,2876410544,2890223560
2025-06-19 03:17:50,FAKE,2876410544,244,2876410788,2890224050
2025-06-19 03:17:52,REAL,2876410788,481,2876411269,2890224531
2025-06-19 03:17:54,REAL,2876411269,479,2876411748,2890225010
2025-06-19 03:17:56,REAL,2876411748,491,2876412239,2890225501
2025-06-19 03:17:58,REAL,2876412239,9804,2876422043,2890235305
2025-06-19 03:18:00,FAKE,2876422043,238,2876422281,2890245625
2025-06-19 03:18:02,REAL,2876422281,10250,2876432531,2890255875
2025-06-19 03:18:04,REAL,2876432531,10318,2876442849,2890266193
2025-06-19 03:18:06,REAL,2876442849,10250,2876453099,2890276443
2025-06-19 03:18:08,FAKE,2876453099,241,2876453340,2890286699
2025-06-19 03:18:10,REAL,2876453340,10251,2876463591,2890296950
2025-06-19 03:18:12,REAL,2876463591,7091,2876470682,2890304041
2025-06-19 03:18:14,REAL,2876470682,548,2876471230,2890304589
2025-06-19 03:18:16,REAL,2876471230,484,2876471714,2890305073
2025-06-19 03:18:18,REAL,2876471714,482,2876472196,2890305555
2025-06-19 03:18:20,REAL,2876472196,480,2876472676,2890306035
2025-06-19 03:18:22,REAL,2876472676,482,2876473158,2890306517
2025-06-19 03:18:24,REAL,2876473158,480,2876473638,2890306997
2025-06-19 03:18:26,REAL,2876473638,479,2876474117,2890307476
2025-06-19 03:18:28,REAL,2876474117,486,2876474603,2890307962
2025-06-19 03:18:30,REAL,2876474603,10860,2876485463,2890318822
2025-06-19 03:18:32,REAL,2876485463,10252,2876495715,2890329074
2025-06-19 03:18:34,FAKE,2876495715,241,2876495956,2890339328
2025-06-19 03:18:36,REAL,2876495956,10258,2876506214,2890349586
2025-06-19 03:18:38,FAKE,2876506214,241,2876506455,2890359902
2025-06-19 03:18:40,REAL,2876506455,10250,2876516705,2890370152
2025-06-19 03:18:42,FAKE,2876516705,243,2876516948,2890380403
2025-06-19 03:18:44,REAL,2876516948,6421,2876523369,2890386824
2025-06-19 03:18:46,REAL,2876523369,480,2876523849,2890387304
2025-06-19 03:18:48,REAL,2876523849,485,2876524334,2890387789
2025-06-19 03:18:50,REAL,2876524334,540,2876524874,2890388329
2025-06-19 03:18:52,FAKE,2876524874,241,2876525115,2890388815
2025-06-19 03:18:54,FAKE,2876525115,238,2876525353,2890389298
2025-06-19 03:18:56,REAL,2876525353,489,2876525842,2890389787
2025-06-19 03:18:58,REAL,2876525842,492,2876526334,2890390279
2025-06-19 03:19:00,REAL,2876526334,482,2876526816,2890390761
2025-06-19 03:19:02,FAKE,2876526816,238,2876527054,2890391251
2025-06-19 03:19:04,REAL,2876527054,483,2876527537,2890391734
2025-06-19 03:19:06,REAL,2876527537,479,2876528016,2890392213
2025-06-19 03:19:08,REAL,2876528016,485,2876528501,2890392698
2025-06-19 03:19:10,REAL,2876528501,486,2876528987,2890393184
2025-06-19 03:19:12,FAKE,2876528987,244,2876529231,2890393675
2025-06-19 03:19:14,REAL,2876529231,482,2876529713,2890394157
2025-06-19 03:19:16,REAL,2876529713,536,2876530249,2890394693
2025-06-19 03:19:18,FAKE,2876530249,244,2876530493,2890395175
2025-06-19 03:19:20,FAKE,2876530493,243,2876530736,2890395659
2025-06-19 03:19:22,FAKE,2876530736,244,2876530980,2890401694
2025-06-19 03:19:24,REAL,2876530980,10772,2876541752,2890412466
2025-06-19 03:19:26,REAL,2876541752,10319,2876552071,2890422785
2025-06-19 03:19:28,REAL,2876552071,10246,2876562317,2890433031
2025-06-19 03:19:30,REAL,2876562317,10251,2876572568,2890443282
2025-06-19 03:19:32,FAKE,2876572568,241,2876572809,2890453602
2025-06-19 03:19:34,REAL,2876572809,10260,2876583069,2890463862
2025-06-19 03:19:36,FAKE,2876583069,241,2876583310,2890474183
2025-06-19 03:19:38,REAL,2876583310,488,2876583798,2890474671
2025-06-19 03:19:40,FAKE,2876583798,244,2876584042,2890475152
2025-06-19 03:19:42,REAL,2876584042,487,2876584529,2890475639
2025-06-19 03:19:44,REAL,2876584529,485,2876585014,2890476124
2025-06-19 03:19:46,REAL,2876585014,482,2876585496,2890476606
2025-06-19 03:19:48,REAL,2876585496,490,2876585986,2890477096
2025-06-19 03:19:50,FAKE,2876585986,243,2876586229,2890477587
2025-06-19 03:19:52,FAKE,2876586229,244,2876586473,2890478064
2025-06-19 03:19:54,REAL,2876586473,9146,2876595619,2890487210
2025-06-19 03:19:56,FAKE,2876595619,238,2876595857,2890499448
2025-06-19 03:19:58,FAKE,2876595857,241,2876596098,2890509774
2025-06-19 03:20:00,FAKE,2876596098,238,2876596336,2890520092
2025-06-19 03:20:02,FAKE,2876596336,243,2876596579,2890530336
2025-06-19 03:20:04,FAKE,2876596579,238,2876596817,2890540662
2025-06-19 03:20:06,FAKE,2876596817,238,2876597055,2890550918
2025-06-19 03:20:08,REAL,2876597055,9729,2876606784,2890560647
2025-06-19 03:20:10,REAL,2876606784,482,2876607266,2890561129
2025-06-19 03:20:12,REAL,2876607266,492,2876607758,2890561621
2025-06-19 03:20:14,FAKE,2876607758,241,2876607999,2890562109
2025-06-19 03:20:16,FAKE,2876607999,243,2876608242,2890562601
2025-06-19 03:20:18,FAKE,2876608242,238,2876608480,2890563093
2025-06-19 03:20:20,REAL,2876608480,479,2876608959,2890563572
2025-06-19 03:20:22,REAL,2876608959,483,2876609442,2890564055
2025-06-19 03:20:24,REAL,2876609442,484,2876609926,2890564539
2025-06-19 03:20:26,REAL,2876609926,9070,2876618996,2890573609
2025-06-19 03:20:28,FAKE,2876618996,238,2876619234,2890585577
2025-06-19 03:20:30,REAL,2876619234,10314,2876629548,2890595891
2025-06-19 03:20:32,REAL,2876629548,10256,2876639804,2890606147
2025-06-19 03:20:34,REAL,2876639804,10310,2876650114,2890616457
2025-06-19 03:20:36,REAL,2876650114,10247,2876660361,2890626704
2025-06-19 03:20:38,REAL,2876660361,10248,2876670609,2890636952
2025-06-19 03:20:40,FAKE,2876670609,244,2876670853,2890646021
2025-06-19 03:20:42,REAL,2876670853,485,2876671338,2890646506
2025-06-19 03:20:44,REAL,2876671338,486,2876671824,2890646992
2025-06-19 03:20:46,FAKE,2876671824,238,2876672062,2890647481
2025-06-19 03:20:48,FAKE,2876672062,244,2876672306,2890647959
2025-06-19 03:20:50,REAL,2876672306,487,2876672793,2890648446
2025-06-19 03:20:52,REAL,2876672793,479,2876673272,2890648925
2025-06-19 03:20:54,REAL,2876673272,494,2876673766,2890649419
2025-06-19 03:20:56,REAL,2876673766,490,2876674256,2890649909
2025-06-19 03:20:58,REAL,2876674256,8016,2876682272,2890657925
2025-06-19 03:21:00,REAL,2876682272,10648,2876692920,2890668573
2025-06-19 03:21:02,REAL,2876692920,10247,2876703167,2890678820
2025-06-19 03:21:04,REAL,2876703167,10255,2876713422,2890689075
2025-06-19 03:21:06,FAKE,2876713422,241,2876713663,2890699333
2025-06-19 03:21:08,FAKE,2876713663,238,2876713901,2890709642
2025-06-19 03:21:10,REAL,2876713901,10315,2876724216,2890719957
2025-06-19 03:21:12,REAL,2876724216,8472,2876732688,2890728429
2025-06-19 03:21:14,REAL,2876732688,484,2876733172,2890728913
2025-06-19 03:21:16,FAKE,2876733172,244,2876733416,2890729393
2025-06-19 03:21:18,REAL,2876733416,485,2876733901,2890729878
2025-06-19 03:21:20,FAKE,2876733901,241,2876734142,2890730362
2025-06-19 03:21:22,REAL,2876734142,482,2876734624,2890730844
2025-06-19 03:21:24,REAL,2876734624,480,2876735104,2890731324
2025-06-19 03:21:26,REAL,2876735104,482,2876735586,2890731806
2025-06-19 03:21:28,REAL,2876735586,486,2876736072,2890732292
2025-06-19 03:21:30,REAL,2876736072,485,2876736557,2890732777
2025-06-19 03:21:32,REAL,2876736557,491,2876737048,2890733268
2025-06-19 03:21:34,REAL,2876737048,479,2876737527,2890733747
2025-06-19 03:21:36,FAKE,2876737527,243,2876737770,2890734229
2025-06-19 03:21:38,REAL,2876737770,488,2876738258,2890734717
2025-06-19 03:21:40,REAL,2876738258,477,2876738735,2890735194
2025-06-19 03:21:42,REAL,2876738735,494,2876739229,2890735688
2025-06-19 03:21:44,REAL,2876739229,600,2876739829,2890736288
2025-06-19 03:21:46,REAL,2876739829,480,2876740309,2890736768
2025-06-19 03:21:48,REAL,2876740309,491,2876740800,2890737259
2025-06-19 03:21:50,FAKE,2876740800,238,2876741038,2890737742
2025-06-19 03:21:52,REAL,2876741038,478,2876741516,2890738220
2025-06-19 03:21:54,REAL,2876741516,481,2876741997,2890738701
2025-06-19 03:21:56,REAL,2876741997,480,2876742477,2890739181
2025-06-19 03:21:58,REAL,2876742477,485,2876742962,2890739666
2025-06-19 03:22:00,REAL,2876742962,478,2876743440,2890740144
2025-06-19 03:22:02,FAKE,2876743440,238,2876743678,2890740627
2025-06-19 03:22:04,REAL,2876743678,482,2876744160,2890741109
2025-06-19 03:22:06,FAKE,2876744160,241,2876744401,2890741598
2025-06-19 03:22:08,FAKE,2876744401,244,2876744645,2890742086
2025-06-19 03:22:10,REAL,2876744645,482,2876745127,2890742568
2025-06-19 03:22:12,REAL,2876745127,478,2876745605,2890743046
2025-06-19 03:22:14,REAL,2876745605,544,2876746149,2890743590
2025-06-19 03:22:16,REAL,2876746149,540,2876746689,2890744130
2025-06-19 03:22:18,REAL,2876746689,479,2876747168,2890744609
2025-06-19 03:22:20,REAL,2876747168,481,2876747649,2890745090
2025-06-19 03:22:22,REAL,2876747649,480,2876748129,2890745570
2025-06-19 03:22:24,REAL,2876748129,490,2876748619,2890746060
2025-06-19 03:22:26,REAL,2876748619,477,2876749096,2890746537
2025-06-19 03:22:28,REAL,2876749096,481,2876749577,2890747018
2025-06-19 03:22:30,FAKE,2876749577,243,2876749820,2890747494
2025-06-19 03:22:32,REAL,2876749820,491,2876750311,2890747985
2025-06-19 03:22:34,REAL,2876750311,10863,2876761174,2890758848
2025-06-19 03:22:36,FAKE,2876761174,238,2876761412,2890769292
2025-06-19 03:22:38,FAKE,2876761412,241,2876761653,2890779543
2025-06-19 03:22:40,FAKE,2876761653,241,2876761894,2890789789
2025-06-19 03:22:42,REAL,2876761894,10326,2876772220,2890800115
2025-06-19 03:22:44,REAL,2876772220,10247,2876782467,2890810362
2025-06-19 03:22:46,REAL,2876782467,10256,2876792723,2890820618
2025-06-19 03:22:48,REAL,2876792723,6630,2876799353,2890827248
2025-06-19 03:22:50,REAL,2876799353,485,2876799838,2890827733
2025-06-19 03:22:52,FAKE,2876799838,244,2876800082,2890828269
2025-06-19 03:22:54,REAL,2876800082,5114,2876805196,2890833383
2025-06-19 03:22:56,FAKE,2876805196,241,2876805437,2890844899
2025-06-19 03:22:58,REAL,2876805437,10252,2876815689,2890855151
2025-06-19 03:23:00,REAL,2876815689,10244,2876825933,2890865395
2025-06-19 03:23:02,REAL,2876825933,10252,2876836185,2890875647
2025-06-19 03:23:04,REAL,2876836185,10261,2876846446,2890885908
2025-06-19 03:23:06,REAL,2876846446,10256,2876856702,2890896164
2025-06-19 03:23:08,FAKE,2876856702,244,2876856946,2890906417
2025-06-19 03:23:10,REAL,2876856946,1533,2876858479,2890907950
2025-06-19 03:23:12,REAL,2876858479,484,2876858963,2890908434
2025-06-19 03:23:14,REAL,2876858963,488,2876859451,2890908922
2025-06-19 03:23:16,FAKE,2876859451,241,2876859692,2890909401
2025-06-19 03:23:18,REAL,2876859692,481,2876860173,2890909882
2025-06-19 03:23:20,REAL,2876860173,485,2876860658,2890910367
2025-06-19 03:23:22,REAL,2876860658,481,2876861139,2890910848
2025-06-19 03:23:24,REAL,2876861139,544,2876861683,2890911392
2025-06-19 03:23:26,REAL,2876861683,5762,2876867445,2890917154
2025-06-19 03:23:28,REAL,2876867445,11121,2876878566,2890928275
2025-06-19 03:23:30,FAKE,2876878566,243,2876878809,2890938599
2025-06-19 03:23:32,REAL,2876878809,10252,2876889061,2890948851
2025-06-19 03:23:34,REAL,2876889061,10261,2876899322,2890959112
2025-06-19 03:23:36,REAL,2876899322,10315,2876909637,2890969427
2025-06-19 03:23:38,REAL,2876909637,10254,2876919891,2890979681
2025-06-19 03:23:40,REAL,2876919891,10258,2876930149,2890989939
2025-06-19 03:23:42,FAKE,2876930149,238,2876930387,2890990821
2025-06-19 03:23:44,REAL,2876930387,482,2876930869,2890991303
2025-06-19 03:23:46,REAL,2876930869,479,2876931348,2890991782
2025-06-19 03:23:48,FAKE,2876931348,238,2876931586,2890992265
2025-06-19 03:23:50,FAKE,2876931586,238,2876931824,2890992750
2025-06-19 03:23:52,REAL,2876931824,484,2876932308,2890993234
2025-06-19 03:23:54,REAL,2876932308,538,2876932846,2890993772
2025-06-19 03:23:56,FAKE,2876932846,243,2876933089,2890994259
2025-06-19 03:23:58,FAKE,2876933089,241,2876933330,2891001093
2025-06-19 03:24:00,FAKE,2876933330,243,2876933573,2891012271
2025-06-19 03:24:02,REAL,2876933573,10256,2876943829,2891022527
2025-06-19 03:24:04,REAL,2876943829,10317,2876954146,2891032844
2025-06-19 03:24:06,REAL,2876954146,10257,2876964403,2891043101
2025-06-19 03:24:08,REAL,2876964403,10253,2876974656,2891053354
2025-06-19 03:24:10,REAL,2876974656,10250,2876984906,2891063604
2025-06-19 03:24:12,REAL,2876984906,10053,2876994959,2891073657
2025-06-19 03:24:14,REAL,2876994959,486,2876995445,2891074143
2025-06-19 03:24:16,REAL,2876995445,485,2876995930,2891074628
2025-06-19 03:24:18,FAKE,2876995930,238,2876996168,2891075118
2025-06-19 03:24:20,REAL,2876996168,482,2876996650,2891075600
2025-06-19 03:24:22,REAL,2876996650,480,2876997130,2891076080
2025-06-19 03:24:24,REAL,2876997130,485,2876997615,2891076565
2025-06-19 03:24:26,REAL,2876997615,536,2876998151,2891077101
2025-06-19 03:24:28,FAKE,2876998151,241,2876998392,2891077590
2025-06-19 03:24:30,FAKE,2876998392,244,2876998636,2891078071
2025-06-19 03:24:32,REAL,2876998636,547,2876999183,2891078618
2025-06-19 03:24:34,FAKE,2876999183,241,2876999424,2891079109
2025-06-19 03:24:36,FAKE,2876999424,243,2876999667,2891079598
2025-06-19 03:24:38,REAL,2876999667,487,2877000154,2891080085
2025-06-19 03:24:40,REAL,2877000154,479,2877000633,2891080564
2025-06-19 03:24:42,REAL,2877000633,488,2877001121,2891081052
2025-06-19 03:24:44,REAL,2877001121,489,2877001610,2891081541
2025-06-19 03:24:46,REAL,2877001610,478,2877002088,2891082019
2025-06-19 03:24:48,REAL,2877002088,488,2877002576,2891082507
2025-06-19 03:24:50,REAL,2877002576,1875,2877004451,2891084382
2025-06-19 03:24:52,REAL,2877004451,12043,2877016494,2891096425
2025-06-19 03:24:54,FAKE,2877016494,243,2877016737,2891106676
2025-06-19 03:24:56,FAKE,2877016737,243,2877016980,2891117047
2025-06-19 03:24:58,REAL,2877016980,10252,2877027232,2891127299
2025-06-19 03:25:00,REAL,2877027232,10245,2877037477,2891137544
2025-06-19 03:25:02,REAL,2877037477,10317,2877047794,2891147861
2025-06-19 03:25:04,FAKE,2877047794,244,2877048038,2891158115
2025-06-19 03:25:06,REAL,2877048038,4235,2877052273,2891162350
2025-06-19 03:25:08,REAL,2877052273,481,2877052754,2891162831
2025-06-19 03:25:10,REAL,2877052754,487,2877053241,2891163318
2025-06-19 03:25:12,REAL,2877053241,487,2877053728,2891163805
2025-06-19 03:25:14,REAL,2877053728,490,2877054218,2891164295
2025-06-19 03:25:16,REAL,2877054218,489,2877054707,2891164784
2025-06-19 03:25:18,REAL,2877054707,491,2877055198,2891165275
2025-06-19 03:25:20,REAL,2877055198,483,2877055681,2891165758
2025-06-19 03:25:22,REAL,2877055681,489,2877056170,2891166247
2025-06-19 03:25:24,FAKE,2877056170,244,2877056414,2891166787
2025-06-19 03:25:26,FAKE,2877056414,243,2877056657,2891167269
2025-06-19 03:25:28,REAL,2877056657,481,2877057138,2891167750
2025-06-19 03:25:30,REAL,2877057138,486,2877057624,2891168236
2025-06-19 03:25:32,FAKE,2877057624,243,2877057867,2891168714
2025-06-19 03:25:34,REAL,2877057867,488,2877058355,2891169202
2025-06-19 03:25:36,REAL,2877058355,484,2877058839,2891169686
2025-06-19 03:25:38,REAL,2877058839,481,2877059320,2891170167
2025-06-19 03:25:40,REAL,2877059320,540,2877059860,2891170707
2025-06-19 03:25:42,FAKE,2877059860,244,2877060104,2891171182
2025-06-19 03:25:44,REAL,2877060104,491,2877060595,2891171673
2025-06-19 03:25:46,REAL,2877060595,485,2877061080,2891172158
2025-06-19 03:25:48,REAL,2877061080,483,2877061563,2891172641
2025-06-19 03:25:50,REAL,2877061563,487,2877062050,2891173128
2025-06-19 03:25:52,FAKE,2877062050,244,2877062294,2891173668
2025-06-19 03:25:54,REAL,2877062294,485,2877062779,2891174153
2025-06-19 03:25:56,FAKE,2877062779,244,2877063023,2891174641
2025-06-19 03:25:58,REAL,2877063023,480,2877063503,2891175121
2025-06-19 03:26:00,FAKE,2877063503,244,2877063747,2891184143
2025-06-19 03:26:02,REAL,2877063747,10580,2877074327,2891194723
2025-06-19 03:26:04,REAL,2877074327,10250,2877084577,2891204973
2025-06-19 03:26:06,REAL,2877084577,10255,2877094832,2891215228
2025-06-19 03:26:08,REAL,2877094832,10255,2877105087,2891225483
2025-06-19 03:26:10,REAL,2877105087,10321,2877115408,2891235804
2025-06-19 03:26:12,REAL,2877115408,10255,2877125663,2891246059
2025-06-19 03:26:14,REAL,2877125663,7801,2877133464,2891253860
2025-06-19 03:26:16,FAKE,2877133464,238,2877133702,2891254343
2025-06-19 03:26:18,REAL,2877133702,480,2877134182,2891254823
2025-06-19 03:26:20,REAL,2877134182,487,2877134669,2891255310
2025-06-19 03:26:22,REAL,2877134669,480,2877135149,2891255790
2025-06-19 03:26:24,FAKE,2877135149,238,2877135387,2891256273
2025-06-19 03:26:26,FAKE,2877135387,244,2877135631,2891256756
2025-06-19 03:26:28,FAKE,2877135631,238,2877135869,2891257235
2025-06-19 03:26:30,FAKE,2877135869,238,2877136107,2891257718
2025-06-19 03:26:32,REAL,2877136107,10058,2877146165,2891267776
2025-06-19 03:26:34,FAKE,2877146165,241,2877146406,2891278365
2025-06-19 03:26:36,REAL,2877146406,10247,2877156653,2891288612
2025-06-19 03:26:38,FAKE,2877156653,244,2877156897,2891298929
2025-06-19 03:26:40,REAL,2877156897,10251,2877167148,2891309180
2025-06-19 03:26:42,REAL,2877167148,10248,2877177396,2891319428
2025-06-19 03:26:44,REAL,2877177396,10319,2877187715,2891329747
2025-06-19 03:26:46,REAL,2877187715,7076,2877194791,2891336823
2025-06-19 03:26:48,REAL,2877194791,539,2877195330,2891337362
2025-06-19 03:26:50,REAL,2877195330,489,2877195819,2891337851
2025-06-19 03:26:52,REAL,2877195819,486,2877196305,2891338337
2025-06-19 03:26:54,REAL,2877196305,482,2877196787,2891338819
2025-06-19 03:26:56,REAL,2877196787,482,2877197269,2891339301
2025-06-19 03:26:58,REAL,2877197269,488,2877197757,2891339789
2025-06-19 03:27:00,REAL,2877197757,479,2877198236,2891340268
2025-06-19 03:27:02,REAL,2877198236,480,2877198716,2891340748
2025-06-19 03:27:04,REAL,2877198716,10454,2877209170,2891351202
2025-06-19 03:27:06,REAL,2877209170,10510,2877219680,2891361712
2025-06-19 03:27:08,REAL,2877219680,10246,2877229926,2891371958
2025-06-19 03:27:10,REAL,2877229926,10316,2877240242,2891382274
2025-06-19 03:27:12,REAL,2877240242,10301,2877250543,2891392575
2025-06-19 03:27:14,REAL,2877250543,10251,2877260794,2891402826
2025-06-19 03:27:16,REAL,2877260794,10311,2877271105,2891413137
2025-06-19 03:27:18,FAKE,2877271105,244,2877271349,2891419623
2025-06-19 03:27:20,FAKE,2877271349,241,2877271590,2891420112
2025-06-19 03:27:22,FAKE,2877271590,241,2877271831,2891420598
2025-06-19 03:27:24,REAL,2877271831,489,2877272320,2891421087
2025-06-19 03:27:26,REAL,2877272320,489,2877272809,2891421576
2025-06-19 03:27:28,REAL,2877272809,492,2877273301,2891422068
2025-06-19 03:27:30,REAL,2877273301,485,2877273786,2891422553
2025-06-19 03:27:32,REAL,2877273786,484,2877274270,2891423037
2025-06-19 03:27:34,REAL,2877274270,485,2877274755,2891423522
2025-06-19 03:27:36,REAL,2877274755,481,2877275236,2891424003
2025-06-19 03:27:38,FAKE,2877275236,241,2877275477,2891424481
2025-06-19 03:27:40,REAL,2877275477,591,2877276068,2891425072
2025-06-19 03:27:42,REAL,2877276068,485,2877276553,2891425557
2025-06-19 03:27:44,REAL,2877276553,483,2877277036,2891426040
2025-06-19 03:27:46,FAKE,2877277036,243,2877277279,2891426524
2025-06-19 03:27:48,REAL,2877277279,481,2877277760,2891427005
2025-06-19 03:27:50,REAL,2877277760,492,2877278252,2891427497
2025-06-19 03:27:52,REAL,2877278252,15024,2877293276,2891442521
2025-06-19 03:27:54,REAL,2877293276,10255,2877303531,2891452776
2025-06-19 03:27:56,REAL,2877303531,10318,2877313849,2891463094
2025-06-19 03:27:58,REAL,2877313849,10254,2877324103,2891473348
2025-06-19 03:28:00,FAKE,2877324103,241,2877324344,2891483604
2025-06-19 03:28:02,FAKE,2877324344,241,2877324585,2891493858
2025-06-19 03:28:04,FAKE,2877324585,244,2877324829,2891504181
2025-06-19 03:28:06,REAL,2877324829,5550,2877330379,2891509731
2025-06-19 03:28:08,FAKE,2877330379,243,2877330622,2891510221
2025-06-19 03:28:10,REAL,2877330622,492,2877331114,2891510713
2025-06-19 03:28:12,REAL,2877331114,487,2877331601,2891511200
2025-06-19 03:28:14,REAL,2877331601,491,2877332092,2891511691
2025-06-19 03:28:16,FAKE,2877332092,244,2877332336,2891512173
2025-06-19 03:28:18,FAKE,2877332336,238,2877332574,2891512659
2025-06-19 03:28:20,REAL,2877332574,482,2877333056,2891513141
2025-06-19 03:28:22,FAKE,2877333056,238,2877333294,2891513759
2025-06-19 03:28:24,REAL,2877333294,12229,2877345523,2891525988
2025-06-19 03:28:26,REAL,2877345523,10259,2877355782,2891536247
2025-06-19 03:28:28,FAKE,2877355782,243,2877356025,2891546497
2025-06-19 03:28:30,REAL,2877356025,10315,2877366340,2891556812
2025-06-19 03:28:32,REAL,2877366340,10255,2877376595,2891567067
2025-06-19 03:28:34,REAL,2877376595,10371,2877386966,2891577438
2025-06-19 03:28:36,REAL,2877386966,10257,2877397223,2891587695
2025-06-19 03:28:38,REAL,2877397223,4904,2877402127,2891592599
2025-06-19 03:28:40,FAKE,2877402127,241,2877402368,2891593088
2025-06-19 03:28:42,REAL,2877402368,491,2877402859,2891593579
2025-06-19 03:28:44,REAL,2877402859,485,2877403344,2891594064
2025-06-19 03:28:46,REAL,2877403344,482,2877403826,2891594546
2025-06-19 03:28:48,REAL,2877403826,483,2877404309,2891595029
2025-06-19 03:28:50,REAL,2877404309,486,2877404795,2891595515
2025-06-19 03:28:52,REAL,2877404795,482,2877405277,2891595997
2025-06-19 03:28:54,FAKE,2877405277,238,2877405515,2891597742
2025-06-19 03:28:56,REAL,2877405515,11505,2877417020,2891609247
2025-06-19 03:28:58,FAKE,2877417020,238,2877417258,2891619565
2025-06-19 03:29:00,FAKE,2877417258,243,2877417501,2891629867
2025-06-19 03:29:02,REAL,2877417501,10250,2877427751,2891640117
2025-06-19 03:29:04,REAL,2877427751,10246,2877437997,2891650363
2025-06-19 03:29:06,REAL,2877437997,10316,2877448313,2891660679
2025-06-19 03:29:08,FAKE,2877448313,244,2877448557,2891670935
2025-06-19 03:29:10,REAL,2877448557,4314,2877452871,2891675249
2025-06-19 03:29:12,REAL,2877452871,484,2877453355,2891675733
2025-06-19 03:29:14,FAKE,2877453355,241,2877453596,2891676220
2025-06-19 03:29:16,FAKE,2877453596,241,2877453837,2891676709
2025-06-19 03:29:18,REAL,2877453837,484,2877454321,2891677193
2025-06-19 03:29:20,REAL,2877454321,493,2877454814,2891677686
2025-06-19 03:29:22,REAL,2877454814,486,2877455300,2891678172
2025-06-19 03:29:24,REAL,2877455300,477,2877455777,2891678649
2025-06-19 03:29:26,FAKE,2877455777,241,2877456018,2891681440
2025-06-19 03:29:28,REAL,2877456018,12368,2877468386,2891693808
2025-06-19 03:29:30,REAL,2877468386,9787,2877478173,2891703595
2025-06-19 03:29:32,FAKE,2877478173,243,2877478416,2891713849
2025-06-19 03:29:34,REAL,2877478416,10248,2877488664,2891724097
2025-06-19 03:29:36,FAKE,2877488664,241,2877488905,2891734104
2025-06-19 03:29:38,REAL,2877488905,10324,2877499229,2891744428
2025-06-19 03:29:40,FAKE,2877499229,244,2877499473,2891754687
2025-06-19 03:29:42,REAL,2877499473,3649,2877503122,2891758336
2025-06-19 03:29:44,REAL,2877503122,482,2877503604,2891758818
2025-06-19 03:29:46,REAL,2877503604,485,2877504089,2891759303
2025-06-19 03:29:48,REAL,2877504089,484,2877504573,2891759787
2025-06-19 03:29:50,REAL,2877504573,492,2877505065,2891760279
2025-06-19 03:29:52,REAL,2877505065,492,2877505557,2891760771
2025-06-19 03:29:54,REAL,2877505557,540,2877506097,2891761311
2025-06-19 03:29:56,REAL,2877506097,478,2877506575,2891761789
2025-06-19 03:29:58,REAL,2877506575,3333,2877509908,2891765122
2025-06-19 03:30:00,FAKE,2877509908,238,2877510146,2891776562
2025-06-19 03:30:02,FAKE,2877510146,244,2877510390,2891786818
2025-06-19 03:30:04,REAL,2877510390,10246,2877520636,2891797064
2025-06-19 03:30:06,REAL,2877520636,10251,2877530887,2891807315
2025-06-19 03:30:08,REAL,2877530887,10250,2877541137,2891817565
2025-06-19 03:30:10,FAKE,2877541137,241,2877541378,2891827809
2025-06-19 03:30:12,REAL,2877541378,10322,2877551700,2891838131
2025-06-19 03:30:14,REAL,2877551700,2995,2877554695,2891841126
2025-06-19 03:30:16,REAL,2877554695,482,2877555177,2891841608
2025-06-19 03:30:18,REAL,2877555177,485,2877555662,2891842093
2025-06-19 03:30:20,REAL,2877555662,538,2877556200,2891842631
2025-06-19 03:30:22,FAKE,2877556200,243,2877556443,2891843113
2025-06-19 03:30:24,REAL,2877556443,480,2877556923,2891843593
2025-06-19 03:30:26,REAL,2877556923,479,2877557402,2891844072
2025-06-19 03:30:28,FAKE,2877557402,244,2877557646,2891844552
2025-06-19 03:30:30,REAL,2877557646,482,2877558128,2891845034
2025-06-19 03:30:32,REAL,2877558128,485,2877558613,2891845519
2025-06-19 03:30:34,REAL,2877558613,477,2877559090,2891845996
2025-06-19 03:30:36,FAKE,2877559090,238,2877559328,2891846472
2025-06-19 03:30:38,FAKE,2877559328,241,2877559569,2891847010
2025-06-19 03:30:40,REAL,2877559569,480,2877560049,2891847490
2025-06-19 03:30:42,REAL,2877560049,480,2877560529,2891847970
2025-06-19 03:30:44,REAL,2877560529,480,2877561009,2891848450
2025-06-19 03:30:46,FAKE,2877561009,238,2877561247,2891848982
2025-06-19 03:30:48,REAL,2877561247,488,2877561735,2891849470
2025-06-19 03:30:50,REAL,2877561735,484,2877562219,2891849954
2025-06-19 03:30:52,FAKE,2877562219,238,2877562457,2891850443
2025-06-19 03:30:54,REAL,2877562457,476,2877562933,2891850919
2025-06-19 03:30:56,FAKE,2877562933,244,2877563177,2891851405
2025-06-19 03:30:58,FAKE,2877563177,241,2877563418,2891851891
2025-06-19 03:31:00,REAL,2877563418,480,2877563898,2891852371
2025-06-19 03:31:02,REAL,2877563898,491,2877564389,2891852862
2025-06-19 03:31:04,REAL,2877564389,492,2877564881,2891853354
2025-06-19 03:31:06,FAKE,2877564881,238,2877565119,2891853838
2025-06-19 03:31:08,REAL,2877565119,491,2877565610,2891854329
2025-06-19 03:31:10,REAL,2877565610,478,2877566088,2891854807
2025-06-19 03:31:12,REAL,2877566088,490,2877566578,2891855297
2025-06-19 03:31:14,REAL,2877566578,549,2877567127,2891855846
2025-06-19 03:31:16,REAL,2877567127,539,2877567666,2891856385
2025-06-19 03:31:18,REAL,2877567666,483,2877568149,2891856868
2025-06-19 03:31:20,REAL,2877568149,485,2877568634,2891857353
2025-06-19 03:31:22,REAL,2877568634,492,2877569126,2891857845
2025-06-19 03:31:24,FAKE,2877569126,241,2877569367,2891868434
2025-06-19 03:31:26,REAL,2877569367,10382,2877579749,2891878816
2025-06-19 03:31:28,FAKE,2877579749,243,2877579992,2891889071
2025-06-19 03:31:30,REAL,2877579992,10250,2877590242,2891899321
2025-06-19 03:31:32,REAL,2877590242,10250,2877600492,2891909571
2025-06-19 03:31:34,REAL,2877600492,10254,2877610746,2891919825
2025-06-19 03:31:36,REAL,2877610746,10317,2877621063,2891930142
2025-06-19 03:31:38,REAL,2877621063,6356,2877627419,2891936498
2025-06-19 03:31:40,REAL,2877627419,484,2877627903,2891936982
2025-06-19 03:31:42,FAKE,2877627903,238,2877628141,2891937524
2025-06-19 03:31:44,REAL,2877628141,479,2877628620,2891938003
2025-06-19 03:31:46,REAL,2877628620,483,2877629103,2891938486
2025-06-19 03:31:48,FAKE,2877629103,241,2877629344,2891938968
2025-06-19 03:31:50,REAL,2877629344,490,2877629834,2891939458
2025-06-19 03:31:52,FAKE,2877629834,243,2877630077,2891939940
2025-06-19 03:31:54,REAL,2877630077,476,2877630553,2891940416
2025-06-19 03:31:56,FAKE,2877630553,244,2877630797,2891954247
2025-06-19 03:31:58,REAL,2877630797,10250,2877641047,2891964497
2025-06-19 03:32:00,REAL,2877641047,10325,2877651372,2891974822
2025-06-19 03:32:02,REAL,2877651372,10252,2877661624,2891985074
2025-06-19 03:32:04,FAKE,2877661624,243,2877661867,2891995391
2025-06-19 03:32:06,REAL,2877661867,10254,2877672121,2892005645
2025-06-19 03:32:08,FAKE,2877672121,241,2877672362,2892015895
2025-06-19 03:32:10,REAL,2877672362,5819,2877678181,2892021714
2025-06-19 03:32:12,REAL,2877678181,484,2877678665,2892022198
2025-06-19 03:32:14,FAKE,2877678665,238,2877678903,2892022687
2025-06-19 03:32:16,REAL,2877678903,485,2877679388,2892023172
2025-06-19 03:32:18,FAKE,2877679388,241,2877679629,2892023647
2025-06-19 03:32:20,REAL,2877679629,481,2877680110,2892024128
2025-06-19 03:32:22,REAL,2877680110,488,2877680598,2892024616
2025-06-19 03:32:24,REAL,2877680598,481,2877681079,2892025097
2025-06-19 03:32:26,FAKE,2877681079,244,2877681323,2892025588
2025-06-19 03:32:28,FAKE,2877681323,244,2877681567,2892037773
2025-06-19 03:32:30,REAL,2877681567,10251,2877691818,2892048024
2025-06-19 03:32:32,REAL,2877691818,10312,2877702130,2892058336
2025-06-19 03:32:34,REAL,2877702130,10253,2877712383,2892068589
2025-06-19 03:32:36,FAKE,2877712383,241,2877712624,2892078840
2025-06-19 03:32:38,REAL,2877712624,10320,2877722944,2892089160
2025-06-19 03:32:40,REAL,2877722944,10311,2877733255,2892099471
2025-06-19 03:32:42,REAL,2877733255,5102,2877738357,2892104573
2025-06-19 03:32:44,FAKE,2877738357,244,2877738601,2892105059
2025-06-19 03:32:46,REAL,2877738601,482,2877739083,2892105541
2025-06-19 03:32:48,REAL,2877739083,481,2877739564,2892106022
2025-06-19 03:32:50,REAL,2877739564,480,2877740044,2892106502
2025-06-19 03:32:52,REAL,2877740044,477,2877740521,2892106979
2025-06-19 03:32:54,FAKE,2877740521,244,2877740765,2892107462
2025-06-19 03:32:56,FAKE,2877740765,243,2877741008,2892107946
2025-06-19 03:32:58,REAL,2877741008,1345,2877742353,2892109291
2025-06-19 03:33:00,REAL,2877742353,12570,2877754923,2892121861
2025-06-19 03:33:02,REAL,2877754923,10251,2877765174,2892132112
2025-06-19 03:33:04,REAL,2877765174,10315,2877775489,2892142427
2025-06-19 03:33:06,REAL,2877775489,10253,2877785742,2892152680
2025-06-19 03:33:08,REAL,2877785742,10301,2877796043,2892162981
2025-06-19 03:33:10,REAL,2877796043,10319,2877806362,2892173300
2025-06-19 03:33:12,FAKE,2877806362,238,2877806600,2892183561
2025-06-19 03:33:14,FAKE,2877806600,241,2877806841,2892188011
2025-06-19 03:33:16,REAL,2877806841,489,2877807330,2892188500
2025-06-19 03:33:18,REAL,2877807330,488,2877807818,2892188988
2025-06-19 03:33:20,FAKE,2877807818,241,2877808059,2892189477
2025-06-19 03:33:22,FAKE,2877808059,243,2877808302,2892189967
2025-06-19 03:33:24,REAL,2877808302,483,2877808785,2892190450
2025-06-19 03:33:26,REAL,2877808785,483,2877809268,2892190933
2025-06-19 03:33:28,REAL,2877809268,485,2877809753,2892191418
2025-06-19 03:33:30,REAL,2877809753,2213,2877811966,2892193631
2025-06-19 03:33:32,REAL,2877811966,11370,2877823336,2892205001
2025-06-19 03:33:34,FAKE,2877823336,241,2877823577,2892215314
2025-06-19 03:33:36,REAL,2877823577,10300,2877833877,2892225614
2025-06-19 03:33:38,FAKE,2877833877,243,2877834120,2892235863
2025-06-19 03:33:40,REAL,2877834120,10311,2877844431,2892246174
2025-06-19 03:33:42,REAL,2877844431,10246,2877854677,2892256420
2025-06-19 03:33:44,REAL,2877854677,10319,2877864996,2892266739
2025-06-19 03:33:46,FAKE,2877864996,243,2877865239,2892270521
2025-06-19 03:33:48,REAL,2877865239,487,2877865726,2892271008
2025-06-19 03:33:50,REAL,2877865726,485,2877866211,2892271493
2025-06-19 03:33:52,FAKE,2877866211,243,2877866454,2892271976
2025-06-19 03:33:54,REAL,2877866454,483,2877866937,2892272459
2025-06-19 03:33:56,REAL,2877866937,485,2877867422,2892272944
2025-06-19 03:33:58,FAKE,2877867422,244,2877867666,2892273424
2025-06-19 03:34:00,FAKE,2877867666,241,2877867907,2892273907
2025-06-19 03:34:02,FAKE,2877867907,241,2877868148,2892274392
2025-06-19 03:34:04,REAL,2877868148,540,2877868688,2892274932
2025-06-19 03:34:06,REAL,2877868688,544,2877869232,2892275476
2025-06-19 03:34:08,REAL,2877869232,486,2877869718,2892275962
2025-06-19 03:34:10,FAKE,2877869718,238,2877869956,2892276454
2025-06-19 03:34:12,REAL,2877869956,489,2877870445,2892276943
2025-06-19 03:34:14,REAL,2877870445,482,2877870927,2892277425
2025-06-19 03:34:16,FAKE,2877870927,243,2877871170,2892277907
2025-06-19 03:34:18,REAL,2877871170,490,2877871660,2892278397
2025-06-19 03:34:20,REAL,2877871660,3527,2877875187,2892281924
2025-06-19 03:34:22,FAKE,2877875187,241,2877875428,2892293096
2025-06-19 03:34:24,REAL,2877875428,10254,2877885682,2892303350
2025-06-19 03:34:26,FAKE,2877885682,244,2877885926,2892313667
2025-06-19 03:34:28,FAKE,2877885926,238,2877886164,2892323921
2025-06-19 03:34:30,REAL,2877886164,10321,2877896485,2892334242
2025-06-19 03:34:32,REAL,2877896485,10184,2877906669,2892344426
2025-06-19 03:34:34,REAL,2877906669,10301,2877916970,2892354727
2025-06-19 03:34:36,REAL,2877916970,2993,2877919963,2892357720
2025-06-19 03:34:38,REAL,2877919963,479,2877920442,2892358199
2025-06-19 03:34:40,REAL,2877920442,481,2877920923,2892358680
2025-06-19 03:34:42,REAL,2877920923,484,2877921407,2892359164
2025-06-19 03:34:44,REAL,2877921407,484,2877921891,2892359648
2025-06-19 03:34:46,FAKE,2877921891,241,2877922132,2892360130
2025-06-19 03:34:48,REAL,2877922132,476,2877922608,2892360606
2025-06-19 03:34:50,FAKE,2877922608,243,2877922851,2892361086
2025-06-19 03:34:52,REAL,2877922851,486,2877923337,2892361572
2025-06-19 03:34:54,FAKE,2877923337,238,2877923575,2892362109
2025-06-19 03:34:56,REAL,2877923575,486,2877924061,2892362595
2025-06-19 03:34:58,FAKE,2877924061,243,2877924304,2892363085
2025-06-19 03:35:00,REAL,2877924304,487,2877924791,2892363572
2025-06-19 03:35:02,FAKE,2877924791,243,2877925034,2892367422
2025-06-19 03:35:04,FAKE,2877925034,243,2877925277,2892381450
2025-06-19 03:35:06,REAL,2877925277,10319,2877935596,2892391769
2025-06-19 03:35:08,REAL,2877935596,10315,2877945911,2892402084
2025-06-19 03:35:10,REAL,2877945911,10251,2877956162,2892412335
2025-06-19 03:35:12,REAL,2877956162,10324,2877966486,2892422659
2025-06-19 03:35:14,FAKE,2877966486,244,2877966730,2892432911
2025-06-19 03:35:16,REAL,2877966730,10313,2877977043,2892443224
2025-06-19 03:35:18,REAL,2877977043,2391,2877979434,2892445615
2025-06-19 03:35:20,REAL,2877979434,478,2877979912,2892446093
2025-06-19 03:35:22,REAL,2877979912,485,2877980397,2892446578
2025-06-19 03:35:24,FAKE,2877980397,241,2877980638,2892447061
2025-06-19 03:35:26,FAKE,2877980638,241,2877980879,2892447540
2025-06-19 03:35:28,REAL,2877980879,487,2877981366,2892448027
2025-06-19 03:35:30,REAL,2877981366,479,2877981845,2892448506
2025-06-19 03:35:32,FAKE,2877981845,243,2877982088,2892449045
2025-06-19 03:35:34,REAL,2877982088,4579,2877986667,2892453624
2025-06-19 03:35:36,REAL,2877986667,11239,2877997906,2892464863
2025-06-19 03:35:38,REAL,2877997906,10254,2878008160,2892475117
2025-06-19 03:35:40,REAL,2878008160,10316,2878018476,2892485433
2025-06-19 03:35:42,REAL,2878018476,10251,2878028727,2892495684
2025-06-19 03:35:44,REAL,2878028727,10249,2878038976,2892505933
2025-06-19 03:35:46,REAL,2878038976,10250,2878049226,2892516183
2025-06-19 03:35:48,REAL,2878049226,10328,2878059554,2892526511
2025-06-19 03:35:50,REAL,2878059554,1800,2878061354,2892528311
2025-06-19 03:35:52,FAKE,2878061354,244,2878061598,2892528789
2025-06-19 03:35:54,REAL,2878061598,476,2878062074,2892529265
2025-06-19 03:35:56,FAKE,2878062074,241,2878062315,2892529747
2025-06-19 03:35:58,REAL,2878062315,474,2878062789,2892530221
2025-06-19 03:36:00,FAKE,2878062789,243,2878063032,2892530759
2025-06-19 03:36:02,REAL,2878063032,488,2878063520,2892531247
2025-06-19 03:36:04,REAL,2878063520,478,2878063998,2892531725
2025-06-19 03:36:06,REAL,2878063998,6306,2878070304,2892538031
2025-06-19 03:36:08,REAL,2878070304,13219,2878083523,2892551250
2025-06-19 03:36:10,REAL,2878083523,10316,2878093839,2892561566
2025-06-19 03:36:12,REAL,2878093839,10256,2878104095,2892571822
2025-06-19 03:36:14,REAL,2878104095,10321,2878114416,2892582143
2025-06-19 03:36:16,REAL,2878114416,10320,2878124736,2892592463
2025-06-19 03:36:18,REAL,2878124736,10261,2878134997,2892602724
2025-06-19 03:36:20,REAL,2878134997,10316,2878145313,2892613040
2025-06-19 03:36:22,FAKE,2878145313,238,2878145551,2892614251
2025-06-19 03:36:24,REAL,2878145551,487,2878146038,2892614738
2025-06-19 03:36:26,FAKE,2878146038,243,2878146281,2892615230
2025-06-19 03:36:28,REAL,2878146281,550,2878146831,2892615780
2025-06-19 03:36:30,FAKE,2878146831,241,2878147072,2892616268
2025-06-19 03:36:32,REAL,2878147072,477,2878147549,2892616745
2025-06-19 03:36:34,FAKE,2878147549,241,2878147790,2892617221
2025-06-19 03:36:36,REAL,2878147790,476,2878148266,2892617697
2025-06-19 03:36:38,REAL,2878148266,6306,2878154572,2892624003
2025-06-19 03:36:40,REAL,2878154572,10909,2878165481,2892634912
2025-06-19 03:36:42,REAL,2878165481,10322,2878175803,2892645234
2025-06-19 03:36:44,REAL,2878175803,10253,2878186056,2892655487
2025-06-19 03:36:46,REAL,2878186056,10319,2878196375,2892665806
2025-06-19 03:36:48,REAL,2878196375,10257,2878206632,2892676063
2025-06-19 03:36:50,FAKE,2878206632,243,2878206875,2892686379
2025-06-19 03:36:52,REAL,2878206875,10252,2878217127,2892696631
2025-06-19 03:36:54,REAL,2878217127,552,2878217679,2892697183
2025-06-19 03:36:56,FAKE,2878217679,241,2878217920,2892697669
2025-06-19 03:36:58,REAL,2878217920,482,2878218402,2892698151
2025-06-19 03:37:00,FAKE,2878218402,244,2878218646,2892698632
2025-06-19 03:37:02,FAKE,2878218646,238,2878218884,2892699181
2025-06-19 03:37:04,REAL,2878218884,478,2878219362,2892699659
2025-06-19 03:37:06,FAKE,2878219362,243,2878219605,2892700147
2025-06-19 03:37:08,REAL,2878219605,486,2878220091,2892700633
2025-06-19 03:37:10,REAL,2878220091,7944,2878228035,2892708577
2025-06-19 03:37:12,FAKE,2878228035,238,2878228273,2892721340
2025-06-19 03:37:14,FAKE,2878228273,244,2878228517,2892731663
2025-06-19 03:37:16,REAL,2878228517,10312,2878238829,2892741975
2025-06-19 03:37:18,FAKE,2878238829,241,2878239070,2892752293
2025-06-19 03:37:20,REAL,2878239070,10246,2878249316,2892762539
2025-06-19 03:37:22,FAKE,2878249316,238,2878249554,2892772858
2025-06-19 03:37:24,REAL,2878249554,9725,2878259279,2892782583
2025-06-19 03:37:26,REAL,2878259279,494,2878259773,2892783077
2025-06-19 03:37:28,REAL,2878259773,482,2878260255,2892783559
2025-06-19 03:37:30,REAL,2878260255,1486,2878261741,2892785045
2025-06-19 03:37:32,FAKE,2878261741,241,2878261982,2892796880
2025-06-19 03:37:34,REAL,2878261982,10247,2878272229,2892807127
2025-06-19 03:37:36,REAL,2878272229,10252,2878282481,2892817379
2025-06-19 03:37:38,FAKE,2878282481,238,2878282719,2892827696
2025-06-19 03:37:40,FAKE,2878282719,241,2878282960,2892837951
2025-06-19 03:37:42,REAL,2878282960,10251,2878293211,2892848202
2025-06-19 03:37:44,REAL,2878293211,10318,2878303529,2892858520
2025-06-19 03:37:46,REAL,2878303529,4441,2878307970,2892862961
2025-06-19 03:37:48,REAL,2878307970,478,2878308448,2892863439
2025-06-19 03:37:50,FAKE,2878308448,243,2878308691,2892863926
2025-06-19 03:37:52,REAL,2878308691,486,2878309177,2892864412
2025-06-19 03:37:54,FAKE,2878309177,243,2878309420,2892864949
2025-06-19 03:37:56,REAL,2878309420,491,2878309911,2892865440
2025-06-19 03:37:58,FAKE,2878309911,243,2878310154,2892865923
2025-06-19 03:38:00,REAL,2878310154,490,2878310644,2892866413
2025-06-19 03:38:02,REAL,2878310644,2530,2878313174,2892868943
2025-06-19 03:38:04,FAKE,2878313174,243,2878313417,2892880907
2025-06-19 03:38:06,REAL,2878313417,10325,2878323742,2892891232
2025-06-19 03:38:08,REAL,2878323742,10262,2878334004,2892901494
2025-06-19 03:38:10,REAL,2878334004,10317,2878344321,2892911811
2025-06-19 03:38:12,REAL,2878344321,10245,2878354566,2892922056
2025-06-19 03:38:14,FAKE,2878354566,243,2878354809,2892932312
2025-06-19 03:38:16,REAL,2878354809,10317,2878365126,2892942629
2025-06-19 03:38:18,REAL,2878365126,3853,2878368979,2892946482
2025-06-19 03:38:20,FAKE,2878368979,241,2878369220,2892946967
2025-06-19 03:38:22,REAL,2878369220,487,2878369707,2892947454
2025-06-19 03:38:24,REAL,2878369707,490,2878370197,2892947944
2025-06-19 03:38:26,REAL,2878370197,538,2878370735,2892948482
2025-06-19 03:38:28,REAL,2878370735,478,2878371213,2892948960
2025-06-19 03:38:30,FAKE,2878371213,244,2878371457,2892949445
2025-06-19 03:38:32,FAKE,2878371457,238,2878371695,2892949930
2025-06-19 03:38:34,FAKE,2878371695,244,2878371939,2892953059
2025-06-19 03:38:36,FAKE,2878371939,241,2878372180,2892965620
2025-06-19 03:38:38,FAKE,2878372180,244,2878372424,2892975867
2025-06-19 03:38:40,REAL,2878372424,10249,2878382673,2892986116
2025-06-19 03:38:42,FAKE,2878382673,241,2878382914,2892996435
2025-06-19 03:38:44,REAL,2878382914,10258,2878393172,2893006693
2025-06-19 03:38:46,REAL,2878393172,10245,2878403417,2893016938
2025-06-19 03:38:48,REAL,2878403417,10249,2878413666,2893027187
2025-06-19 03:38:50,REAL,2878413666,3247,2878416913,2893030434
2025-06-19 03:38:52,REAL,2878416913,482,2878417395,2893030916
2025-06-19 03:38:54,REAL,2878417395,487,2878417882,2893031403
2025-06-19 03:38:56,FAKE,2878417882,244,2878418126,2893031888
2025-06-19 03:38:58,REAL,2878418126,542,2878418668,2893032430
2025-06-19 03:39:00,FAKE,2878418668,243,2878418911,2893032920
2025-06-19 03:39:02,REAL,2878418911,483,2878419394,2893033403
2025-06-19 03:39:04,FAKE,2878419394,243,2878419637,2893033886
2025-06-19 03:39:06,REAL,2878419637,489,2878420126,2893034375
2025-06-19 03:39:08,REAL,2878420126,489,2878420615,2893034864
2025-06-19 03:39:10,REAL,2878420615,485,2878421100,2893035349
2025-06-19 03:39:12,FAKE,2878421100,241,2878421341,2893035825
2025-06-19 03:39:14,REAL,2878421341,482,2878421823,2893036307
2025-06-19 03:39:16,REAL,2878421823,476,2878422299,2893036783
2025-06-19 03:39:18,REAL,2878422299,487,2878422786,2893037270
2025-06-19 03:39:20,FAKE,2878422786,244,2878423030,2893037755
2025-06-19 03:39:22,REAL,2878423030,536,2878423566,2893038291
2025-06-19 03:39:24,FAKE,2878423566,238,2878423804,2893038775
2025-06-19 03:39:26,REAL,2878423804,483,2878424287,2893039258
2025-06-19 03:39:28,REAL,2878424287,478,2878424765,2893039736
2025-06-19 03:39:30,REAL,2878424765,487,2878425252,2893040223
2025-06-19 03:39:32,REAL,2878425252,487,2878425739,2893040710
2025-06-19 03:39:34,FAKE,2878425739,243,2878425982,2893041190
2025-06-19 03:39:36,FAKE,2878425982,241,2878426223,2893041727
2025-06-19 03:39:38,REAL,2878426223,4250,2878430473,2893045977
2025-06-19 03:39:40,REAL,2878430473,11568,2878442041,2893057545
2025-06-19 03:39:42,FAKE,2878442041,241,2878442282,2893067796
2025-06-19 03:39:44,FAKE,2878442282,243,2878442525,2893078115
2025-06-19 03:39:46,REAL,2878442525,10247,2878452772,2893088362
2025-06-19 03:39:48,REAL,2878452772,10249,2878463021,2893098611
2025-06-19 03:39:50,REAL,2878463021,10247,2878473268,2893108858
2025-06-19 03:39:52,REAL,2878473268,10247,2878483515,2893119105
2025-06-19 03:39:54,REAL,2878483515,2002,2878485517,2893121107
2025-06-19 03:39:56,REAL,2878485517,489,2878486006,2893121596
2025-06-19 03:39:58,REAL,2878486006,483,2878486489,2893122079
2025-06-19 03:40:00,REAL,2878486489,476,2878486965,2893122555
2025-06-19 03:40:02,REAL,2878486965,540,2878487505,2893123095
2025-06-19 03:40:04,REAL,2878487505,486,2878487991,2893123581
2025-06-19 03:40:06,REAL,2878487991,483,2878488474,2893124064
2025-06-19 03:40:08,FAKE,2878488474,238,2878488712,2893124548
2025-06-19 03:40:10,FAKE,2878488712,241,2878488953,2893125037
2025-06-19 03:40:12,REAL,2878488953,483,2878489436,2893125520
2025-06-19 03:40:14,REAL,2878489436,482,2878489918,2893126002
2025-06-19 03:40:16,REAL,2878489918,483,2878490401,2893126485
2025-06-19 03:40:18,FAKE,2878490401,238,2878490639,2893126978
2025-06-19 03:40:20,REAL,2878490639,5177,2878495816,2893132155
2025-06-19 03:40:22,FAKE,2878495816,244,2878496060,2893143389
2025-06-19 03:40:24,REAL,2878496060,10253,2878506313,2893153642
2025-06-19 03:40:26,REAL,2878506313,10310,2878516623,2893163952
2025-06-19 03:40:28,REAL,2878516623,10259,2878526882,2893174211
2025-06-19 03:40:30,REAL,2878526882,10313,2878537195,2893184524
2025-06-19 03:40:32,REAL,2878537195,10245,2878547440,2893194769
2025-06-19 03:40:34,REAL,2878547440,10248,2878557688,2893205017
2025-06-19 03:40:36,FAKE,2878557688,244,2878557932,2893206423
2025-06-19 03:40:38,REAL,2878557932,482,2878558414,2893206905
2025-06-19 03:40:40,REAL,2878558414,480,2878558894,2893207385
2025-06-19 03:40:42,REAL,2878558894,481,2878559375,2893207866
2025-06-19 03:40:44,REAL,2878559375,484,2878559859,2893208350
2025-06-19 03:40:46,FAKE,2878559859,241,2878560100,2893208826
2025-06-19 03:40:48,REAL,2878560100,484,2878560584,2893209310
2025-06-19 03:40:50,FAKE,2878560584,243,2878560827,2893209854
2025-06-19 03:40:52,FAKE,2878560827,238,2878561065,2893210339
2025-06-19 03:40:54,REAL,2878561065,484,2878561549,2893210823
2025-06-19 03:40:56,REAL,2878561549,490,2878562039,2893211313
2025-06-19 03:40:58,FAKE,2878562039,238,2878562277,2893211793
2025-06-19 03:41:00,FAKE,2878562277,243,2878562520,2893212283
2025-06-19 03:41:02,REAL,2878562520,479,2878562999,2893212762
2025-06-19 03:41:04,REAL,2878562999,481,2878563480,2893213243
2025-06-19 03:41:06,FAKE,2878563480,244,2878563724,2893213779
2025-06-19 03:41:08,REAL,2878563724,481,2878564205,2893214260
2025-06-19 03:41:10,FAKE,2878564205,244,2878564449,2893214743
2025-06-19 03:41:12,REAL,2878564449,490,2878564939,2893215233
2025-06-19 03:41:14,REAL,2878564939,535,2878565474,2893215768
2025-06-19 03:41:16,FAKE,2878565474,238,2878565712,2893216259
2025-06-19 03:41:18,REAL,2878565712,482,2878566194,2893216741
2025-06-19 03:41:20,FAKE,2878566194,238,2878566432,2893217222
2025-06-19 03:41:22,REAL,2878566432,475,2878566907,2893217697
2025-06-19 03:41:24,REAL,2878566907,6370,2878573277,2893224067
2025-06-19 03:41:26,REAL,2878573277,11041,2878584318,2893235108
2025-06-19 03:41:28,REAL,2878584318,10254,2878594572,2893245362
2025-06-19 03:41:30,REAL,2878594572,10320,2878604892,2893255682
2025-06-19 03:41:32,REAL,2878604892,10250,2878615142,2893265932
2025-06-19 03:41:34,REAL,2878615142,10259,2878625401,2893276191
2025-06-19 03:41:36,REAL,2878625401,10250,2878635651,2893286441
2025-06-19 03:41:38,REAL,2878635651,9989,2878645640,2893296430
2025-06-19 03:41:40,REAL,2878645640,477,2878646117,2893296907
2025-06-19 03:41:42,FAKE,2878646117,244,2878646361,2893297389
2025-06-19 03:41:44,REAL,2878646361,484,2878646845,2893297873
2025-06-19 03:41:46,FAKE,2878646845,238,2878647083,2893298361
2025-06-19 03:41:48,REAL,2878647083,532,2878647615,2893298893
2025-06-19 03:41:50,FAKE,2878647615,241,2878647856,2893299380
2025-06-19 03:41:52,REAL,2878647856,541,2878648397,2893299921
2025-06-19 03:41:54,REAL,2878648397,480,2878648877,2893300401
2025-06-19 03:41:56,REAL,2878648877,489,2878649366,2893300890
2025-06-19 03:41:58,FAKE,2878649366,243,2878649609,2893301375
2025-06-19 03:42:00,REAL,2878649609,485,2878650094,2893301860
2025-06-19 03:42:02,REAL,2878650094,484,2878650578,2893302344
2025-06-19 03:42:04,REAL,2878650578,483,2878651061,2893302827
2025-06-19 03:42:06,REAL,2878651061,485,2878651546,2893303312
2025-06-19 03:42:08,REAL,2878651546,484,2878652030,2893303796
2025-06-19 03:42:10,FAKE,2878652030,244,2878652274,2893304281
2025-06-19 03:42:12,FAKE,2878652274,238,2878652512,2893304768
2025-06-19 03:42:14,REAL,2878652512,544,2878653056,2893305312
2025-06-19 03:42:16,FAKE,2878653056,241,2878653297,2893307328
2025-06-19 03:42:18,FAKE,2878653297,243,2878653540,2893318701
2025-06-19 03:42:20,REAL,2878653540,10302,2878663842,2893329003
2025-06-19 03:42:22,REAL,2878663842,10314,2878674156,2893339317
2025-06-19 03:42:24,REAL,2878674156,10247,2878684403,2893349564
2025-06-19 03:42:26,REAL,2878684403,10258,2878694661,2893359822
2025-06-19 03:42:28,REAL,2878694661,10321,2878704982,2893370143
2025-06-19 03:42:30,REAL,2878704982,10251,2878715233,2893380394
2025-06-19 03:42:32,REAL,2878715233,4107,2878719340,2893384501
2025-06-19 03:42:34,REAL,2878719340,483,2878719823,2893384984
2025-06-19 03:42:36,REAL,2878719823,479,2878720302,2893385463
2025-06-19 03:42:38,FAKE,2878720302,238,2878720540,2893393148
2025-06-19 03:42:40,FAKE,2878720540,238,2878720778,2893403994
2025-06-19 03:42:42,REAL,2878720778,10247,2878731025,2893414241
2025-06-19 03:42:44,REAL,2878731025,10321,2878741346,2893424562
2025-06-19 03:42:46,FAKE,2878741346,241,2878741587,2893434818
2025-06-19 03:42:48,FAKE,2878741587,244,2878741831,2893445126
2025-06-19 03:42:50,FAKE,2878741831,244,2878742075,2893455384
2025-06-19 03:42:52,REAL,2878742075,8667,2878750742,2893464051
2025-06-19 03:42:54,REAL,2878750742,489,2878751231,2893464540
2025-06-19 03:42:56,FAKE,2878751231,243,2878751474,2893465025
2025-06-19 03:42:58,REAL,2878751474,488,2878751962,2893465513
2025-06-19 03:43:00,REAL,2878751962,481,2878752443,2893465994
2025-06-19 03:43:02,FAKE,2878752443,244,2878752687,2893466527
2025-06-19 03:43:04,REAL,2878752687,491,2878753178,2893467018
2025-06-19 03:43:06,REAL,2878753178,492,2878753670,2893467510
2025-06-19 03:43:08,FAKE,2878753670,243,2878753913,2893467992
2025-06-19 03:43:10,FAKE,2878753913,241,2878754154,2893468483
2025-06-19 03:43:12,FAKE,2878754154,243,2878754397,2893468971
2025-06-19 03:43:14,FAKE,2878754397,243,2878754640,2893469459
2025-06-19 03:43:16,REAL,2878754640,481,2878755121,2893469940
2025-06-19 03:43:18,FAKE,2878755121,244,2878755365,2893470480
2025-06-19 03:43:20,REAL,2878755365,8756,2878764121,2893479236
2025-06-19 03:43:22,FAKE,2878764121,241,2878764362,2893490075
2025-06-19 03:43:24,FAKE,2878764362,244,2878764606,2893500324
2025-06-19 03:43:26,FAKE,2878764606,243,2878764849,2893510581
2025-06-19 03:43:28,REAL,2878764849,10252,2878775101,2893520833
2025-06-19 03:43:30,FAKE,2878775101,238,2878775339,2893531151
2025-06-19 03:43:32,REAL,2878775339,10257,2878785596,2893541408
2025-06-19 03:43:34,REAL,2878785596,8012,2878793608,2893549420
2025-06-19 03:43:36,FAKE,2878793608,241,2878793849,2893549913
2025-06-19 03:43:38,REAL,2878793849,485,2878794334,2893550398
2025-06-19 03:43:40,FAKE,2878794334,241,2878794575,2893550872
2025-06-19 03:43:42,FAKE,2878794575,244,2878794819,2893551358
2025-06-19 03:43:44,FAKE,2878794819,244,2878795063,2893551850
2025-06-19 03:43:46,FAKE,2878795063,238,2878795301,2893552448
2025-06-19 03:43:48,REAL,2878795301,483,2878795784,2893552931
2025-06-19 03:43:50,REAL,2878795784,487,2878796271,2893553418
2025-06-19 03:43:52,REAL,2878796271,484,2878796755,2893553902
2025-06-19 03:43:54,REAL,2878796755,483,2878797238,2893554385
2025-06-19 03:43:56,REAL,2878797238,475,2878797713,2893554860
2025-06-19 03:43:58,FAKE,2878797713,243,2878797956,2893555344
2025-06-19 03:44:00,REAL,2878797956,492,2878798448,2893555836
2025-06-19 03:44:02,FAKE,2878798448,244,2878798692,2893556318
2025-06-19 03:44:04,REAL,2878798692,476,2878799168,2893556794
2025-06-19 03:44:06,REAL,2878799168,488,2878799656,2893557282
2025-06-19 03:44:08,REAL,2878799656,487,2878800143,2893557769
2025-06-19 03:44:10,REAL,2878800143,540,2878800683,2893558309
2025-06-19 03:44:12,REAL,2878800683,491,2878801174,2893558800
2025-06-19 03:44:14,REAL,2878801174,534,2878801708,2893559334
2025-06-19 03:44:16,REAL,2878801708,483,2878802191,2893559817
2025-06-19 03:44:18,REAL,2878802191,484,2878802675,2893560301
2025-06-19 03:44:20,REAL,2878802675,479,2878803154,2893560780
2025-06-19 03:44:22,REAL,2878803154,476,2878803630,2893561256
2025-06-19 03:44:24,REAL,2878803630,479,2878804109,2893561735
2025-06-19 03:44:26,REAL,2878804109,484,2878804593,2893562219
2025-06-19 03:44:28,REAL,2878804593,483,2878805076,2893562702
2025-06-19 03:44:30,FAKE,2878805076,241,2878805317,2893563182
2025-06-19 03:44:32,FAKE,2878805317,241,2878805558,2893563664
2025-06-19 03:44:34,REAL,2878805558,11974,2878817532,2893575638
2025-06-19 03:44:36,REAL,2878817532,10844,2878828376,2893586482
2025-06-19 03:44:38,REAL,2878828376,10318,2878838694,2893596800
2025-06-19 03:44:40,REAL,2878838694,10249,2878848943,2893607049
2025-06-19 03:44:42,REAL,2878848943,10255,2878859198,2893617304
2025-06-19 03:44:44,REAL,2878859198,10300,2878869498,2893627604
2025-06-19 03:44:46,REAL,2878869498,10322,2878879820,2893637926
2025-06-19 03:44:48,FAKE,2878879820,241,2878880061,2893644813
2025-06-19 03:44:50,REAL,2878880061,483,2878880544,2893645296
2025-06-19 03:44:52,REAL,2878880544,487,2878881031,2893645783
2025-06-19 03:44:54,FAKE,2878881031,238,2878881269,2893646267
2025-06-19 03:44:56,FAKE,2878881269,244,2878881513,2893646747
2025-06-19 03:44:58,REAL,2878881513,482,2878881995,2893647229
2025-06-19 03:45:00,REAL,2878881995,535,2878882530,2893647764
2025-06-19 03:45:02,REAL,2878882530,484,2878883014,2893648248
2025-06-19 03:45:04,FAKE,2878883014,238,2878883252,2893648740
2025-06-19 03:45:06,REAL,2878883252,484,2878883736,2893649224
2025-06-19 03:45:08,REAL,2878883736,490,2878884226,2893649714
2025-06-19 03:45:10,FAKE,2878884226,243,2878884469,2893650196
2025-06-19 03:45:12,FAKE,2878884469,244,2878884713,2893650683
2025-06-19 03:45:14,REAL,2878884713,543,2878885256,2893651226
2025-06-19 03:45:16,REAL,2878885256,486,2878885742,2893651712
2025-06-19 03:45:18,REAL,2878885742,486,2878886228,2893652198
2025-06-19 03:45:20,FAKE,2878886228,238,2878886466,2893652681
2025-06-19 03:45:22,REAL,2878886466,484,2878886950,2893653165
2025-06-19 03:45:24,REAL,2878886950,550,2878887500,2893653715
2025-06-19 03:45:26,REAL,2878887500,481,2878887981,2893654196
2025-06-19 03:45:28,FAKE,2878887981,238,2878888219,2893654678
2025-06-19 03:45:30,FAKE,2878888219,243,2878888462,2893655159
2025-06-19 03:45:32,FAKE,2878888462,241,2878888703,2893669128
2025-06-19 03:45:34,REAL,2878888703,10313,2878899016,2893679441
2025-06-19 03:45:36,REAL,2878899016,10249,2878909265,2893689690
2025-06-19 03:45:38,FAKE,2878909265,238,2878909503,2893699938
2025-06-19 03:45:40,REAL,2878909503,10319,2878919822,2893710257
2025-06-19 03:45:42,FAKE,2878919822,244,2878920066,2893720565
2025-06-19 03:45:44,REAL,2878920066,10244,2878930310,2893730809
2025-06-19 03:45:46,REAL,2878930310,5893,2878936203,2893736702
2025-06-19 03:45:48,REAL,2878936203,485,2878936688,2893737187
2025-06-19 03:45:50,REAL,2878936688,486,2878937174,2893737673
2025-06-19 03:45:52,REAL,2878937174,483,2878937657,2893738156
2025-06-19 03:45:54,REAL,2878937657,484,2878938141,2893738640
2025-06-19 03:45:56,FAKE,2878938141,241,2878938382,2893739178
2025-06-19 03:45:58,FAKE,2878938382,244,2878938626,2893739664
2025-06-19 03:46:00,REAL,2878938626,483,2878939109,2893740147
2025-06-19 03:46:02,REAL,2878939109,490,2878939599,2893740637
2025-06-19 03:46:04,REAL,2878939599,493,2878940092,2893741130
2025-06-19 03:46:06,REAL,2878940092,487,2878940579,2893741617
2025-06-19 03:46:08,REAL,2878940579,477,2878941056,2893742094
2025-06-19 03:46:10,REAL,2878941056,541,2878941597,2893742635
2025-06-19 03:46:12,FAKE,2878941597,241,2878941838,2893743121
2025-06-19 03:46:14,REAL,2878941838,480,2878942318,2893743601
2025-06-19 03:46:16,FAKE,2878942318,243,2878942561,2893744088
2025-06-19 03:46:18,REAL,2878942561,484,2878943045,2893744572
2025-06-19 03:46:20,FAKE,2878943045,243,2878943288,2893745053
2025-06-19 03:46:22,FAKE,2878943288,238,2878943526,2893745347
2025-06-19 03:46:24,FAKE,2878943526,241,2878943767,2893745824
2025-06-19 03:46:26,REAL,2878943767,489,2878944256,2893746313
2025-06-19 03:46:28,REAL,2878944256,484,2878944740,2893746797
2025-06-19 03:46:30,REAL,2878944740,489,2878945229,2893747286
2025-06-19 03:46:32,FAKE,2878945229,241,2878945470,2893747778
2025-06-19 03:46:34,REAL,2878945470,482,2878945952,2893748260
2025-06-19 03:46:36,FAKE,2878945952,244,2878946196,2893748743
2025-06-19 03:46:38,FAKE,2878946196,238,2878946434,2893749220
2025-06-19 03:46:40,FAKE,2878946434,244,2878946678,2893749708
2025-06-19 03:46:42,FAKE,2878946678,243,2878946921,2893750193
2025-06-19 03:46:44,REAL,2878946921,481,2878947402,2893750674
2025-06-19 03:46:46,REAL,2878947402,486,2878947888,2893751160
2025-06-19 03:46:48,REAL,2878947888,483,2878948371,2893751643
2025-06-19 03:46:50,FAKE,2878948371,243,2878948614,2893760718
2025-06-19 03:46:52,REAL,2878948614,10716,2878959330,2893771434
2025-06-19 03:46:54,REAL,2878959330,10248,2878969578,2893781682
2025-06-19 03:46:56,FAKE,2878969578,243,2878969821,2893791999
2025-06-19 03:46:58,REAL,2878969821,10249,2878980070,2893802248
2025-06-19 03:47:00,FAKE,2878980070,243,2878980313,2893812503
2025-06-19 03:47:02,FAKE,2878980313,243,2878980556,2893822868
2025-06-19 03:47:04,FAKE,2878980556,243,2878980799,2893832389
2025-06-19 03:47:06,REAL,2878980799,480,2878981279,2893832869
2025-06-19 03:47:08,REAL,2878981279,487,2878981766,2893833356
2025-06-19 03:47:10,REAL,2878981766,483,2878982249,2893833839
2025-06-19 03:47:12,REAL,2878982249,480,2878982729,2893834319
2025-06-19 03:47:14,REAL,2878982729,491,2878983220,2893834810
2025-06-19 03:47:16,REAL,2878983220,483,2878983703,2893835293
2025-06-19 03:47:18,REAL,2878983703,488,2878984191,2893835781
2025-06-19 03:47:20,FAKE,2878984191,241,2878984432,2893836329
2025-06-19 03:47:22,REAL,2878984432,483,2878984915,2893836812
2025-06-19 03:47:24,REAL,2878984915,486,2878985401,2893837298
2025-06-19 03:47:26,REAL,2878985401,478,2878985879,2893837776
2025-06-19 03:47:28,REAL,2878985879,480,2878986359,2893838256
2025-06-19 03:47:30,REAL,2878986359,487,2878986846,2893838743
2025-06-19 03:47:32,REAL,2878986846,480,2878987326,2893839223
2025-06-19 03:47:34,FAKE,2878987326,238,2878987564,2893839699
2025-06-19 03:47:36,FAKE,2878987564,241,2878987805,2893840186
2025-06-19 03:47:38,REAL,2878987805,485,2878988290,2893840671
2025-06-19 03:47:40,REAL,2878988290,488,2878988778,2893841159
2025-06-19 03:47:42,REAL,2878988778,2729,2878991507,2893843888
2025-06-19 03:47:44,REAL,2878991507,11634,2879003141,2893855522
2025-06-19 03:47:46,FAKE,2879003141,241,2879003382,2893865777
2025-06-19 03:47:48,REAL,2879003382,10374,2879013756,2893876151
2025-06-19 03:47:50,REAL,2879013756,10249,2879024005,2893886400
2025-06-19 03:47:52,REAL,2879024005,10374,2879034379,2893896774
2025-06-19 03:47:54,REAL,2879034379,10253,2879044632,2893907027
2025-06-19 03:47:56,FAKE,2879044632,238,2879044870,2893917350
2025-06-19 03:47:58,REAL,2879044870,3658,2879048528,2893921008
2025-06-19 03:48:00,FAKE,2879048528,241,2879048769,2893921493
2025-06-19 03:48:02,FAKE,2879048769,238,2879049007,2893921974
2025-06-19 03:48:04,REAL,2879049007,485,2879049492,2893922459
2025-06-19 03:48:06,REAL,2879049492,481,2879049973,2893922940
2025-06-19 03:48:08,REAL,2879049973,492,2879050465,2893923432
2025-06-19 03:48:10,FAKE,2879050465,243,2879050708,2893923911
2025-06-19 03:48:12,REAL,2879050708,490,2879051198,2893924401
2025-06-19 03:48:14,FAKE,2879051198,243,2879051441,2893927862
2025-06-19 03:48:16,REAL,2879051441,11364,2879062805,2893939226
2025-06-19 03:48:18,FAKE,2879062805,241,2879063046,2893949542
2025-06-19 03:48:20,REAL,2879063046,10259,2879073305,2893959801
2025-06-19 03:48:22,REAL,2879073305,10256,2879083561,2893970057
2025-06-19 03:48:24,REAL,2879083561,10253,2879093814,2893980310
2025-06-19 03:48:26,REAL,2879093814,10318,2879104132,2893990628
2025-06-19 03:48:28,FAKE,2879104132,243,2879104375,2894000877
2025-06-19 03:48:30,REAL,2879104375,3052,2879107427,2894003929
2025-06-19 03:48:32,FAKE,2879107427,243,2879107670,2894004413
2025-06-19 03:48:34,REAL,2879107670,488,2879108158,2894004901
2025-06-19 03:48:36,REAL,2879108158,487,2879108645,2894005388
2025-06-19 03:48:38,REAL,2879108645,484,2879109129,2894005872
2025-06-19 03:48:40,REAL,2879109129,482,2879109611,2894006354
2025-06-19 03:48:42,FAKE,2879109611,244,2879109855,2894006831
2025-06-19 03:48:44,REAL,2879109855,598,2879110453,2894007429
2025-06-19 03:48:46,FAKE,2879110453,241,2879110694,2894011151
2025-06-19 03:48:48,REAL,2879110694,11503,2879122197,2894022654
2025-06-19 03:48:50,REAL,2879122197,10316,2879132513,2894032970
2025-06-19 03:48:52,REAL,2879132513,10248,2879142761,2894043218
2025-06-19 03:48:54,FAKE,2879142761,243,2879143004,2894053531
2025-06-19 03:48:56,REAL,2879143004,10252,2879153256,2894063783
2025-06-19 03:48:58,REAL,2879153256,10314,2879163570,2894074097
2025-06-19 03:49:00,REAL,2879163570,10259,2879173829,2894084356
2025-06-19 03:49:02,REAL,2879173829,2454,2879176283,2894086810
2025-06-19 03:49:04,FAKE,2879176283,241,2879176524,2894087290
2025-06-19 03:49:06,REAL,2879176524,484,2879177008,2894087774
2025-06-19 03:49:08,REAL,2879177008,483,2879177491,2894088257
2025-06-19 03:49:10,REAL,2879177491,491,2879177982,2894088748
2025-06-19 03:49:12,REAL,2879177982,485,2879178467,2894089233
2025-06-19 03:49:14,REAL,2879178467,533,2879179000,2894089766
2025-06-19 03:49:16,REAL,2879179000,481,2879179481,2894090247
2025-06-19 03:49:18,REAL,2879179481,5252,2879184733,2894095499
2025-06-19 03:49:20,FAKE,2879184733,241,2879184974,2894109123
2025-06-19 03:49:22,REAL,2879184974,10314,2879195288,2894119437
2025-06-19 03:49:24,FAKE,2879195288,238,2879195526,2894129688
2025-06-19 03:49:26,FAKE,2879195526,244,2879195770,2894139940
2025-06-19 03:49:28,REAL,2879195770,10258,2879206028,2894150198
2025-06-19 03:49:30,REAL,2879206028,10257,2879216285,2894160455
2025-06-19 03:49:32,REAL,2879216285,10317,2879226602,2894170772
2025-06-19 03:49:34,FAKE,2879226602,241,2879226843,2894172585
2025-06-19 03:49:36,REAL,2879226843,541,2879227384,2894173126
2025-06-19 03:49:38,REAL,2879227384,484,2879227868,2894173610
2025-06-19 03:49:40,FAKE,2879227868,241,2879228109,2894174099
2025-06-19 03:49:42,REAL,2879228109,486,2879228595,2894174585
2025-06-19 03:49:44,REAL,2879228595,484,2879229079,2894175069
2025-06-19 03:49:46,REAL,2879229079,534,2879229613,2894175603
2025-06-19 03:49:48,REAL,2879229613,479,2879230092,2894176082
2025-06-19 03:49:50,REAL,2879230092,482,2879230574,2894176564
2025-06-19 03:49:52,FAKE,2879230574,244,2879230818,2894177053
2025-06-19 03:49:54,REAL,2879230818,484,2879231302,2894177537
2025-06-19 03:49:56,REAL,2879231302,477,2879231779,2894178014
2025-06-19 03:49:58,FAKE,2879231779,238,2879232017,2894178502
2025-06-19 03:50:00,FAKE,2879232017,238,2879232255,2894178984
2025-06-19 03:50:02,REAL,2879232255,481,2879232736,2894179465
2025-06-19 03:50:04,REAL,2879232736,489,2879233225,2894179954
2025-06-19 03:50:06,REAL,2879233225,484,2879233709,2894180438
2025-06-19 03:50:08,REAL,2879233709,483,2879234192,2894180921
2025-06-19 03:50:10,FAKE,2879234192,244,2879234436,2894181403
2025-06-19 03:50:12,REAL,2879234436,15337,2879249773,2894196740
2025-06-19 03:50:14,FAKE,2879249773,238,2879250011,2894206990
2025-06-19 03:50:16,REAL,2879250011,10318,2879260329,2894217308
2025-06-19 03:50:18,REAL,2879260329,10259,2879270588,2894227567
2025-06-19 03:50:20,REAL,2879270588,10258,2879280846,2894237825
2025-06-19 03:50:22,FAKE,2879280846,241,2879281087,2894248145
2025-06-19 03:50:24,REAL,2879281087,10254,2879291341,2894258399
2025-06-19 03:50:26,REAL,2879291341,5750,2879297091,2894264149
2025-06-19 03:50:28,REAL,2879297091,484,2879297575,2894264633
2025-06-19 03:50:30,REAL,2879297575,483,2879298058,2894265116
2025-06-19 03:50:32,REAL,2879298058,490,2879298548,2894265606
2025-06-19 03:50:34,FAKE,2879298548,243,2879298791,2894266091
2025-06-19 03:50:36,FAKE,2879298791,241,2879299032,2894266574
2025-06-19 03:50:38,REAL,2879299032,486,2879299518,2894267060
2025-06-19 03:50:40,REAL,2879299518,546,2879300064,2894267606
2025-06-19 03:50:42,FAKE,2879300064,238,2879300302,2894268094
2025-06-19 03:50:44,REAL,2879300302,492,2879300794,2894268586
2025-06-19 03:50:46,REAL,2879300794,485,2879301279,2894269071
2025-06-19 03:50:48,REAL,2879301279,483,2879301762,2894269554
2025-06-19 03:50:50,REAL,2879301762,485,2879302247,2894270039
2025-06-19 03:50:52,REAL,2879302247,486,2879302733,2894270525
2025-06-19 03:50:54,REAL,2879302733,483,2879303216,2894271008
2025-06-19 03:50:56,FAKE,2879303216,241,2879303457,2894271491
2025-06-19 03:50:58,FAKE,2879303457,241,2879303698,2894271965
2025-06-19 03:51:00,REAL,2879303698,482,2879304180,2894272447
2025-06-19 03:51:02,REAL,2879304180,483,2879304663,2894272930
2025-06-19 03:51:04,REAL,2879304663,481,2879305144,2894273411
2025-06-19 03:51:06,REAL,2879305144,478,2879305622,2894273889
2025-06-19 03:51:08,FAKE,2879305622,243,2879305865,2894274429
2025-06-19 03:51:10,REAL,2879305865,479,2879306344,2894274908
2025-06-19 03:51:12,FAKE,2879306344,238,2879306582,2894275396
2025-06-19 03:51:14,FAKE,2879306582,243,2879306825,2894275876
2025-06-19 03:51:16,FAKE,2879306825,238,2879307063,2894276361
2025-06-19 03:51:18,REAL,2879307063,532,2879307595,2894276893
2025-06-19 03:51:20,FAKE,2879307595,243,2879307838,2894277377
2025-06-19 03:51:22,FAKE,2879307838,244,2879308082,2894277861
2025-06-19 03:51:24,REAL,2879308082,1610,2879309692,2894279471
2025-06-19 03:51:26,FAKE,2879309692,238,2879309930,2894294477
2025-06-19 03:51:28,REAL,2879309930,10324,2879320254,2894304801
2025-06-19 03:51:30,REAL,2879320254,10255,2879330509,2894315056
2025-06-19 03:51:32,FAKE,2879330509,238,2879330747,2894325300
2025-06-19 03:51:34,FAKE,2879330747,243,2879330990,2894335618
2025-06-19 03:51:36,FAKE,2879330990,243,2879331233,2894345871
2025-06-19 03:51:38,REAL,2879331233,10319,2879341552,2894356190
2025-06-19 03:51:40,REAL,2879341552,4376,2879345928,2894360566
2025-06-19 03:51:42,REAL,2879345928,481,2879346409,2894361047
2025-06-19 03:51:44,REAL,2879346409,489,2879346898,2894361536
2025-06-19 03:51:46,REAL,2879346898,483,2879347381,2894362019
2025-06-19 03:51:48,FAKE,2879347381,244,2879347625,2894362503
2025-06-19 03:51:50,FAKE,2879347625,238,2879347863,2894362983
2025-06-19 03:51:52,REAL,2879347863,482,2879348345,2894363465
2025-06-19 03:51:54,FAKE,2879348345,241,2879348586,2894363952
2025-06-19 03:51:56,REAL,2879348586,476,2879349062,2894364428
2025-06-19 03:51:58,REAL,2879349062,483,2879349545,2894364911
2025-06-19 03:52:00,REAL,2879349545,543,2879350088,2894365454
2025-06-19 03:52:02,REAL,2879350088,483,2879350571,2894365937
2025-06-19 03:52:04,REAL,2879350571,488,2879351059,2894366425
2025-06-19 03:52:06,REAL,2879351059,476,2879351535,2894366901
2025-06-19 03:52:08,REAL,2879351535,543,2879352078,2894367444
2025-06-19 03:52:10,FAKE,2879352078,244,2879352322,2894367927
2025-06-19 03:52:12,REAL,2879352322,493,2879352815,2894368420
2025-06-19 03:52:14,REAL,2879352815,493,2879353308,2894368913
2025-06-19 03:52:16,REAL,2879353308,482,2879353790,2894369395
2025-06-19 03:52:18,REAL,2879353790,477,2879354267,2894369872
2025-06-19 03:52:20,REAL,2879354267,485,2879354752,2894370357
2025-06-19 03:52:22,REAL,2879354752,479,2879355231,2894370836
2025-06-19 03:52:24,REAL,2879355231,484,2879355715,2894371320
2025-06-19 03:52:26,REAL,2879355715,493,2879356208,2894371813
2025-06-19 03:52:28,REAL,2879356208,491,2879356699,2894372304
2025-06-19 03:52:30,REAL,2879356699,475,2879357174,2894372779
2025-06-19 03:52:32,REAL,2879357174,481,2879357655,2894373260
2025-06-19 03:52:34,REAL,2879357655,537,2879358192,2894373797
2025-06-19 03:52:36,REAL,2879358192,489,2879358681,2894374286
2025-06-19 03:52:38,REAL,2879358681,541,2879359222,2894374827
2025-06-19 03:52:40,REAL,2879359222,478,2879359700,2894375305
2025-06-19 03:52:42,FAKE,2879359700,244,2879359944,2894375788
2025-06-19 03:52:44,FAKE,2879359944,241,2879360185,2894379456
2025-06-19 03:52:46,FAKE,2879360185,238,2879360423,2894391094
2025-06-19 03:52:48,FAKE,2879360423,238,2879360661,2894401339
2025-06-19 03:52:50,REAL,2879360661,10247,2879370908,2894411586
2025-06-19 03:52:52,REAL,2879370908,10319,2879381227,2894421905
2025-06-19 03:52:54,FAKE,2879381227,243,2879381470,2894432154
2025-06-19 03:52:56,REAL,2879381470,10251,2879391721,2894442405
2025-06-19 03:52:58,REAL,2879391721,10317,2879402038,2894452722
2025-06-19 03:53:00,FAKE,2879402038,241,2879402279,2894455515
2025-06-19 03:53:02,REAL,2879402279,490,2879402769,2894456005
2025-06-19 03:53:04,FAKE,2879402769,241,2879403010,2894456491
2025-06-19 03:53:06,REAL,2879403010,547,2879403557,2894457038
2025-06-19 03:53:08,FAKE,2879403557,244,2879403801,2894457520
2025-06-19 03:53:10,FAKE,2879403801,241,2879404042,2894458006
2025-06-19 03:53:12,FAKE,2879404042,238,2879404280,2894458482
2025-06-19 03:53:14,REAL,2879404280,484,2879404764,2894458966
2025-06-19 03:53:16,REAL,2879404764,4193,2879408957,2894463159
2025-06-19 03:53:18,REAL,2879408957,11308,2879420265,2894474467
2025-06-19 03:53:20,FAKE,2879420265,238,2879420503,2894484719
2025-06-19 03:53:22,REAL,2879420503,10254,2879430757,2894494973
2025-06-19 03:53:24,REAL,2879430757,10252,2879441009,2894505225
2025-06-19 03:53:26,FAKE,2879441009,244,2879441253,2894515545
2025-06-19 03:53:28,FAKE,2879441253,241,2879441494,2894525805
2025-06-19 03:53:30,REAL,2879441494,10257,2879451751,2894536062
2025-06-19 03:53:32,REAL,2879451751,2191,2879453942,2894538253
2025-06-19 03:53:34,REAL,2879453942,539,2879454481,2894538792
2025-06-19 03:53:36,FAKE,2879454481,241,2879454722,2894539267
2025-06-19 03:53:38,REAL,2879454722,482,2879455204,2894539749
2025-06-19 03:53:40,REAL,2879455204,490,2879455694,2894540239
2025-06-19 03:53:42,REAL,2879455694,481,2879456175,2894540720
2025-06-19 03:53:44,FAKE,2879456175,238,2879456413,2894541202
2025-06-19 03:53:46,REAL,2879456413,488,2879456901,2894541690
2025-06-19 03:53:48,REAL,2879456901,490,2879457391,2894542180
2025-06-19 03:53:50,REAL,2879457391,486,2879457877,2894542666
2025-06-19 03:53:52,REAL,2879457877,541,2879458418,2894543207
2025-06-19 03:53:54,REAL,2879458418,486,2879458904,2894543693
2025-06-19 03:53:56,FAKE,2879458904,238,2879459142,2894544171
2025-06-19 03:53:58,REAL,2879459142,490,2879459632,2894544661
2025-06-19 03:54:00,REAL,2879459632,487,2879460119,2894545148
2025-06-19 03:54:02,FAKE,2879460119,243,2879460362,2894545625
2025-06-19 03:54:04,FAKE,2879460362,243,2879460605,2894546166
2025-06-19 03:54:06,REAL,2879460605,479,2879461084,2894546645
2025-06-19 03:54:08,REAL,2879461084,480,2879461564,2894547125
2025-06-19 03:54:10,REAL,2879461564,481,2879462045,2894547606
2025-06-19 03:54:12,REAL,2879462045,479,2879462524,2894548085
2025-06-19 03:54:14,REAL,2879462524,476,2879463000,2894548561
2025-06-19 03:54:16,FAKE,2879463000,238,2879463238,2894549118
2025-06-19 03:54:18,REAL,2879463238,483,2879463721,2894549601
2025-06-19 03:54:20,REAL,2879463721,476,2879464197,2894550077
2025-06-19 03:54:22,FAKE,2879464197,238,2879464435,2894550565
2025-06-19 03:54:24,REAL,2879464435,475,2879464910,2894551040
2025-06-19 03:54:26,REAL,2879464910,14411,2879479321,2894565451
2025-06-19 03:54:28,FAKE,2879479321,243,2879479564,2894575697
2025-06-19 03:54:30,REAL,2879479564,10319,2879489883,2894586016
2025-06-19 03:54:32,FAKE,2879489883,241,2879490124,2894596268
2025-06-19 03:54:34,REAL,2879490124,10376,2879500500,2894606644
2025-06-19 03:54:36,REAL,2879500500,10257,2879510757,2894616901
2025-06-19 03:54:38,FAKE,2879510757,241,2879510998,2894627228
2025-06-19 03:54:40,REAL,2879510998,5763,2879516761,2894632991
2025-06-19 03:54:42,REAL,2879516761,485,2879517246,2894633476
2025-06-19 03:54:44,FAKE,2879517246,241,2879517487,2894633960
2025-06-19 03:54:46,REAL,2879517487,487,2879517974,2894634447
2025-06-19 03:54:48,REAL,2879517974,484,2879518458,2894634931
2025-06-19 03:54:50,REAL,2879518458,488,2879518946,2894635419
2025-06-19 03:54:52,REAL,2879518946,489,2879519435,2894635908
2025-06-19 03:54:54,FAKE,2879519435,243,2879519678,2894636384
2025-06-19 03:54:56,FAKE,2879519678,238,2879519916,2894636867
2025-06-19 03:54:58,REAL,2879519916,12035,2879531951,2894648902
2025-06-19 03:55:00,REAL,2879531951,10314,2879542265,2894659216
2025-06-19 03:55:02,REAL,2879542265,10316,2879552581,2894669532
2025-06-19 03:55:04,REAL,2879552581,10254,2879562835,2894679786
2025-06-19 03:55:06,REAL,2879562835,10322,2879573157,2894690108
2025-06-19 03:55:08,REAL,2879573157,10247,2879583404,2894700355
2025-06-19 03:55:10,FAKE,2879583404,241,2879583645,2894710679
2025-06-19 03:55:12,FAKE,2879583645,244,2879583889,2894715785
2025-06-19 03:55:14,FAKE,2879583889,238,2879584127,2894716272
2025-06-19 03:55:16,FAKE,2879584127,241,2879584368,2894716760
2025-06-19 03:55:18,FAKE,2879584368,243,2879584611,2894717234
2025-06-19 03:55:20,REAL,2879584611,483,2879585094,2894717717
2025-06-19 03:55:22,REAL,2879585094,484,2879585578,2894718201
2025-06-19 03:55:24,REAL,2879585578,482,2879586060,2894718683
2025-06-19 03:55:26,FAKE,2879586060,244,2879586304,2894719165
2025-06-19 03:55:28,REAL,2879586304,1216,2879587520,2894720381
2025-06-19 03:55:30,FAKE,2879587520,243,2879587763,2894735188
2025-06-19 03:55:32,REAL,2879587763,10300,2879598063,2894745488
2025-06-19 03:55:34,REAL,2879598063,10246,2879608309,2894755734
2025-06-19 03:55:36,FAKE,2879608309,244,2879608553,2894766050
2025-06-19 03:55:38,REAL,2879608553,10246,2879618799,2894776296
2025-06-19 03:55:40,REAL,2879618799,10312,2879629111,2894786608
2025-06-19 03:55:42,REAL,2879629111,10248,2879639359,2894796856
2025-06-19 03:55:44,REAL,2879639359,4571,2879643930,2894801427
2025-06-19 03:55:46,REAL,2879643930,487,2879644417,2894801914
2025-06-19 03:55:48,REAL,2879644417,487,2879644904,2894802401
2025-06-19 03:55:50,REAL,2879644904,484,2879645388,2894802885
2025-06-19 03:55:52,REAL,2879645388,490,2879645878,2894803375
2025-06-19 03:55:54,FAKE,2879645878,241,2879646119,2894803862
2025-06-19 03:55:56,FAKE,2879646119,244,2879646363,2894804343
2025-06-19 03:55:58,REAL,2879646363,485,2879646848,2894804828
2025-06-19 03:56:00,REAL,2879646848,493,2879647341,2894805321
2025-06-19 03:56:02,REAL,2879647341,547,2879647888,2894805868
2025-06-19 03:56:04,REAL,2879647888,535,2879648423,2894806403
2025-06-19 03:56:06,REAL,2879648423,484,2879648907,2894806887
2025-06-19 03:56:08,REAL,2879648907,485,2879649392,2894807372
2025-06-19 03:56:10,REAL,2879649392,487,2879649879,2894807859
2025-06-19 03:56:12,REAL,2879649879,480,2879650359,2894808339
2025-06-19 03:56:14,REAL,2879650359,486,2879650845,2894808825
2025-06-19 03:56:16,FAKE,2879650845,238,2879651083,2894809303
2025-06-19 03:56:18,REAL,2879651083,482,2879651565,2894809785
2025-06-19 03:56:20,FAKE,2879651565,244,2879651809,2894810273
2025-06-19 03:56:22,REAL,2879651809,8481,2879660290,2894818754
2025-06-19 03:56:24,REAL,2879660290,10388,2879670678,2894829142
2025-06-19 03:56:26,FAKE,2879670678,238,2879670916,2894839461
2025-06-19 03:56:28,REAL,2879670916,10250,2879681166,2894849711
2025-06-19 03:56:30,FAKE,2879681166,241,2879681407,2894860085
2025-06-19 03:56:32,REAL,2879681407,10256,2879691663,2894870341
2025-06-19 03:56:34,REAL,2879691663,10252,2879701915,2894880593
2025-06-19 03:56:36,REAL,2879701915,8472,2879710387,2894889065
2025-06-19 03:56:38,REAL,2879710387,486,2879710873,2894889551
2025-06-19 03:56:40,REAL,2879710873,483,2879711356,2894890034
2025-06-19 03:56:42,REAL,2879711356,480,2879711836,2894890514
2025-06-19 03:56:44,REAL,2879711836,492,2879712328,2894891006
2025-06-19 03:56:46,REAL,2879712328,481,2879712809,2894891487
2025-06-19 03:56:48,REAL,2879712809,486,2879713295,2894891973
2025-06-19 03:56:50,REAL,2879713295,487,2879713782,2894892460
2025-06-19 03:56:52,REAL,2879713782,475,2879714257,2894892935
2025-06-19 03:56:54,FAKE,2879714257,244,2879714501,2894893414
2025-06-19 03:56:56,FAKE,2879714501,241,2879714742,2894893959
2025-06-19 03:56:58,REAL,2879714742,488,2879715230,2894894447
2025-06-19 03:57:00,REAL,2879715230,484,2879715714,2894894931
2025-06-19 03:57:02,REAL,2879715714,490,2879716204,2894895421
2025-06-19 03:57:04,FAKE,2879716204,238,2879716442,2894895905
2025-06-19 03:57:06,REAL,2879716442,480,2879716922,2894896385
2025-06-19 03:57:08,FAKE,2879716922,244,2879717166,2894896876
2025-06-19 03:57:10,FAKE,2879717166,241,2879717407,2894897356
2025-06-19 03:57:12,REAL,2879717407,485,2879717892,2894897841
2025-06-19 03:57:14,FAKE,2879717892,243,2879718135,2894898326
2025-06-19 03:57:16,REAL,2879718135,488,2879718623,2894898814
2025-06-19 03:57:18,REAL,2879718623,490,2879719113,2894899304
2025-06-19 03:57:20,REAL,2879719113,543,2879719656,2894899847
2025-06-19 03:57:22,REAL,2879719656,540,2879720196,2894900387
2025-06-19 03:57:24,REAL,2879720196,481,2879720677,2894900868
2025-06-19 03:57:26,REAL,2879720677,476,2879721153,2894901344
2025-06-19 03:57:28,REAL,2879721153,479,2879721632,2894901823
2025-06-19 03:57:30,REAL,2879721632,484,2879722116,2894902307
2025-06-19 03:57:32,REAL,2879722116,479,2879722595,2894902786
2025-06-19 03:57:34,REAL,2879722595,484,2879723079,2894903270
2025-06-19 03:57:36,REAL,2879723079,491,2879723570,2894903761
2025-06-19 03:57:38,FAKE,2879723570,243,2879723813,2894904241
2025-06-19 03:57:40,FAKE,2879723813,243,2879724056,2894904724
2025-06-19 03:57:42,REAL,2879724056,482,2879724538,2894905206
2025-06-19 03:57:44,FAKE,2879724538,244,2879724782,2894905690
2025-06-19 03:57:46,REAL,2879724782,489,2879725271,2894906179
2025-06-19 03:57:48,REAL,2879725271,492,2879725763,2894906671
2025-06-19 03:57:50,REAL,2879725763,537,2879726300,2894907208
2025-06-19 03:57:52,REAL,2879726300,493,2879726793,2894907701
2025-06-19 03:57:54,REAL,2879726793,489,2879727282,2894908190
2025-06-19 03:57:56,REAL,2879727282,482,2879727764,2894908672
2025-06-19 03:57:58,FAKE,2879727764,244,2879728008,2894909159
2025-06-19 03:58:00,FAKE,2879728008,238,2879728246,2894909638
2025-06-19 03:58:02,REAL,2879728246,489,2879728735,2894910127
2025-06-19 03:58:04,REAL,2879728735,481,2879729216,2894910608
2025-06-19 03:58:06,FAKE,2879729216,241,2879729457,2894911097
2025-06-19 03:58:08,REAL,2879729457,545,2879730002,2894911642
2025-06-19 03:58:10,FAKE,2879730002,243,2879730245,2894912121
2025-06-19 03:58:12,REAL,2879730245,492,2879730737,2894912613
2025-06-19 03:58:14,REAL,2879730737,489,2879731226,2894913102
2025-06-19 03:58:16,REAL,2879731226,533,2879731759,2894913635
2025-06-19 03:58:18,REAL,2879731759,486,2879732245,2894914121
2025-06-19 03:58:20,FAKE,2879732245,244,2879732489,2894914600
2025-06-19 03:58:22,REAL,2879732489,478,2879732967,2894915078
2025-06-19 03:58:24,REAL,2879732967,492,2879733459,2894915570
2025-06-19 03:58:26,REAL,2879733459,476,2879733935,2894916046
2025-06-19 03:58:28,REAL,2879733935,478,2879734413,2894916524
2025-06-19 03:58:30,REAL,2879734413,482,2879734895,2894917006
2025-06-19 03:58:32,REAL,2879734895,486,2879735381,2894917492
2025-06-19 03:58:34,FAKE,2879735381,243,2879735624,2894917978
2025-06-19 03:58:36,REAL,2879735624,493,2879736117,2894918471
2025-06-19 03:58:38,FAKE,2879736117,238,2879736355,2894918945
2025-06-19 03:58:40,FAKE,2879736355,241,2879736596,2894919436
2025-06-19 03:58:42,REAL,2879736596,547,2879737143,2894919983
2025-06-19 03:58:44,FAKE,2879737143,238,2879737381,2894920471
2025-06-19 03:58:46,REAL,2879737381,486,2879737867,2894920957
2025-06-19 03:58:48,REAL,2879737867,486,2879738353,2894921443
2025-06-19 03:58:50,REAL,2879738353,494,2879738847,2894921937
2025-06-19 03:58:52,REAL,2879738847,489,2879739336,2894922426
2025-06-19 03:58:54,FAKE,2879739336,241,2879739577,2894922912
2025-06-19 03:58:56,REAL,2879739577,482,2879740059,2894923394
2025-06-19 03:58:58,REAL,2879740059,539,2879740598,2894923933
2025-06-19 03:59:00,REAL,2879740598,488,2879741086,2894924421
2025-06-19 03:59:02,REAL,2879741086,492,2879741578,2894924913
2025-06-19 03:59:04,REAL,2879741578,482,2879742060,2894925395
2025-06-19 03:59:06,FAKE,2879742060,241,2879742301,2894925887
2025-06-19 03:59:08,REAL,2879742301,479,2879742780,2894926366
2025-06-19 03:59:10,REAL,2879742780,535,2879743315,2894926901
2025-06-19 03:59:12,REAL,2879743315,481,2879743796,2894927382
2025-06-19 03:59:14,REAL,2879743796,491,2879744287,2894927873
2025-06-19 03:59:16,FAKE,2879744287,243,2879744530,2894928360
2025-06-19 03:59:18,FAKE,2879744530,241,2879744771,2894928845
2025-06-19 03:59:20,REAL,2879744771,484,2879745255,2894929329
2025-06-19 03:59:22,FAKE,2879745255,241,2879745496,2894936423
2025-06-19 03:59:24,FAKE,2879745496,243,2879745739,2894947207
2025-06-19 03:59:26,REAL,2879745739,10254,2879755993,2894957461
2025-06-19 03:59:28,FAKE,2879755993,244,2879756237,2894967709
2025-06-19 03:59:30,REAL,2879756237,10323,2879766560,2894978032
2025-06-19 03:59:32,REAL,2879766560,10252,2879776812,2894988284
2025-06-19 03:59:34,REAL,2879776812,10248,2879787060,2894998532
2025-06-19 03:59:36,FAKE,2879787060,241,2879787301,2895008391
2025-06-19 03:59:38,REAL,2879787301,480,2879787781,2895008871
2025-06-19 03:59:40,REAL,2879787781,481,2879788262,2895009352
2025-06-19 03:59:42,FAKE,2879788262,243,2879788505,2895009834
2025-06-19 03:59:44,REAL,2879788505,484,2879788989,2895010318
2025-06-19 03:59:46,REAL,2879788989,602,2879789591,2895010920
2025-06-19 03:59:48,REAL,2879789591,474,2879790065,2895011394
2025-06-19 03:59:50,REAL,2879790065,487,2879790552,2895011881
2025-06-19 03:59:52,REAL,2879790552,476,2879791028,2895012357
2025-06-19 03:59:54,FAKE,2879791028,238,2879791266,2895012832
2025-06-19 03:59:56,FAKE,2879791266,244,2879791510,2895013315
2025-06-19 03:59:58,FAKE,2879791510,244,2879791754,2895013797
2025-06-19 04:00:00,FAKE,2879791754,244,2879791998,2895014283
2025-06-19 04:00:02,REAL,2879791998,482,2879792480,2895014765
2025-06-19 04:00:04,REAL,2879792480,488,2879792968,2895015253
2025-06-19 04:00:06,REAL,2879792968,486,2879793454,2895015739
2025-06-19 04:00:08,REAL,2879793454,481,2879793935,2895016220
2025-06-19 04:00:10,FAKE,2879793935,238,2879794173,2895016702
2025-06-19 04:00:12,REAL,2879794173,540,2879794713,2895017242
2025-06-19 04:00:14,REAL,2879794713,484,2879795197,2895017726
2025-06-19 04:00:16,REAL,2879795197,477,2879795674,2895018203
2025-06-19 04:00:18,REAL,2879795674,487,2879796161,2895018690
2025-06-19 04:00:20,FAKE,2879796161,244,2879796405,2895019178
2025-06-19 04:00:22,REAL,2879796405,483,2879796888,2895019661
2025-06-19 04:00:24,FAKE,2879796888,244,2879797132,2895020138
2025-06-19 04:00:26,REAL,2879797132,8211,2879805343,2895028349
2025-06-19 04:00:28,REAL,2879805343,10641,2879815984,2895038990
2025-06-19 04:00:30,FAKE,2879815984,241,2879816225,2895049240
2025-06-19 04:00:32,REAL,2879816225,10318,2879826543,2895059558
2025-06-19 04:00:34,FAKE,2879826543,241,2879826784,2895069807
2025-06-19 04:00:36,REAL,2879826784,10311,2879837095,2895080118
2025-06-19 04:00:38,REAL,2879837095,10256,2879847351,2895090374
2025-06-19 04:00:40,REAL,2879847351,8602,2879855953,2895098976
2025-06-19 04:00:42,REAL,2879855953,482,2879856435,2895099458
2025-06-19 04:00:44,FAKE,2879856435,244,2879856679,2895099939
2025-06-19 04:00:46,FAKE,2879856679,241,2879856920,2895100421
2025-06-19 04:00:48,FAKE,2879856920,243,2879857163,2895100905
2025-06-19 04:00:50,REAL,2879857163,539,2879857702,2895101444
2025-06-19 04:00:52,FAKE,2879857702,238,2879857940,2895101924
2025-06-19 04:00:54,REAL,2879857940,481,2879858421,2895102405
2025-06-19 04:00:56,REAL,2879858421,492,2879858913,2895102897
2025-06-19 04:00:58,REAL,2879858913,488,2879859401,2895103385
2025-06-19 04:01:00,REAL,2879859401,484,2879859885,2895103869
2025-06-19 04:01:02,REAL,2879859885,491,2879860376,2895104360
2025-06-19 04:01:04,REAL,2879860376,482,2879860858,2895104842
2025-06-19 04:01:06,FAKE,2879860858,238,2879861096,2895105331
2025-06-19 04:01:08,REAL,2879861096,489,2879861585,2895105820
2025-06-19 04:01:10,FAKE,2879861585,243,2879861828,2895106301
2025-06-19 04:01:12,REAL,2879861828,480,2879862308,2895106781
2025-06-19 04:01:14,REAL,2879862308,480,2879862788,2895107261
2025-06-19 04:01:16,REAL,2879862788,550,2879863338,2895107811
2025-06-19 04:01:18,FAKE,2879863338,244,2879863582,2895111802
2025-06-19 04:01:20,REAL,2879863582,15405,2879878987,2895127207
2025-06-19 04:01:22,REAL,2879878987,10250,2879889237,2895137457
2025-06-19 04:01:24,REAL,2879889237,10317,2879899554,2895147774
2025-06-19 04:01:26,REAL,2879899554,10306,2879909860,2895158080
2025-06-19 04:01:28,REAL,2879909860,10315,2879920175,2895168395
2025-06-19 04:01:30,FAKE,2879920175,243,2879920418,2895178648
2025-06-19 04:01:32,REAL,2879920418,10177,2879930595,2895188825
2025-06-19 04:01:34,FAKE,2879930595,238,2879930833,2895191619
2025-06-19 04:01:36,FAKE,2879930833,243,2879931076,2895192105
2025-06-19 04:01:38,FAKE,2879931076,238,2879931314,2895192595
2025-06-19 04:01:40,REAL,2879931314,475,2879931789,2895193070
2025-06-19 04:01:42,REAL,2879931789,479,2879932268,2895193549
2025-06-19 04:01:44,REAL,2879932268,544,2879932812,2895194093
2025-06-19 04:01:46,FAKE,2879932812,244,2879933056,2895194571
2025-06-19 04:01:48,REAL,2879933056,482,2879933538,2895195053
2025-06-19 04:01:50,REAL,2879933538,4249,2879937787,2895199302
2025-06-19 04:01:52,FAKE,2879937787,244,2879938031,2895210415
2025-06-19 04:01:54,REAL,2879938031,10316,2879948347,2895220731
2025-06-19 04:01:56,REAL,2879948347,10259,2879958606,2895230990
2025-06-19 04:01:58,REAL,2879958606,10315,2879968921,2895241305
2025-06-19 04:02:00,REAL,2879968921,10253,2879979174,2895251558
2025-06-19 04:02:02,FAKE,2879979174,244,2879979418,2895261870
2025-06-19 04:02:04,REAL,2879979418,10256,2879989674,2895272126
2025-06-19 04:02:06,REAL,2879989674,2140,2879991814,2895274266
2025-06-19 04:02:08,REAL,2879991814,491,2879992305,2895274757
2025-06-19 04:02:10,REAL,2879992305,476,2879992781,2895275233
2025-06-19 04:02:12,REAL,2879992781,482,2879993263,2895275715
2025-06-19 04:02:14,FAKE,2879993263,244,2879993507,2895276249
2025-06-19 04:02:16,REAL,2879993507,486,2879993993,2895276735
2025-06-19 04:02:18,REAL,2879993993,485,2879994478,2895277220
2025-06-19 04:02:20,REAL,2879994478,481,2879994959,2895277701
2025-06-19 04:02:22,REAL,2879994959,4843,2879999802,2895282544
2025-06-19 04:02:24,REAL,2879999802,11573,2880011375,2895294117
2025-06-19 04:02:26,REAL,2880011375,10246,2880021621,2895304363
2025-06-19 04:02:28,FAKE,2880021621,243,2880021864,2895314614
2025-06-19 04:02:30,FAKE,2880021864,238,2880022102,2895324860
2025-06-19 04:02:32,REAL,2880022102,10324,2880032426,2895335184
2025-06-19 04:02:34,REAL,2880032426,10250,2880042676,2895345434
2025-06-19 04:02:36,FAKE,2880042676,244,2880042920,2895355684
2025-06-19 04:02:38,REAL,2880042920,1540,2880044460,2895357224
2025-06-19 04:02:40,REAL,2880044460,482,2880044942,2895357706
2025-06-19 04:02:42,FAKE,2880044942,238,2880045180,2895358193
2025-06-19 04:02:44,REAL,2880045180,11314,2880056494,2895369507
2025-06-19 04:02:46,REAL,2880056494,10375,2880066869,2895379882
2025-06-19 04:02:48,FAKE,2880066869,243,2880067112,2895390137
2025-06-19 04:02:50,REAL,2880067112,10316,2880077428,2895400453
2025-06-19 04:02:52,FAKE,2880077428,238,2880077666,2895410706
2025-06-19 04:02:54,REAL,2880077666,10318,2880087984,2895421024
2025-06-19 04:02:56,REAL,2880087984,10247,2880098231,2895431271
2025-06-19 04:02:58,REAL,2880098231,6033,2880104264,2895437304
2025-06-19 04:03:00,FAKE,2880104264,244,2880104508,2895437783
2025-06-19 04:03:02,FAKE,2880104508,244,2880104752,2895438271
2025-06-19 04:03:04,REAL,2880104752,486,2880105238,2895438757
2025-06-19 04:03:06,FAKE,2880105238,244,2880105482,2895439240
2025-06-19 04:03:08,REAL,2880105482,246,2880105728,2895439486
2025-06-19 04:03:10,REAL,2880105728,486,2880106214,2895439972
2025-06-19 04:03:12,FAKE,2880106214,238,2880106452,2895440700
2025-06-19 04:03:14,REAL,2880106452,242,2880106694,2895440942
2025-06-19 04:03:16,REAL,2880106694,15272,2880121966,2895456214
2025-06-19 04:03:18,FAKE,2880121966,243,2880122209,2895466532
2025-06-19 04:03:20,REAL,2880122209,10257,2880132466,2895476789
2025-06-19 04:03:22,FAKE,2880132466,244,2880132710,2895487032
2025-06-19 04:03:24,FAKE,2880132710,241,2880132951,2895497350
2025-06-19 04:03:26,REAL,2880132951,10252,2880143203,2895507602
2025-06-19 04:03:28,REAL,2880143203,10315,2880153518,2895517917
2025-06-19 04:03:30,REAL,2880153518,5364,2880158882,2895523281
2025-06-19 04:03:32,REAL,2880158882,477,2880159359,2895523758
2025-06-19 04:03:34,REAL,2880159359,480,2880159839,2895524238
2025-06-19 04:03:36,REAL,2880159839,481,2880160320,2895524719
2025-06-19 04:03:38,REAL,2880160320,486,2880160806,2895525205
2025-06-19 04:03:40,REAL,2880160806,482,2880161288,2895525687
2025-06-19 04:03:42,REAL,2880161288,484,2880161772,2895526171
2025-06-19 04:03:44,FAKE,2880161772,244,2880162016,2895526655
2025-06-19 04:03:46,REAL,2880162016,483,2880162499,2895527138
2025-06-19 04:03:48,FAKE,2880162499,238,2880162737,2895527678
2025-06-19 04:03:50,REAL,2880162737,492,2880163229,2895528170
2025-06-19 04:03:52,REAL,2880163229,486,2880163715,2895528656
2025-06-19 04:03:54,REAL,2880163715,486,2880164201,2895529142
2025-06-19 04:03:56,REAL,2880164201,490,2880164691,2895529632
2025-06-19 04:03:58,FAKE,2880164691,244,2880164935,2895530173
2025-06-19 04:04:00,FAKE,2880164935,243,2880165178,2895530665
2025-06-19 04:04:02,FAKE,2880165178,244,2880165422,2895531150
2025-06-19 04:04:04,FAKE,2880165422,244,2880165666,2895531627
2025-06-19 04:04:06,FAKE,2880165666,241,2880165907,2895532110
2025-06-19 04:04:08,FAKE,2880165907,241,2880166148,2895532600
2025-06-19 04:04:10,REAL,2880166148,476,2880166624,2895533076
2025-06-19 04:04:12,FAKE,2880166624,238,2880166862,2895533552
2025-06-19 04:04:14,REAL,2880166862,486,2880167348,2895534038
2025-06-19 04:04:16,REAL,2880167348,488,2880167836,2895534526
2025-06-19 04:04:18,REAL,2880167836,1860,2880169696,2895536386
2025-06-19 04:04:20,REAL,2880169696,13900,2880183596,2895550286
2025-06-19 04:04:22,REAL,2880183596,10248,2880193844,2895560534
2025-06-19 04:04:24,REAL,2880193844,10309,2880204153,2895570843
2025-06-19 04:04:26,REAL,2880204153,10327,2880214480,2895581170
2025-06-19 04:04:28,REAL,2880214480,10248,2880224728,2895591418
2025-06-19 04:04:30,FAKE,2880224728,238,2880224966,2895601737
2025-06-19 04:04:32,REAL,2880224966,10317,2880235283,2895612054
2025-06-19 04:04:34,REAL,2880235283,4116,2880239399,2895616170
2025-06-19 04:04:36,REAL,2880239399,482,2880239881,2895616652
2025-06-19 04:04:38,REAL,2880239881,483,2880240364,2895617135
2025-06-19 04:04:40,REAL,2880240364,483,2880240847,2895617618
2025-06-19 04:04:42,FAKE,2880240847,244,2880241091,2895618098
2025-06-19 04:04:44,REAL,2880241091,485,2880241576,2895618583
2025-06-19 04:04:46,REAL,2880241576,487,2880242063,2895619070
2025-06-19 04:04:48,REAL,2880242063,530,2880242593,2895619600
2025-06-19 04:04:50,REAL,2880242593,481,2880243074,2895620081
2025-06-19 04:04:52,REAL,2880243074,479,2880243553,2895620560
2025-06-19 04:04:54,FAKE,2880243553,238,2880243791,2895621040
2025-06-19 04:04:56,FAKE,2880243791,241,2880244032,2895621521
2025-06-19 04:04:58,REAL,2880244032,486,2880244518,2895622007
2025-06-19 04:05:00,FAKE,2880244518,241,2880244759,2895622496
2025-06-19 04:05:02,REAL,2880244759,478,2880245237,2895622974
2025-06-19 04:05:04,REAL,2880245237,547,2880245784,2895623521
2025-06-19 04:05:06,FAKE,2880245784,244,2880246028,2895624006
2025-06-19 04:05:08,REAL,2880246028,488,2880246516,2895624494
2025-06-19 04:05:10,REAL,2880246516,487,2880247003,2895624981
2025-06-19 04:05:12,FAKE,2880247003,238,2880247241,2895625463
2025-06-19 04:05:14,FAKE,2880247241,241,2880247482,2895625954
2025-06-19 04:05:16,REAL,2880247482,475,2880247957,2895626429
2025-06-19 04:05:18,FAKE,2880247957,241,2880248198,2895626913
2025-06-19 04:05:20,FAKE,2880248198,243,2880248441,2895627444
2025-06-19 04:05:22,REAL,2880248441,3329,2880251770,2895630773
2025-06-19 04:05:24,REAL,2880251770,11904,2880263674,2895642677
2025-06-19 04:05:26,REAL,2880263674,10259,2880273933,2895652936
2025-06-19 04:05:28,REAL,2880273933,10315,2880284248,2895663251
2025-06-19 04:05:30,FAKE,2880284248,244,2880284492,2895673497
2025-06-19 04:05:32,REAL,2880284492,10253,2880294745,2895683750
2025-06-19 04:05:34,REAL,2880294745,10310,2880305055,2895694060
2025-06-19 04:05:36,REAL,2880305055,10248,2880315303,2895704308
2025-06-19 04:05:38,REAL,2880315303,2928,2880318231,2895707236
2025-06-19 04:05:40,REAL,2880318231,486,2880318717,2895707722
2025-06-19 04:05:42,FAKE,2880318717,238,2880318955,2895708199
2025-06-19 04:05:44,REAL,2880318955,481,2880319436,2895708680
2025-06-19 04:05:46,REAL,2880319436,491,2880319927,2895709171
2025-06-19 04:05:48,REAL,2880319927,486,2880320413,2895709657
2025-06-19 04:05:50,REAL,2880320413,546,2880320959,2895710203
2025-06-19 04:05:52,REAL,2880320959,490,2880321449,2895710693
2025-06-19 04:05:54,REAL,2880321449,484,2880321933,2895711177
2025-06-19 04:05:56,REAL,2880321933,490,2880322423,2895711667
2025-06-19 04:05:58,FAKE,2880322423,241,2880322664,2895712145
2025-06-19 04:06:00,REAL,2880322664,482,2880323146,2895712627
2025-06-19 04:06:02,REAL,2880323146,489,2880323635,2895713116
2025-06-19 04:06:04,FAKE,2880323635,241,2880323876,2895713598
2025-06-19 04:06:06,REAL,2880323876,475,2880324351,2895714073
2025-06-19 04:06:08,REAL,2880324351,539,2880324890,2895714612
2025-06-19 04:06:10,FAKE,2880324890,238,2880325128,2895715101
2025-06-19 04:06:12,FAKE,2880325128,238,2880325366,2895715581
2025-06-19 04:06:14,FAKE,2880325366,244,2880325610,2895716067
2025-06-19 04:06:16,REAL,2880325610,484,2880326094,2895716551
2025-06-19 04:06:18,REAL,2880326094,485,2880326579,2895717036
2025-06-19 04:06:20,REAL,2880326579,544,2880327123,2895717580
2025-06-19 04:06:22,REAL,2880327123,484,2880327607,2895718064
2025-06-19 04:06:24,REAL,2880327607,484,2880328091,2895718548
2025-06-19 04:06:26,REAL,2880328091,482,2880328573,2895719030
2025-06-19 04:06:28,REAL,2880328573,490,2880329063,2895719520
2025-06-19 04:06:30,REAL,2880329063,485,2880329548,2895720005
2025-06-19 04:06:32,FAKE,2880329548,241,2880329789,2895720484
2025-06-19 04:06:34,FAKE,2880329789,241,2880330030,2895720966
2025-06-19 04:06:36,REAL,2880330030,489,2880330519,2895721455
2025-06-19 04:06:38,REAL,2880330519,484,2880331003,2895721939
2025-06-19 04:06:40,FAKE,2880331003,244,2880331247,2895722425
2025-06-19 04:06:42,FAKE,2880331247,244,2880331491,2895722906
2025-06-19 04:06:44,REAL,2880331491,482,2880331973,2895723388
2025-06-19 04:06:46,REAL,2880331973,477,2880332450,2895723865
2025-06-19 04:06:48,REAL,2880332450,489,2880332939,2895724354
2025-06-19 04:06:50,FAKE,2880332939,243,2880333182,2895724844
2025-06-19 04:06:52,REAL,2880333182,546,2880333728,2895725390
2025-06-19 04:06:54,REAL,2880333728,491,2880334219,2895725881
2025-06-19 04:06:56,FAKE,2880334219,241,2880334460,2895726367
2025-06-19 04:06:58,REAL,2880334460,482,2880334942,2895726849
2025-06-19 04:07:00,FAKE,2880334942,241,2880335183,2895727328
2025-06-19 04:07:02,REAL,2880335183,545,2880335728,2895727873
2025-06-19 04:07:04,REAL,2880335728,11906,2880347634,2895739779
2025-06-19 04:07:06,FAKE,2880347634,241,2880347875,2895750031
2025-06-19 04:07:08,REAL,2880347875,10313,2880358188,2895760344
2025-06-19 04:07:10,REAL,2880358188,10250,2880368438,2895770594
2025-06-19 04:07:12,REAL,2880368438,10253,2880378691,2895780847
2025-06-19 04:07:14,REAL,2880378691,10249,2880388940,2895791096
2025-06-19 04:07:16,REAL,2880388940,10325,2880399265,2895801421
2025-06-19 04:07:18,REAL,2880399265,5894,2880405159,2895807315
2025-06-19 04:07:20,FAKE,2880405159,238,2880405397,2895807794
2025-06-19 04:07:22,FAKE,2880405397,241,2880405638,2895808282
2025-06-19 04:07:24,REAL,2880405638,480,2880406118,2895808762
2025-06-19 04:07:26,REAL,2880406118,480,2880406598,2895809242
2025-06-19 04:07:28,REAL,2880406598,484,2880407082,2895809726
2025-06-19 04:07:30,REAL,2880407082,488,2880407570,2895810214
2025-06-19 04:07:32,REAL,2880407570,481,2880408051,2895810695
2025-06-19 04:07:34,REAL,2880408051,487,2880408538,2895811182
2025-06-19 04:07:36,REAL,2880408538,12181,2880420719,2895823363
2025-06-19 04:07:38,REAL,2880420719,10254,2880430973,2895833617
2025-06-19 04:07:40,REAL,2880430973,10255,2880441228,2895843872
2025-06-19 04:07:42,FAKE,2880441228,243,2880441471,2895854188
2025-06-19 04:07:44,REAL,2880441471,10300,2880451771,2895864488
2025-06-19 04:07:46,REAL,2880451771,10249,2880462020,2895874737
2025-06-19 04:07:48,FAKE,2880462020,243,2880462263,2895885062
2025-06-19 04:07:50,REAL,2880462263,5295,2880467558,2895890357
2025-06-19 04:07:52,REAL,2880467558,490,2880468048,2895890847
2025-06-19 04:07:54,REAL,2880468048,482,2880468530,2895891329
2025-06-19 04:07:56,FAKE,2880468530,243,2880468773,2895891810
2025-06-19 04:07:58,REAL,2880468773,486,2880469259,2895892296
2025-06-19 04:08:00,FAKE,2880469259,244,2880469503,2895892780
2025-06-19 04:08:02,FAKE,2880469503,244,2880469747,2895893267
2025-06-19 04:08:04,REAL,2880469747,485,2880470232,2895893752
2025-06-19 04:08:06,REAL,2880470232,1148,2880471380,2895894900
2025-06-19 04:08:08,FAKE,2880471380,243,2880471623,2895906870
2025-06-19 04:08:10,FAKE,2880471623,241,2880471864,2895917190
2025-06-19 04:08:12,REAL,2880471864,10257,2880482121,2895927447
2025-06-19 04:08:14,FAKE,2880482121,243,2880482364,2895938618
2025-06-19 04:08:16,FAKE,2880482364,243,2880482607,2895947950
2025-06-19 04:08:18,FAKE,2880482607,238,2880482845,2895958194
2025-06-19 04:08:20,REAL,2880482845,10311,2880493156,2895968505
2025-06-19 04:08:22,REAL,2880493156,4578,2880497734,2895973083
2025-06-19 04:08:24,REAL,2880497734,482,2880498216,2895973565
2025-06-19 04:08:26,FAKE,2880498216,238,2880498454,2895974053
2025-06-19 04:08:28,REAL,2880498454,545,2880498999,2895974598
2025-06-19 04:08:30,REAL,2880498999,479,2880499478,2895975077
2025-06-19 04:08:32,REAL,2880499478,486,2880499964,2895975563
2025-06-19 04:08:34,REAL,2880499964,479,2880500443,2895976042
2025-06-19 04:08:36,FAKE,2880500443,244,2880500687,2895976530
2025-06-19 04:08:38,FAKE,2880500687,238,2880500925,2895978476
2025-06-19 04:08:40,FAKE,2880500925,241,2880501166,2895990245
2025-06-19 04:08:42,REAL,2880501166,10254,2880511420,2896000499
2025-06-19 04:08:44,FAKE,2880511420,244,2880511664,2896010815
2025-06-19 04:08:46,REAL,2880511664,10258,2880521922,2896021073
2025-06-19 04:08:48,REAL,2880521922,10251,2880532173,2896031324
2025-06-19 04:08:50,REAL,2880532173,10319,2880542492,2896041643
2025-06-19 04:08:52,REAL,2880542492,10250,2880552742,2896051893
2025-06-19 04:08:54,FAKE,2880552742,243,2880552985,2896055932
2025-06-19 04:08:56,REAL,2880552985,494,2880553479,2896056426
2025-06-19 04:08:58,FAKE,2880553479,243,2880553722,2896056902
2025-06-19 04:09:00,REAL,2880553722,476,2880554198,2896057378
2025-06-19 04:09:02,REAL,2880554198,485,2880554683,2896057863
2025-06-19 04:09:04,REAL,2880554683,487,2880555170,2896058350
2025-06-19 04:09:06,REAL,2880555170,483,2880555653,2896058833
2025-06-19 04:09:08,FAKE,2880555653,238,2880555891,2896059320
2025-06-19 04:09:10,REAL,2880555891,2525,2880558416,2896061845
2025-06-19 04:09:12,REAL,2880558416,15463,2880573879,2896077308
2025-06-19 04:09:14,REAL,2880573879,10321,2880584200,2896087629
2025-06-19 04:09:16,FAKE,2880584200,244,2880584444,2896097876
2025-06-19 04:09:18,FAKE,2880584444,238,2880584682,2896108127
2025-06-19 04:09:20,REAL,2880584682,10327,2880595009,2896118454
2025-06-19 04:09:22,FAKE,2880595009,243,2880595252,2896128710
2025-06-19 04:09:24,FAKE,2880595252,241,2880595493,2896139028
2025-06-19 04:09:26,REAL,2880595493,3395,2880598888,2896142423
2025-06-19 04:09:28,FAKE,2880598888,241,2880599129,2896142908
2025-06-19 04:09:30,REAL,2880599129,489,2880599618,2896143397
2025-06-19 04:09:32,FAKE,2880599618,241,2880599859,2896143883
2025-06-19 04:09:34,REAL,2880599859,488,2880600347,2896144371
2025-06-19 04:09:36,REAL,2880600347,485,2880600832,2896144856
2025-06-19 04:09:38,REAL,2880600832,478,2880601310,2896145334
2025-06-19 04:09:40,FAKE,2880601310,238,2880601548,2896145818
2025-06-19 04:09:42,FAKE,2880601548,241,2880601789,2896149412
2025-06-19 04:09:44,REAL,2880601789,11444,2880613233,2896160856
2025-06-19 04:09:46,REAL,2880613233,10254,2880623487,2896171110
2025-06-19 04:09:48,FAKE,2880623487,244,2880623731,2896181362
2025-06-19 04:09:50,REAL,2880623731,10321,2880634052,2896191683
2025-06-19 04:09:52,REAL,2880634052,10252,2880644304,2896201935
2025-06-19 04:09:54,REAL,2880644304,10309,2880654613,2896212244
2025-06-19 04:09:56,REAL,2880654613,10261,2880664874,2896222505
2025-06-19 04:09:58,FAKE,2880664874,241,2880665115,2896225225
2025-06-19 04:10:00,FAKE,2880665115,243,2880665358,2896225710
2025-06-19 04:10:02,FAKE,2880665358,243,2880665601,2896226193
2025-06-19 04:10:04,FAKE,2880665601,244,2880665845,2896226675
2025-06-19 04:10:06,FAKE,2880665845,243,2880666088,2896227152
2025-06-19 04:10:08,REAL,2880666088,478,2880666566,2896227630
2025-06-19 04:10:10,REAL,2880666566,485,2880667051,2896228115
2025-06-19 04:10:12,REAL,2880667051,483,2880667534,2896228598
2025-06-19 04:10:14,REAL,2880667534,4125,2880671659,2896232723
2025-06-19 04:10:16,FAKE,2880671659,238,2880671897,2896244301
2025-06-19 04:10:18,FAKE,2880671897,243,2880672140,2896254556
2025-06-19 04:10:20,REAL,2880672140,10253,2880682393,2896264809
2025-06-19 04:10:22,FAKE,2880682393,243,2880682636,2896275130
2025-06-19 04:10:24,REAL,2880682636,10249,2880692885,2896285379
2025-06-19 04:10:26,FAKE,2880692885,244,2880693129,2896295634
2025-06-19 04:10:28,FAKE,2880693129,244,2880693373,2896305951
2025-06-19 04:10:30,FAKE,2880693373,243,2880693616,2896308020
2025-06-19 04:10:32,FAKE,2880693616,243,2880693859,2896308502
2025-06-19 04:10:34,REAL,2880693859,476,2880694335,2896308978
2025-06-19 04:10:36,REAL,2880694335,537,2880694872,2896309515
2025-06-19 04:10:38,REAL,2880694872,488,2880695360,2896310003
2025-06-19 04:10:40,REAL,2880695360,484,2880695844,2896310487
2025-06-19 04:10:42,REAL,2880695844,489,2880696333,2896310976
2025-06-19 04:10:44,FAKE,2880696333,244,2880696577,2896311466
2025-06-19 04:10:46,REAL,2880696577,481,2880697058,2896311947
2025-06-19 04:10:48,REAL,2880697058,480,2880697538,2896312427
2025-06-19 04:10:50,REAL,2880697538,484,2880698022,2896312911
2025-06-19 04:10:52,FAKE,2880698022,244,2880698266,2896313398
2025-06-19 04:10:54,REAL,2880698266,539,2880698805,2896313937
2025-06-19 04:10:56,REAL,2880698805,490,2880699295,2896314427
2025-06-19 04:10:58,FAKE,2880699295,238,2880699533,2896314908
2025-06-19 04:11:00,REAL,2880699533,490,2880700023,2896315398
2025-06-19 04:11:02,REAL,2880700023,481,2880700504,2896315879
2025-06-19 04:11:04,FAKE,2880700504,241,2880700745,2896316367
2025-06-19 04:11:06,REAL,2880700745,484,2880701229,2896316851
2025-06-19 04:11:08,REAL,2880701229,484,2880701713,2896317335
2025-06-19 04:11:10,REAL,2880701713,484,2880702197,2896317819
2025-06-19 04:11:12,REAL,2880702197,477,2880702674,2896318296
2025-06-19 04:11:14,REAL,2880702674,482,2880703156,2896318778
2025-06-19 04:11:16,REAL,2880703156,489,2880703645,2896319267
2025-06-19 04:11:18,REAL,2880703645,5836,2880709481,2896325103
2025-06-19 04:11:20,FAKE,2880709481,243,2880709724,2896336006
2025-06-19 04:11:22,REAL,2880709724,10250,2880719974,2896346256
2025-06-19 04:11:24,FAKE,2880719974,244,2880720218,2896356571
2025-06-19 04:11:26,FAKE,2880720218,241,2880720459,2896366823
2025-06-19 04:11:28,FAKE,2880720459,243,2880720702,2896377144
2025-06-19 04:11:30,REAL,2880720702,10246,2880730948,2896387390
2025-06-19 04:11:32,REAL,2880730948,10249,2880741197,2896397639
2025-06-19 04:11:34,FAKE,2880741197,241,2880741438,2896398587
2025-06-19 04:11:36,REAL,2880741438,491,2880741929,2896399078
2025-06-19 04:11:38,FAKE,2880741929,241,2880742170,2896399559
2025-06-19 04:11:40,REAL,2880742170,482,2880742652,2896400041
2025-06-19 04:11:42,REAL,2880742652,492,2880743144,2896400533
2025-06-19 04:11:44,REAL,2880743144,486,2880743630,2896401019
2025-06-19 04:11:46,FAKE,2880743630,244,2880743874,2896401501
2025-06-19 04:11:48,FAKE,2880743874,244,2880744118,2896401984
2025-06-19 04:11:50,FAKE,2880744118,238,2880744356,2896407958
2025-06-19 04:11:52,FAKE,2880744356,238,2880744594,2896418937
2025-06-19 04:11:54,REAL,2880744594,10251,2880754845,2896429188
2025-06-19 04:11:56,REAL,2880754845,10318,2880765163,2896439506
2025-06-19 04:11:58,REAL,2880765163,10247,2880775410,2896449753
2025-06-19 04:12:00,REAL,2880775410,10314,2880785724,2896460067
2025-06-19 04:12:02,REAL,2880785724,10307,2880796031,2896470374
2025-06-19 04:12:04,REAL,2880796031,9986,2880806017,2896480360
2025-06-19 04:12:06,REAL,2880806017,488,2880806505,2896480848
2025-06-19 04:12:08,REAL,2880806505,488,2880806993,2896481336
2025-06-19 04:12:10,FAKE,2880806993,241,2880807234,2896481825
2025-06-19 04:12:12,REAL,2880807234,491,2880807725,2896482316
2025-06-19 04:12:14,REAL,2880807725,490,2880808215,2896482806
2025-06-19 04:12:16,REAL,2880808215,477,2880808692,2896483283
2025-06-19 04:12:18,REAL,2880808692,485,2880809177,2896483768
2025-06-19 04:12:20,REAL,2880809177,478,2880809655,2896484246
2025-06-19 04:12:22,FAKE,2880809655,241,2880809896,2896484733
2025-06-19 04:12:24,REAL,2880809896,485,2880810381,2896485218
2025-06-19 04:12:26,REAL,2880810381,487,2880810868,2896485705
2025-06-19 04:12:28,FAKE,2880810868,238,2880811106,2896486188
2025-06-19 04:12:30,FAKE,2880811106,241,2880811347,2896486674
2025-06-19 04:12:32,REAL,2880811347,487,2880811834,2896487161
2025-06-19 04:12:34,REAL,2880811834,542,2880812376,2896487703
2025-06-19 04:12:36,REAL,2880812376,491,2880812867,2896488194
2025-06-19 04:12:38,REAL,2880812867,485,2880813352,2896488679
2025-06-19 04:12:40,REAL,2880813352,538,2880813890,2896489217
2025-06-19 04:12:42,REAL,2880813890,482,2880814372,2896489699
2025-06-19 04:12:44,REAL,2880814372,484,2880814856,2896490183
2025-06-19 04:12:46,REAL,2880814856,484,2880815340,2896490667
2025-06-19 04:12:48,FAKE,2880815340,238,2880815578,2896491156
2025-06-19 04:12:50,REAL,2880815578,480,2880816058,2896491636
2025-06-19 04:12:52,FAKE,2880816058,241,2880816299,2896492118
2025-06-19 04:12:54,REAL,2880816299,488,2880816787,2896492606
2025-06-19 04:12:56,REAL,2880816787,479,2880817266,2896493085
2025-06-19 04:12:58,REAL,2880817266,486,2880817752,2896493571
2025-06-19 04:13:00,REAL,2880817752,487,2880818239,2896494058
2025-06-19 04:13:02,REAL,2880818239,492,2880818731,2896494550
2025-06-19 04:13:04,FAKE,2880818731,244,2880818975,2896495033
2025-06-19 04:13:06,REAL,2880818975,485,2880819460,2896495518
2025-06-19 04:13:08,FAKE,2880819460,243,2880819703,2896495999
2025-06-19 04:13:10,REAL,2880819703,482,2880820185,2896496481
2025-06-19 04:13:12,REAL,2880820185,489,2880820674,2896496970
2025-06-19 04:13:14,REAL,2880820674,489,2880821163,2896497459
2025-06-19 04:13:16,REAL,2880821163,539,2880821702,2896497998
2025-06-19 04:13:18,REAL,2880821702,483,2880822185,2896498481
2025-06-19 04:13:20,FAKE,2880822185,243,2880822428,2896499025
2025-06-19 04:13:22,REAL,2880822428,482,2880822910,2896499507
2025-06-19 04:13:24,REAL,2880822910,487,2880823397,2896499994
2025-06-19 04:13:26,REAL,2880823397,480,2880823877,2896500474
2025-06-19 04:13:28,REAL,2880823877,480,2880824357,2896500954
2025-06-19 04:13:30,REAL,2880824357,2797,2880827154,2896503751
2025-06-19 04:13:32,REAL,2880827154,11311,2880838465,2896515062
2025-06-19 04:13:34,REAL,2880838465,10256,2880848721,2896525318
2025-06-19 04:13:36,REAL,2880848721,10260,2880858981,2896535578
2025-06-19 04:13:38,REAL,2880858981,10255,2880869236,2896545833
2025-06-19 04:13:40,REAL,2880869236,10315,2880879551,2896556148
2025-06-19 04:13:42,REAL,2880879551,10257,2880889808,2896566405
2025-06-19 04:13:44,FAKE,2880889808,238,2880890046,2896576655
2025-06-19 04:13:46,REAL,2880890046,3253,2880893299,2896579908
2025-06-19 04:13:48,FAKE,2880893299,244,2880893543,2896580390
2025-06-19 04:13:50,REAL,2880893543,485,2880894028,2896580875
2025-06-19 04:13:52,REAL,2880894028,536,2880894564,2896581411
2025-06-19 04:13:54,REAL,2880894564,483,2880895047,2896581894
2025-06-19 04:13:56,REAL,2880895047,484,2880895531,2896582378
2025-06-19 04:13:58,FAKE,2880895531,241,2880895772,2896582866
2025-06-19 04:14:00,REAL,2880895772,484,2880896256,2896583350
2025-06-19 04:14:02,REAL,2880896256,3796,2880900052,2896587146
2025-06-19 04:14:04,FAKE,2880900052,238,2880900290,2896598517
2025-06-19 04:14:06,FAKE,2880900290,244,2880900534,2896608841
2025-06-19 04:14:08,REAL,2880900534,10252,2880910786,2896619093
2025-06-19 04:14:10,FAKE,2880910786,244,2880911030,2896629339
2025-06-19 04:14:12,FAKE,2880911030,238,2880911268,2896639585
2025-06-19 04:14:14,REAL,2880911268,10313,2880921581,2896649898
2025-06-19 04:14:16,REAL,2880921581,10252,2880931833,2896660150
2025-06-19 04:14:18,REAL,2880931833,2599,2880934432,2896662749
2025-06-19 04:14:20,REAL,2880934432,482,2880934914,2896663231
2025-06-19 04:14:22,REAL,2880934914,481,2880935395,2896663712
2025-06-19 04:14:24,FAKE,2880935395,244,2880935639,2896664196
2025-06-19 04:14:26,REAL,2880935639,480,2880936119,2896664676
2025-06-19 04:14:28,REAL,2880936119,486,2880936605,2896665162
2025-06-19 04:14:30,REAL,2880936605,541,2880937146,2896665703
2025-06-19 04:14:32,REAL,2880937146,486,2880937632,2896666189
2025-06-19 04:14:34,REAL,2880937632,480,2880938112,2896666669
2025-06-19 04:14:36,REAL,2880938112,483,2880938595,2896667152
2025-06-19 04:14:38,REAL,2880938595,485,2880939080,2896667637
2025-06-19 04:14:40,REAL,2880939080,487,2880939567,2896668124
2025-06-19 04:14:42,REAL,2880939567,488,2880940055,2896668612
2025-06-19 04:14:44,FAKE,2880940055,241,2880940296,2896669090
2025-06-19 04:14:46,REAL,2880940296,487,2880940783,2896669577
2025-06-19 04:14:48,FAKE,2880940783,238,2880941021,2896670118
2025-06-19 04:14:50,REAL,2880941021,478,2880941499,2896670596
2025-06-19 04:14:52,REAL,2880941499,481,2880941980,2896671077
2025-06-19 04:14:54,REAL,2880941980,480,2880942460,2896671557
2025-06-19 04:14:56,REAL,2880942460,486,2880942946,2896672043
2025-06-19 04:14:58,REAL,2880942946,489,2880943435,2896672532
2025-06-19 04:15:00,REAL,2880943435,479,2880943914,2896673011
2025-06-19 04:15:02,FAKE,2880943914,244,2880944158,2896673489
2025-06-19 04:15:04,REAL,2880944158,479,2880944637,2896673968
2025-06-19 04:15:06,REAL,2880944637,539,2880945176,2896674507
2025-06-19 04:15:08,REAL,2880945176,489,2880945665,2896674996
2025-06-19 04:15:10,FAKE,2880945665,238,2880945903,2896675480
2025-06-19 04:15:12,REAL,2880945903,476,2880946379,2896675956
2025-06-19 04:15:14,REAL,2880946379,484,2880946863,2896676440
2025-06-19 04:15:16,REAL,2880946863,485,2880947348,2896676925
2025-06-19 04:15:18,REAL,2880947348,477,2880947825,2896677402
2025-06-19 04:15:20,REAL,2880947825,482,2880948307,2896677884
2025-06-19 04:15:22,FAKE,2880948307,243,2880948550,2896678374
2025-06-19 04:15:24,FAKE,2880948550,238,2880948788,2896678867
2025-06-19 04:15:26,REAL,2880948788,475,2880949263,2896679342
2025-06-19 04:15:28,FAKE,2880949263,241,2880949504,2896679822
2025-06-19 04:15:30,REAL,2880949504,485,2880949989,2896680307
2025-06-19 04:15:32,FAKE,2880949989,243,2880950232,2896680846
2025-06-19 04:15:34,FAKE,2880950232,241,2880950473,2896681333
2025-06-19 04:15:36,REAL,2880950473,482,2880950955,2896681815
2025-06-19 04:15:38,FAKE,2880950955,238,2880951193,2896682293
2025-06-19 04:15:40,REAL,2880951193,486,2880951679,2896682779
2025-06-19 04:15:42,FAKE,2880951679,238,2880951917,2896683269
2025-06-19 04:15:44,REAL,2880951917,539,2880952456,2896683808
2025-06-19 04:15:46,REAL,2880952456,487,2880952943,2896684295
2025-06-19 04:15:48,FAKE,2880952943,238,2880953181,2896690400
2025-06-19 04:15:50,FAKE,2880953181,241,2880953422,2896701857
2025-06-19 04:15:52,FAKE,2880953422,241,2880953663,2896712112
2025-06-19 04:15:54,FAKE,2880953663,241,2880953904,2896722359
2025-06-19 04:15:56,FAKE,2880953904,244,2880954148,2896732679
2025-06-19 04:15:58,REAL,2880954148,10246,2880964394,2896742925
2025-06-19 04:16:00,REAL,2880964394,10250,2880974644,2896753175
2025-06-19 04:16:02,FAKE,2880974644,238,2880974882,2896763493
2025-06-19 04:16:04,REAL,2880974882,619,2880975501,2896764112
2025-06-19 04:16:06,REAL,2880975501,481,2880975982,2896764593
2025-06-19 04:16:08,REAL,2880975982,478,2880976460,2896765071
2025-06-19 04:16:10,FAKE,2880976460,244,2880976704,2896765559
2025-06-19 04:16:12,REAL,2880976704,485,2880977189,2896766044
2025-06-19 04:16:14,REAL,2880977189,480,2880977669,2896766524
2025-06-19 04:16:16,REAL,2880977669,481,2880978150,2896767005
2025-06-19 04:16:18,FAKE,2880978150,243,2880978393,2896767486
2025-06-19 04:16:20,REAL,2880978393,6900,2880985293,2896774386
2025-06-19 04:16:22,REAL,2880985293,11298,2880996591,2896785684
2025-06-19 04:16:24,REAL,2880996591,10247,2881006838,2896795931
2025-06-19 04:16:26,FAKE,2881006838,244,2881007082,2896806255
2025-06-19 04:16:28,REAL,2881007082,10246,2881017328,2896816501
2025-06-19 04:16:30,FAKE,2881017328,238,2881017566,2896826748
2025-06-19 04:16:32,REAL,2881017566,10314,2881027880,2896837062
2025-06-19 04:16:34,FAKE,2881027880,241,2881028121,2896846853
2025-06-19 04:16:36,FAKE,2881028121,243,2881028364,2896847334
2025-06-19 04:16:38,REAL,2881028364,489,2881028853,2896847823
2025-06-19 04:16:40,REAL,2881028853,491,2881029344,2896848314
2025-06-19 04:16:42,FAKE,2881029344,241,2881029585,2896848796
2025-06-19 04:16:44,REAL,2881029585,491,2881030076,2896849287
2025-06-19 04:16:46,REAL,2881030076,488,2881030564,2896849775
2025-06-19 04:16:48,REAL,2881030564,488,2881031052,2896850263
2025-06-19 04:16:50,FAKE,2881031052,241,2881031293,2896850757
2025-06-19 04:16:52,FAKE,2881031293,241,2881031534,2896851243
2025-06-19 04:16:54,FAKE,2881031534,244,2881031778,2896851731
2025-06-19 04:16:56,FAKE,2881031778,238,2881032016,2896852267
2025-06-19 04:16:58,REAL,2881032016,486,2881032502,2896852753
2025-06-19 04:17:00,REAL,2881032502,487,2881032989,2896853240
2025-06-19 04:17:02,REAL,2881032989,490,2881033479,2896853730
2025-06-19 04:17:04,FAKE,2881033479,238,2881033717,2896854268
2025-06-19 04:17:06,FAKE,2881033717,238,2881033955,2896854749
2025-06-19 04:17:08,FAKE,2881033955,243,2881034198,2896855234
2025-06-19 04:17:10,FAKE,2881034198,238,2881034436,2896855714
2025-06-19 04:17:12,REAL,2881034436,478,2881034914,2896856192
2025-06-19 04:17:14,REAL,2881034914,481,2881035395,2896856673
2025-06-19 04:17:16,REAL,2881035395,485,2881035880,2896857158
2025-06-19 04:17:18,REAL,2881035880,546,2881036426,2896857704
2025-06-19 04:17:20,REAL,2881036426,480,2881036906,2896858184
2025-06-19 04:17:22,REAL,2881036906,477,2881037383,2896858661
2025-06-19 04:17:24,REAL,2881037383,486,2881037869,2896859147
2025-06-19 04:17:26,FAKE,2881037869,238,2881038107,2896859631
2025-06-19 04:17:28,REAL,2881038107,488,2881038595,2896860119
2025-06-19 04:17:30,REAL,2881038595,483,2881039078,2896860602
2025-06-19 04:17:32,REAL,2881039078,476,2881039554,2896861078
2025-06-19 04:17:34,FAKE,2881039554,238,2881039792,2896861562
2025-06-19 04:17:36,REAL,2881039792,480,2881040272,2896862042
2025-06-19 04:17:38,REAL,2881040272,484,2881040756,2896862526
2025-06-19 04:17:40,FAKE,2881040756,244,2881041000,2896863063
2025-06-19 04:17:42,FAKE,2881041000,243,2881041243,2896863553
2025-06-19 04:17:44,FAKE,2881041243,241,2881041484,2896866493
2025-06-19 04:17:46,REAL,2881041484,14945,2881056429,2896881438
2025-06-19 04:17:48,REAL,2881056429,10849,2881067278,2896892287
2025-06-19 04:17:50,FAKE,2881067278,238,2881067516,2896902008
2025-06-19 04:17:52,REAL,2881067516,10252,2881077768,2896912260
2025-06-19 04:17:54,REAL,2881077768,10313,2881088081,2896922573
2025-06-19 04:17:56,REAL,2881088081,10253,2881098334,2896932826
2025-06-19 04:17:58,FAKE,2881098334,238,2881098572,2896943153
2025-06-19 04:18:00,REAL,2881098572,3322,2881101894,2896946475
2025-06-19 04:18:02,REAL,2881101894,541,2881102435,2896947016
2025-06-19 04:18:04,REAL,2881102435,480,2881102915,2896947496
2025-06-19 04:18:06,REAL,2881102915,489,2881103404,2896947985
2025-06-19 04:18:08,REAL,2881103404,480,2881103884,2896948465
2025-06-19 04:18:10,REAL,2881103884,485,2881104369,2896948950
2025-06-19 04:18:12,FAKE,2881104369,238,2881104607,2896949433
2025-06-19 04:18:14,REAL,2881104607,486,2881105093,2896949919
2025-06-19 04:18:16,REAL,2881105093,3729,2881108822,2896953648
2025-06-19 04:18:18,REAL,2881108822,11565,2881120387,2896965213
2025-06-19 04:18:20,REAL,2881120387,10253,2881130640,2896975466
2025-06-19 04:18:22,FAKE,2881130640,243,2881130883,2896985786
2025-06-19 04:18:24,REAL,2881130883,10309,2881141192,2896996095
2025-06-19 04:18:26,REAL,2881141192,10256,2881151448,2897006351
2025-06-19 04:18:28,REAL,2881151448,10250,2881161698,2897016601
2025-06-19 04:18:30,REAL,2881161698,10319,2881172017,2897026920
2025-06-19 04:18:32,REAL,2881172017,2671,2881174688,2897029591
2025-06-19 04:18:34,REAL,2881174688,489,2881175177,2897030080
2025-06-19 04:18:36,REAL,2881175177,484,2881175661,2897030564
2025-06-19 04:18:38,FAKE,2881175661,241,2881175902,2897031048
2025-06-19 04:18:40,REAL,2881175902,481,2881176383,2897031529
2025-06-19 04:18:42,REAL,2881176383,479,2881176862,2897032008
2025-06-19 04:18:44,REAL,2881176862,489,2881177351,2897032497
2025-06-19 04:18:46,REAL,2881177351,541,2881177892,2897033038
2025-06-19 04:18:48,REAL,2881177892,482,2881178374,2897033520
2025-06-19 04:18:50,FAKE,2881178374,244,2881178618,2897034006
2025-06-19 04:18:52,REAL,2881178618,480,2881179098,2897034486
2025-06-19 04:18:54,REAL,2881179098,485,2881179583,2897034971
2025-06-19 04:18:56,REAL,2881179583,483,2881180066,2897035454
2025-06-19 04:18:58,FAKE,2881180066,244,2881180310,2897035932
2025-06-19 04:19:00,REAL,2881180310,538,2881180848,2897036470
2025-06-19 04:19:02,REAL,2881180848,489,2881181337,2897036959
2025-06-19 04:19:04,REAL,2881181337,479,2881181816,2897037438
2025-06-19 04:19:06,FAKE,2881181816,238,2881182054,2897037920
2025-06-19 04:19:08,REAL,2881182054,542,2881182596,2897038462
2025-06-19 04:19:10,REAL,2881182596,485,2881183081,2897038947
2025-06-19 04:19:12,FAKE,2881183081,244,2881183325,2897039427
2025-06-19 04:19:14,REAL,2881183325,485,2881183810,2897039912
2025-06-19 04:19:16,FAKE,2881183810,238,2881184048,2897040398
2025-06-19 04:19:18,REAL,2881184048,483,2881184531,2897040881
2025-06-19 04:19:20,REAL,2881184531,5053,2881189584,2897045934
2025-06-19 04:19:22,REAL,2881189584,11306,2881200890,2897057240
2025-06-19 04:19:24,REAL,2881200890,10317,2881211207,2897067557
2025-06-19 04:19:26,REAL,2881211207,10254,2881221461,2897077811
2025-06-19 04:19:28,REAL,2881221461,10255,2881231716,2897088066
2025-06-19 04:19:30,REAL,2881231716,10373,2881242089,2897098439
2025-06-19 04:19:32,REAL,2881242089,10257,2881252346,2897108696
2025-06-19 04:19:34,FAKE,2881252346,238,2881252584,2897119013
2025-06-19 04:19:36,REAL,2881252584,1402,2881253986,2897120415
2025-06-19 04:19:38,FAKE,2881253986,243,2881254229,2897120907
2025-06-19 04:19:40,REAL,2881254229,491,2881254720,2897121398
2025-06-19 04:19:42,FAKE,2881254720,241,2881254961,2897121881
2025-06-19 04:19:44,REAL,2881254961,487,2881255448,2897122368
2025-06-19 04:19:46,REAL,2881255448,486,2881255934,2897122854
2025-06-19 04:19:48,REAL,2881255934,239,2881256173,2897123093
2025-06-19 04:19:50,REAL,2881256173,490,2881256663,2897123583
2025-06-19 04:19:52,REAL,2881256663,542,2881257205,2897124125
2025-06-19 04:19:54,REAL,2881257205,491,2881257696,2897124616
2025-06-19 04:19:56,FAKE,2881257696,243,2881257939,2897125091
2025-06-19 04:19:58,REAL,2881257939,481,2881258420,2897125572
2025-06-19 04:20:00,REAL,2881258420,488,2881258908,2897126060
2025-06-19 04:20:02,FAKE,2881258908,243,2881259151,2897126551
2025-06-19 04:20:04,REAL,2881259151,540,2881259691,2897127091
2025-06-19 04:20:06,REAL,2881259691,484,2881260175,2897127575
2025-06-19 04:20:08,REAL,2881260175,487,2881260662,2897128062
2025-06-19 04:20:10,FAKE,2881260662,238,2881260900,2897128539
2025-06-19 04:20:12,FAKE,2881260900,241,2881261141,2897129024
2025-06-19 04:20:14,REAL,2881261141,15131,2881276272,2897144155
2025-06-19 04:20:16,FAKE,2881276272,238,2881276510,2897154411
2025-06-19 04:20:18,FAKE,2881276510,243,2881276753,2897164725
2025-06-19 04:20:20,REAL,2881276753,10247,2881287000,2897174972
2025-06-19 04:20:22,REAL,2881287000,10317,2881297317,2897185289
2025-06-19 04:20:24,REAL,2881297317,10257,2881307574,2897195546
2025-06-19 04:20:26,REAL,2881307574,10257,2881317831,2897205803
2025-06-19 04:20:28,REAL,2881317831,5492,2881323323,2897211295
2025-06-19 04:20:30,REAL,2881323323,489,2881323812,2897211784
2025-06-19 04:20:32,REAL,2881323812,483,2881324295,2897212267
2025-06-19 04:20:34,FAKE,2881324295,238,2881324533,2897212742
2025-06-19 04:20:36,REAL,2881324533,542,2881325075,2897213284
2025-06-19 04:20:38,REAL,2881325075,494,2881325569,2897213778
2025-06-19 04:20:40,FAKE,2881325569,244,2881325813,2897214262
2025-06-19 04:20:42,REAL,2881325813,488,2881326301,2897214750
2025-06-19 04:20:44,REAL,2881326301,689,2881326990,2897215439
2025-06-19 04:20:46,REAL,2881326990,12422,2881339412,2897227861
2025-06-19 04:20:48,FAKE,2881339412,241,2881339653,2897238116
2025-06-19 04:20:50,REAL,2881339653,10321,2881349974,2897248437
2025-06-19 04:20:52,FAKE,2881349974,241,2881350215,2897258688
2025-06-19 04:20:54,REAL,2881350215,10316,2881360531,2897269004
2025-06-19 04:20:56,REAL,2881360531,10251,2881370782,2897279255
2025-06-19 04:20:58,REAL,2881370782,10376,2881381158,2897289631
2025-06-19 04:21:00,REAL,2881381158,4836,2881385994,2897294467
2025-06-19 04:21:02,FAKE,2881385994,238,2881386232,2897294949
2025-06-19 04:21:04,FAKE,2881386232,241,2881386473,2897295436
2025-06-19 04:21:06,REAL,2881386473,476,2881386949,2897295912
2025-06-19 04:21:08,REAL,2881386949,484,2881387433,2897296396
2025-06-19 04:21:10,REAL,2881387433,477,2881387910,2897296873
2025-06-19 04:21:12,FAKE,2881387910,241,2881388151,2897297356
2025-06-19 04:21:14,FAKE,2881388151,243,2881388394,2897297839
2025-06-19 04:21:16,REAL,2881388394,1741,2881390135,2897299580
2025-06-19 04:21:18,REAL,2881390135,11840,2881401975,2897311420
2025-06-19 04:21:20,FAKE,2881401975,238,2881402213,2897321787
2025-06-19 04:21:22,FAKE,2881402213,241,2881402454,2897332043
2025-06-19 04:21:24,FAKE,2881402454,241,2881402695,2897342293
2025-06-19 04:21:26,REAL,2881402695,10314,2881413009,2897352607
2025-06-19 04:21:28,FAKE,2881413009,244,2881413253,2897362863
2025-06-19 04:21:30,REAL,2881413253,10315,2881423568,2897373178
2025-06-19 04:21:32,REAL,2881423568,4177,2881427745,2897377355
2025-06-19 04:21:34,FAKE,2881427745,241,2881427986,2897377842
2025-06-19 04:21:36,REAL,2881427986,484,2881428470,2897378326
2025-06-19 04:21:38,FAKE,2881428470,243,2881428713,2897378803
2025-06-19 04:21:40,REAL,2881428713,481,2881429194,2897379284
2025-06-19 04:21:42,REAL,2881429194,534,2881429728,2897379818
2025-06-19 04:21:44,REAL,2881429728,481,2881430209,2897380299
2025-06-19 04:21:46,REAL,2881430209,490,2881430699,2897380789
2025-06-19 04:21:48,FAKE,2881430699,238,2881430937,2897381273
2025-06-19 04:21:50,FAKE,2881430937,244,2881431181,2897381754
2025-06-19 04:21:52,FAKE,2881431181,243,2881431424,2897382242
2025-06-19 04:21:54,REAL,2881431424,489,2881431913,2897382731
2025-06-19 04:21:56,REAL,2881431913,487,2881432400,2897383218
2025-06-19 04:21:58,REAL,2881432400,481,2881432881,2897383699
2025-06-19 04:22:00,REAL,2881432881,539,2881433420,2897384238
2025-06-19 04:22:02,FAKE,2881433420,243,2881433663,2897384723
2025-06-19 04:22:04,REAL,2881433663,486,2881434149,2897385209
2025-06-19 04:22:06,FAKE,2881434149,244,2881434393,2897385694
2025-06-19 04:22:08,FAKE,2881434393,241,2881434634,2897386180
2025-06-19 04:22:10,REAL,2881434634,488,2881435122,2897386668
2025-06-19 04:22:12,REAL,2881435122,477,2881435599,2897387145
2025-06-19 04:22:14,REAL,2881435599,488,2881436087,2897387633
2025-06-19 04:22:16,REAL,2881436087,477,2881436564,2897388110
2025-06-19 04:22:18,REAL,2881436564,491,2881437055,2897388601
2025-06-19 04:22:20,FAKE,2881437055,244,2881437299,2897392129
2025-06-19 04:22:22,FAKE,2881437299,241,2881437540,2897403507
2025-06-19 04:22:24,FAKE,2881437540,241,2881437781,2897413759
2025-06-19 04:22:26,REAL,2881437781,10251,2881448032,2897424010
2025-06-19 04:22:28,REAL,2881448032,10309,2881458341,2897434319
2025-06-19 04:22:30,REAL,2881458341,10310,2881468651,2897444629
2025-06-19 04:22:32,FAKE,2881468651,238,2881468889,2897454881
2025-06-19 04:22:34,REAL,2881468889,10319,2881479208,2897465200
2025-06-19 04:22:36,REAL,2881479208,2993,2881482201,2897468193
2025-06-19 04:22:38,REAL,2881482201,483,2881482684,2897468676
2025-06-19 04:22:40,REAL,2881482684,485,2881483169,2897469161
2025-06-19 04:22:42,REAL,2881483169,479,2881483648,2897469640
2025-06-19 04:22:44,FAKE,2881483648,243,2881483891,2897470131
2025-06-19 04:22:46,REAL,2881483891,478,2881484369,2897470609
2025-06-19 04:22:48,REAL,2881484369,482,2881484851,2897471091
2025-06-19 04:22:50,FAKE,2881484851,244,2881485095,2897471571
2025-06-19 04:22:52,REAL,2881485095,489,2881485584,2897472060
2025-06-19 04:22:54,FAKE,2881485584,244,2881485828,2897472539
2025-06-19 04:22:56,REAL,2881485828,483,2881486311,2897473022
2025-06-19 04:22:58,FAKE,2881486311,243,2881486554,2897473505
2025-06-19 04:23:00,REAL,2881486554,479,2881487033,2897473984
2025-06-19 04:23:02,FAKE,2881487033,238,2881487271,2897474469
2025-06-19 04:23:04,REAL,2881487271,536,2881487807,2897475005
2025-06-19 04:23:06,REAL,2881487807,480,2881488287,2897475485
2025-06-19 04:23:08,FAKE,2881488287,241,2881488528,2897475972
2025-06-19 04:23:10,REAL,2881488528,487,2881489015,2897476459
2025-06-19 04:23:12,FAKE,2881489015,244,2881489259,2897476937
2025-06-19 04:23:14,REAL,2881489259,478,2881489737,2897477415
2025-06-19 04:23:16,REAL,2881489737,484,2881490221,2897477899
2025-06-19 04:23:18,REAL,2881490221,541,2881490762,2897478440
2025-06-19 04:23:20,FAKE,2881490762,241,2881491003,2897478915
2025-06-19 04:23:22,REAL,2881491003,488,2881491491,2897479403
2025-06-19 04:23:24,FAKE,2881491491,243,2881491734,2897484313
2025-06-19 04:23:26,FAKE,2881491734,243,2881491977,2897495286
2025-06-19 04:23:28,FAKE,2881491977,238,2881492215,2897505607
2025-06-19 04:23:30,FAKE,2881492215,238,2881492453,2897515860
2025-06-19 04:23:32,REAL,2881492453,10243,2881502696,2897526103
2025-06-19 04:23:34,REAL,2881502696,10314,2881513010,2897536417
2025-06-19 04:23:36,REAL,2881513010,10251,2881523261,2897546668
2025-06-19 04:23:38,FAKE,2881523261,244,2881523505,2897556918
2025-06-19 04:23:40,REAL,2881523505,1745,2881525250,2897558663
2025-06-19 04:23:42,REAL,2881525250,482,2881525732,2897559145
2025-06-19 04:23:44,REAL,2881525732,492,2881526224,2897559637
2025-06-19 04:23:46,FAKE,2881526224,244,2881526468,2897560118
2025-06-19 04:23:48,REAL,2881526468,490,2881526958,2897560608
2025-06-19 04:23:50,FAKE,2881526958,244,2881527202,2897561102
2025-06-19 04:23:52,REAL,2881527202,491,2881527693,2897561593
2025-06-19 04:23:54,REAL,2881527693,491,2881528184,2897562084
2025-06-19 04:23:56,REAL,2881528184,5834,2881534018,2897567918
2025-06-19 04:23:58,REAL,2881534018,11439,2881545457,2897579357
2025-06-19 04:24:00,REAL,2881545457,10255,2881555712,2897589612
2025-06-19 04:24:02,REAL,2881555712,10255,2881565967,2897599867
2025-06-19 04:24:04,REAL,2881565967,10253,2881576220,2897610120
2025-06-19 04:24:06,FAKE,2881576220,241,2881576461,2897620433
2025-06-19 04:24:08,FAKE,2881576461,244,2881576705,2897630752
2025-06-19 04:24:10,REAL,2881576705,10252,2881586957,2897641004
2025-06-19 04:24:12,FAKE,2881586957,244,2881587201,2897642086
2025-06-19 04:24:14,FAKE,2881587201,241,2881587442,2897642571
2025-06-19 04:24:16,FAKE,2881587442,244,2881587686,2897643060
2025-06-19 04:24:18,FAKE,2881587686,238,2881587924,2897643542
2025-06-19 04:24:20,REAL,2881587924,480,2881588404,2897644022
2025-06-19 04:24:22,REAL,2881588404,487,2881588891,2897644509
2025-06-19 04:24:24,REAL,2881588891,482,2881589373,2897644991
2025-06-19 04:24:26,FAKE,2881589373,243,2881589616,2897645485
2025-06-19 04:24:28,REAL,2881589616,488,2881590104,2897645973
2025-06-19 04:24:30,FAKE,2881590104,238,2881590342,2897646457
2025-06-19 04:24:32,REAL,2881590342,484,2881590826,2897646941
2025-06-19 04:24:34,REAL,2881590826,477,2881591303,2897647418
2025-06-19 04:24:36,REAL,2881591303,482,2881591785,2897647900
2025-06-19 04:24:38,REAL,2881591785,539,2881592324,2897648439
2025-06-19 04:24:40,REAL,2881592324,480,2881592804,2897648919
2025-06-19 04:24:42,REAL,2881592804,487,2881593291,2897649406
2025-06-19 04:24:44,REAL,2881593291,487,2881593778,2897649893
2025-06-19 04:24:46,FAKE,2881593778,238,2881594016,2897650377
2025-06-19 04:24:48,REAL,2881594016,481,2881594497,2897650858
2025-06-19 04:24:50,REAL,2881594497,479,2881594976,2897651337
2025-06-19 04:24:52,REAL,2881594976,548,2881595524,2897651885
2025-06-19 04:24:54,FAKE,2881595524,243,2881595767,2897652379
2025-06-19 04:24:56,REAL,2881595767,483,2881596250,2897652862
2025-06-19 04:24:58,FAKE,2881596250,238,2881596488,2897653348
2025-06-19 04:25:00,REAL,2881596488,6913,2881603401,2897660261
2025-06-19 04:25:02,REAL,2881603401,11107,2881614508,2897671368
2025-06-19 04:25:04,REAL,2881614508,10253,2881624761,2897681621
2025-06-19 04:25:06,FAKE,2881624761,243,2881625004,2897691877
2025-06-19 04:25:08,FAKE,2881625004,238,2881625242,2897702124
2025-06-19 04:25:10,REAL,2881625242,10259,2881635501,2897712383
2025-06-19 04:25:12,REAL,2881635501,10316,2881645817,2897722699
2025-06-19 04:25:14,REAL,2881645817,9582,2881655399,2897732281
2025-06-19 04:25:16,REAL,2881655399,482,2881655881,2897732763
2025-06-19 04:25:18,FAKE,2881655881,241,2881656122,2897733239
2025-06-19 04:25:20,FAKE,2881656122,243,2881656365,2897733726
2025-06-19 04:25:22,REAL,2881656365,483,2881656848,2897734209
2025-06-19 04:25:24,REAL,2881656848,481,2881657329,2897734690
2025-06-19 04:25:26,FAKE,2881657329,238,2881657567,2897735181
2025-06-19 04:25:28,FAKE,2881657567,241,2881657808,2897735663
2025-06-19 04:25:30,REAL,2881657808,487,2881658295,2897736150
2025-06-19 04:25:32,FAKE,2881658295,238,2881658533,2897744099
2025-06-19 04:25:34,REAL,2881658533,10579,2881669112,2897754678
2025-06-19 04:25:36,REAL,2881669112,10254,2881679366,2897764932
2025-06-19 04:25:38,FAKE,2881679366,243,2881679609,2897775186
2025-06-19 04:25:40,REAL,2881679609,10369,2881689978,2897785555
2025-06-19 04:25:42,REAL,2881689978,10245,2881700223,2897795800
2025-06-19 04:25:44,REAL,2881700223,10255,2881710478,2897806055
2025-06-19 04:25:46,REAL,2881710478,9059,2881719537,2897815114
2025-06-19 04:25:48,FAKE,2881719537,238,2881719775,2897815592
2025-06-19 04:25:50,REAL,2881719775,477,2881720252,2897816069
2025-06-19 04:25:52,FAKE,2881720252,241,2881720493,2897818406
2025-06-19 04:25:54,REAL,2881720493,11438,2881731931,2897829844
2025-06-19 04:25:56,REAL,2881731931,10327,2881742258,2897840171
2025-06-19 04:25:58,FAKE,2881742258,244,2881742502,2897850420
2025-06-19 04:26:00,REAL,2881742502,10248,2881752750,2897860668
2025-06-19 04:26:02,REAL,2881752750,10314,2881763064,2897870982
2025-06-19 04:26:04,REAL,2881763064,10258,2881773322,2897881240
2025-06-19 04:26:06,FAKE,2881773322,241,2881773563,2897891490
2025-06-19 04:26:08,REAL,2881773563,3783,2881777346,2897895273
2025-06-19 04:26:10,REAL,2881777346,484,2881777830,2897895757
2025-06-19 04:26:12,FAKE,2881777830,244,2881778074,2897896243
2025-06-19 04:26:14,REAL,2881778074,487,2881778561,2897896730
2025-06-19 04:26:16,REAL,2881778561,477,2881779038,2897897207
2025-06-19 04:26:18,FAKE,2881779038,243,2881779281,2897897693
2025-06-19 04:26:20,REAL,2881779281,491,2881779772,2897898184
2025-06-19 04:26:22,FAKE,2881779772,244,2881780016,2897898670
2025-06-19 04:26:24,REAL,2881780016,479,2881780495,2897899149
2025-06-19 04:26:26,REAL,2881780495,545,2881781040,2897899694
2025-06-19 04:26:28,REAL,2881781040,484,2881781524,2897900178
2025-06-19 04:26:30,REAL,2881781524,487,2881782011,2897900665
2025-06-19 04:26:32,FAKE,2881782011,238,2881782249,2897901151
2025-06-19 04:26:34,FAKE,2881782249,243,2881782492,2897901686
2025-06-19 04:26:36,REAL,2881782492,479,2881782971,2897902165
2025-06-19 04:26:38,FAKE,2881782971,241,2881783212,2897902650
2025-06-19 04:26:40,REAL,2881783212,490,2881783702,2897903140
2025-06-19 04:26:42,REAL,2881783702,484,2881784186,2897903624
2025-06-19 04:26:44,FAKE,2881784186,243,2881784429,2897904103
2025-06-19 04:26:46,REAL,2881784429,491,2881784920,2897904594
2025-06-19 04:26:48,FAKE,2881784920,241,2881785161,2897905081
2025-06-19 04:26:50,FAKE,2881785161,244,2881785405,2897905562
2025-06-19 04:26:52,REAL,2881785405,485,2881785890,2897906047
2025-06-19 04:26:54,REAL,2881785890,479,2881786369,2897906526
2025-06-19 04:26:56,FAKE,2881786369,244,2881786613,2897907009
2025-06-19 04:26:58,REAL,2881786613,477,2881787090,2897907486
2025-06-19 04:27:00,REAL,2881787090,489,2881787579,2897907975
2025-06-19 04:27:02,FAKE,2881787579,241,2881787820,2897908460
2025-06-19 04:27:04,FAKE,2881787820,243,2881788063,2897908938
2025-06-19 04:27:06,REAL,2881788063,475,2881788538,2897909413
2025-06-19 04:27:08,FAKE,2881788538,238,2881788776,2897909897
2025-06-19 04:27:10,REAL,2881788776,483,2881789259,2897910380
2025-06-19 04:27:12,REAL,2881789259,484,2881789743,2897910864
2025-06-19 04:27:14,REAL,2881789743,546,2881790289,2897911410
2025-06-19 04:27:16,REAL,2881790289,488,2881790777,2897911898
2025-06-19 04:27:18,FAKE,2881790777,241,2881791018,2897912431
2025-06-19 04:27:20,REAL,2881791018,483,2881791501,2897912914
2025-06-19 04:27:22,FAKE,2881791501,238,2881791739,2897913399
2025-06-19 04:27:24,FAKE,2881791739,241,2881791980,2897913886
2025-06-19 04:27:26,REAL,2881791980,478,2881792458,2897914364
2025-06-19 04:27:28,REAL,2881792458,485,2881792943,2897914849
2025-06-19 04:27:30,FAKE,2881792943,244,2881793187,2897915331
2025-06-19 04:27:32,REAL,2881793187,484,2881793671,2897915815
2025-06-19 04:27:34,REAL,2881793671,10785,2881804456,2897926600
2025-06-19 04:27:36,REAL,2881804456,10385,2881814841,2897936985
2025-06-19 04:27:38,FAKE,2881814841,243,2881815084,2897947298
2025-06-19 04:27:40,REAL,2881815084,10247,2881825331,2897957545
2025-06-19 04:27:42,REAL,2881825331,10250,2881835581,2897967795
2025-06-19 04:27:44,REAL,2881835581,10248,2881845829,2897978043
2025-06-19 04:27:46,REAL,2881845829,10254,2881856083,2897988297
2025-06-19 04:27:48,REAL,2881856083,6750,2881862833,2897995047
2025-06-19 04:27:50,REAL,2881862833,486,2881863319,2897995533
2025-06-19 04:27:52,REAL,2881863319,480,2881863799,2897996013
2025-06-19 04:27:54,REAL,2881863799,481,2881864280,2897996494
2025-06-19 04:27:56,REAL,2881864280,486,2881864766,2897996980
2025-06-19 04:27:58,REAL,2881864766,484,2881865250,2897997464
2025-06-19 04:28:00,REAL,2881865250,544,2881865794,2897998008
2025-06-19 04:28:02,REAL,2881865794,482,2881866276,2897998490
2025-06-19 04:28:04,REAL,2881866276,488,2881866764,2897998978
2025-06-19 04:28:06,REAL,2881866764,14357,2881881121,2898013335
2025-06-19 04:28:08,FAKE,2881881121,238,2881881359,2898023653
2025-06-19 04:28:10,FAKE,2881881359,243,2881881602,2898033904
2025-06-19 04:28:12,FAKE,2881881602,238,2881881840,2898044225
2025-06-19 04:28:14,REAL,2881881840,10246,2881892086,2898054471
2025-06-19 04:28:16,REAL,2881892086,10247,2881902333,2898064718
2025-06-19 04:28:18,FAKE,2881902333,244,2881902577,2898074969
2025-06-19 04:28:20,FAKE,2881902577,241,2881902818,2898081067
2025-06-19 04:28:22,FAKE,2881902818,241,2881903059,2898081545
2025-06-19 04:28:24,FAKE,2881903059,244,2881903303,2898082024
2025-06-19 04:28:26,REAL,2881903303,488,2881903791,2898082512
2025-06-19 04:28:28,REAL,2881903791,484,2881904275,2898082996
2025-06-19 04:28:30,REAL,2881904275,489,2881904764,2898083485
2025-06-19 04:28:32,FAKE,2881904764,241,2881905005,2898083966
2025-06-19 04:28:34,REAL,2881905005,491,2881905496,2898084457
2025-06-19 04:28:36,REAL,2881905496,479,2881905975,2898084936
2025-06-19 04:28:38,FAKE,2881905975,241,2881906216,2898085476
2025-06-19 04:28:40,REAL,2881906216,488,2881906704,2898085964
2025-06-19 04:28:42,FAKE,2881906704,243,2881906947,2898086452
2025-06-19 04:28:44,REAL,2881906947,477,2881907424,2898086929
2025-06-19 04:28:46,REAL,2881907424,486,2881907910,2898087415
2025-06-19 04:28:48,FAKE,2881907910,238,2881908148,2898087955
2025-06-19 04:28:50,FAKE,2881908148,238,2881908386,2898088433
2025-06-19 04:28:52,FAKE,2881908386,238,2881908624,2898088919
2025-06-19 04:28:54,FAKE,2881908624,238,2881908862,2898089408
2025-06-19 04:28:56,REAL,2881908862,484,2881909346,2898089892
2025-06-19 04:28:58,REAL,2881909346,477,2881909823,2898090369
2025-06-19 04:29:00,REAL,2881909823,491,2881910314,2898090860
2025-06-19 04:29:02,FAKE,2881910314,243,2881910557,2898091344
2025-06-19 04:29:04,REAL,2881910557,482,2881911039,2898091826
2025-06-19 04:29:06,REAL,2881911039,486,2881911525,2898092312
2025-06-19 04:29:08,FAKE,2881911525,244,2881911769,2898093140
2025-06-19 04:29:10,FAKE,2881911769,241,2881912010,2898109209
2025-06-19 04:29:12,REAL,2881912010,10252,2881922262,2898119461
2025-06-19 04:29:14,REAL,2881922262,10250,2881932512,2898129711
2025-06-19 04:29:16,FAKE,2881932512,243,2881932755,2898140031
2025-06-19 04:29:18,REAL,2881932755,10252,2881943007,2898150283
2025-06-19 04:29:20,REAL,2881943007,10256,2881953263,2898160539
2025-06-19 04:29:22,REAL,2881953263,10253,2881963516,2898170792
2025-06-19 04:29:24,REAL,2881963516,4837,2881968353,2898175629
2025-06-19 04:29:26,REAL,2881968353,483,2881968836,2898176112
2025-06-19 04:29:28,FAKE,2881968836,243,2881969079,2898176595
2025-06-19 04:29:30,REAL,2881969079,487,2881969566,2898177082
2025-06-19 04:29:32,REAL,2881969566,481,2881970047,2898177563
2025-06-19 04:29:34,REAL,2881970047,534,2881970581,2898178097
2025-06-19 04:29:36,FAKE,2881970581,238,2881970819,2898178581
2025-06-19 04:29:38,REAL,2881970819,486,2881971305,2898179067
2025-06-19 04:29:40,REAL,2881971305,1821,2881973126,2898180888
2025-06-19 04:29:42,FAKE,2881973126,238,2881973364,2898192125
2025-06-19 04:29:44,REAL,2881973364,10258,2881983622,2898202383
2025-06-19 04:29:46,FAKE,2881983622,244,2881983866,2898212703
2025-06-19 04:29:48,REAL,2881983866,10250,2881994116,2898222953
2025-06-19 04:29:50,REAL,2881994116,10321,2882004437,2898233274
2025-06-19 04:29:52,FAKE,2882004437,241,2882004678,2898243526
2025-06-19 04:29:54,REAL,2882004678,10259,2882014937,2898253785
2025-06-19 04:29:56,REAL,2882014937,4246,2882019183,2898258031
2025-06-19 04:29:58,FAKE,2882019183,244,2882019427,2898258514
2025-06-19 04:30:00,REAL,2882019427,481,2882019908,2898258995
2025-06-19 04:30:02,FAKE,2882019908,238,2882020146,2898259474
2025-06-19 04:30:04,FAKE,2882020146,238,2882020384,2898259960
2025-06-19 04:30:06,REAL,2882020384,481,2882020865,2898260441
2025-06-19 04:30:08,REAL,2882020865,482,2882021347,2898260923
2025-06-19 04:30:10,FAKE,2882021347,238,2882021585,2898261416
2025-06-19 04:30:12,FAKE,2882021585,241,2882021826,2898261897
2025-06-19 04:30:14,FAKE,2882021826,241,2882022067,2898262429
2025-06-19 04:30:16,REAL,2882022067,482,2882022549,2898262911
2025-06-19 04:30:18,REAL,2882022549,480,2882023029,2898263391
2025-06-19 04:30:20,REAL,2882023029,482,2882023511,2898263873
2025-06-19 04:30:22,REAL,2882023511,544,2882024055,2898264417
2025-06-19 04:30:24,REAL,2882024055,489,2882024544,2898264906
2025-06-19 04:30:26,FAKE,2882024544,241,2882024785,2898265383
2025-06-19 04:30:28,REAL,2882024785,493,2882025278,2898265876
2025-06-19 04:30:30,REAL,2882025278,481,2882025759,2898266357
2025-06-19 04:30:32,FAKE,2882025759,241,2882026000,2898266847
2025-06-19 04:30:34,REAL,2882026000,483,2882026483,2898267330
2025-06-19 04:30:36,FAKE,2882026483,244,2882026727,2898267811
2025-06-19 04:30:38,FAKE,2882026727,238,2882026965,2898268298
2025-06-19 04:30:40,REAL,2882026965,486,2882027451,2898268784
2025-06-19 04:30:42,REAL,2882027451,486,2882027937,2898269270
2025-06-19 04:30:44,REAL,2882027937,487,2882028424,2898269757
2025-06-19 04:30:46,REAL,2882028424,539,2882028963,2898270296
2025-06-19 04:30:48,REAL,2882028963,483,2882029446,2898270779
2025-06-19 04:30:50,FAKE,2882029446,244,2882029690,2898271256
2025-06-19 04:30:52,REAL,2882029690,493,2882030183,2898271749
2025-06-19 04:30:54,REAL,2882030183,477,2882030660,2898272226
2025-06-19 04:30:56,REAL,2882030660,485,2882031145,2898272711
2025-06-19 04:30:58,REAL,2882031145,484,2882031629,2898273195
2025-06-19 04:31:00,FAKE,2882031629,243,2882031872,2898273681
2025-06-19 04:31:02,REAL,2882031872,486,2882032358,2898274167
2025-06-19 04:31:04,REAL,2882032358,494,2882032852,2898274661
2025-06-19 04:31:06,FAKE,2882032852,238,2882033090,2898275141
2025-06-19 04:31:08,FAKE,2882033090,241,2882033331,2898275633
2025-06-19 04:31:10,REAL,2882033331,542,2882033873,2898276175
2025-06-19 04:31:12,REAL,2882033873,485,2882034358,2898276660
2025-06-19 04:31:14,FAKE,2882034358,243,2882034601,2898277145
2025-06-19 04:31:16,FAKE,2882034601,238,2882034839,2898277638
2025-06-19 04:31:18,FAKE,2882034839,238,2882035077,2898278179
2025-06-19 04:31:20,FAKE,2882035077,238,2882035315,2898278663
2025-06-19 04:31:22,FAKE,2882035315,238,2882035553,2898288464
2025-06-19 04:31:24,REAL,2882035553,10450,2882046003,2898298914
2025-06-19 04:31:26,REAL,2882046003,10247,2882056250,2898309161
2025-06-19 04:31:28,REAL,2882056250,10256,2882066506,2898319417
2025-06-19 04:31:30,REAL,2882066506,10253,2882076759,2898329670
2025-06-19 04:31:32,REAL,2882076759,10254,2882087013,2898339924
2025-06-19 04:31:34,FAKE,2882087013,243,2882087256,2898350173
2025-06-19 04:31:36,REAL,2882087256,7284,2882094540,2898357457
2025-06-19 04:31:38,FAKE,2882094540,238,2882094778,2898357943
2025-06-19 04:31:40,FAKE,2882094778,244,2882095022,2898358427
2025-06-19 04:31:42,REAL,2882095022,484,2882095506,2898358911
2025-06-19 04:31:44,FAKE,2882095506,244,2882095750,2898359387
2025-06-19 04:31:46,REAL,2882095750,485,2882096235,2898359872
2025-06-19 04:31:48,REAL,2882096235,491,2882096726,2898360363
2025-06-19 04:31:50,REAL,2882096726,485,2882097211,2898360848
2025-06-19 04:31:52,FAKE,2882097211,241,2882097452,2898361388
2025-06-19 04:31:54,REAL,2882097452,481,2882097933,2898361869
2025-06-19 04:31:56,FAKE,2882097933,238,2882098171,2898362408
2025-06-19 04:31:58,FAKE,2882098171,241,2882098412,2898362888
2025-06-19 04:32:00,REAL,2882098412,481,2882098893,2898363369
2025-06-19 04:32:02,REAL,2882098893,485,2882099378,2898363854
2025-06-19 04:32:04,FAKE,2882099378,243,2882099621,2898364341
2025-06-19 04:32:06,FAKE,2882099621,243,2882099864,2898364816
2025-06-19 04:32:08,REAL,2882099864,483,2882100347,2898365299
2025-06-19 04:32:10,FAKE,2882100347,238,2882100585,2898365790
2025-06-19 04:32:12,FAKE,2882100585,244,2882100829,2898366283
2025-06-19 04:32:14,REAL,2882100829,480,2882101309,2898366763
2025-06-19 04:32:16,REAL,2882101309,478,2882101787,2898367241
2025-06-19 04:32:18,REAL,2882101787,486,2882102273,2898367727
2025-06-19 04:32:20,FAKE,2882102273,244,2882102517,2898378528
2025-06-19 04:32:22,REAL,2882102517,10251,2882112768,2898388779
2025-06-19 04:32:24,REAL,2882112768,10920,2882123688,2898399699
2025-06-19 04:32:26,FAKE,2882123688,238,2882123926,2898409407
2025-06-19 04:32:28,REAL,2882123926,10250,2882134176,2898419657
2025-06-19 04:32:30,FAKE,2882134176,241,2882134417,2898429909
2025-06-19 04:32:32,FAKE,2882134417,241,2882134658,2898440163
2025-06-19 04:32:34,REAL,2882134658,6365,2882141023,2898446528
2025-06-19 04:32:36,FAKE,2882141023,241,2882141264,2898447016
2025-06-19 04:32:38,FAKE,2882141264,241,2882141505,2898447507
2025-06-19 04:32:40,FAKE,2882141505,241,2882141746,2898448000
2025-06-19 04:32:42,REAL,2882141746,489,2882142235,2898448489
2025-06-19 04:32:44,REAL,2882142235,486,2882142721,2898448975
2025-06-19 04:32:46,REAL,2882142721,482,2882143203,2898449457
2025-06-19 04:32:48,REAL,2882143203,485,2882143688,2898449942
2025-06-19 04:32:50,REAL,2882143688,482,2882144170,2898450424
2025-06-19 04:32:52,REAL,2882144170,479,2882144649,2898450903
2025-06-19 04:32:54,REAL,2882144649,481,2882145130,2898451384
2025-06-19 04:32:56,FAKE,2882145130,244,2882145374,2898451872
2025-06-19 04:32:58,FAKE,2882145374,241,2882145615,2898452416
2025-06-19 04:33:00,FAKE,2882145615,241,2882145856,2898452963
2025-06-19 04:33:02,FAKE,2882145856,238,2882146094,2898453446
2025-06-19 04:33:04,REAL,2882146094,485,2882146579,2898453931
2025-06-19 04:33:06,REAL,2882146579,484,2882147063,2898454415
2025-06-19 04:33:08,FAKE,2882147063,243,2882147306,2898454907
2025-06-19 04:33:10,REAL,2882147306,491,2882147797,2898455398
2025-06-19 04:33:12,REAL,2882147797,487,2882148284,2898455885
2025-06-19 04:33:14,FAKE,2882148284,243,2882148527,2898456372
2025-06-19 04:33:16,REAL,2882148527,482,2882149009,2898456854
2025-06-19 04:33:18,REAL,2882149009,485,2882149494,2898457339
2025-06-19 04:33:20,REAL,2882149494,487,2882149981,2898457826
2025-06-19 04:33:22,REAL,2882149981,491,2882150472,2898458317
2025-06-19 04:33:24,REAL,2882150472,482,2882150954,2898458799
2025-06-19 04:33:26,REAL,2882150954,480,2882151434,2898459279
2025-06-19 04:33:28,REAL,2882151434,6811,2882158245,2898466090
2025-06-19 04:33:30,REAL,2882158245,11109,2882169354,2898477199
2025-06-19 04:33:32,REAL,2882169354,10325,2882179679,2898487524
2025-06-19 04:33:34,REAL,2882179679,10246,2882189925,2898497770
2025-06-19 04:33:36,REAL,2882189925,10244,2882200169,2898508014
2025-06-19 04:33:38,FAKE,2882200169,238,2882200407,2898518331
2025-06-19 04:33:40,FAKE,2882200407,244,2882200651,2898528577
2025-06-19 04:33:42,REAL,2882200651,9987,2882210638,2898538564
2025-06-19 04:33:44,REAL,2882210638,483,2882211121,2898539047
2025-06-19 04:33:46,REAL,2882211121,477,2882211598,2898539524
2025-06-19 04:33:48,REAL,2882211598,477,2882212075,2898540001
2025-06-19 04:33:50,REAL,2882212075,477,2882212552,2898540478
2025-06-19 04:33:52,REAL,2882212552,488,2882213040,2898540966
2025-06-19 04:33:54,REAL,2882213040,483,2882213523,2898541449
2025-06-19 04:33:56,REAL,2882213523,490,2882214013,2898541939
2025-06-19 04:33:58,REAL,2882214013,490,2882214503,2898542429
2025-06-19 04:34:00,FAKE,2882214503,244,2882214747,2898542967
2025-06-19 04:34:02,REAL,2882214747,480,2882215227,2898543447
2025-06-19 04:34:04,REAL,2882215227,482,2882215709,2898543929
2025-06-19 04:34:06,REAL,2882215709,482,2882216191,2898544411
2025-06-19 04:34:08,FAKE,2882216191,243,2882216434,2898544951
2025-06-19 04:34:10,REAL,2882216434,484,2882216918,2898545435
2025-06-19 04:34:12,REAL,2882216918,485,2882217403,2898545920
2025-06-19 04:34:14,REAL,2882217403,484,2882217887,2898546404
2025-06-19 04:34:16,REAL,2882217887,477,2882218364,2898546881
2025-06-19 04:34:18,REAL,2882218364,486,2882218850,2898547367
2025-06-19 04:34:20,FAKE,2882218850,238,2882219088,2898547845
2025-06-19 04:34:22,FAKE,2882219088,238,2882219326,2898548331
2025-06-19 04:34:24,REAL,2882219326,486,2882219812,2898548817
2025-06-19 04:34:26,REAL,2882219812,491,2882220303,2898549308
2025-06-19 04:34:28,FAKE,2882220303,241,2882220544,2898549787
2025-06-19 04:34:30,REAL,2882220544,544,2882221088,2898550331
2025-06-19 04:34:32,REAL,2882221088,482,2882221570,2898550813
2025-06-19 04:34:34,REAL,2882221570,489,2882222059,2898551302
2025-06-19 04:34:36,REAL,2882222059,482,2882222541,2898551784
2025-06-19 04:34:38,REAL,2882222541,484,2882223025,2898552268
2025-06-19 04:34:40,FAKE,2882223025,241,2882223266,2898552756
2025-06-19 04:34:42,REAL,2882223266,481,2882223747,2898553237
2025-06-19 04:34:44,FAKE,2882223747,238,2882223985,2898553716
2025-06-19 04:34:46,REAL,2882223985,485,2882224470,2898554201
2025-06-19 04:34:48,FAKE,2882224470,238,2882224708,2898554683
2025-06-19 04:34:50,REAL,2882224708,535,2882225243,2898555218
2025-06-19 04:34:52,FAKE,2882225243,241,2882225484,2898563235
2025-06-19 04:34:54,REAL,2882225484,10776,2882236260,2898574011
2025-06-19 04:34:56,REAL,2882236260,10256,2882246516,2898584267
2025-06-19 04:34:58,REAL,2882246516,10316,2882256832,2898594583
2025-06-19 04:35:00,REAL,2882256832,10253,2882267085,2898604836
2025-06-19 04:35:02,REAL,2882267085,10303,2882277388,2898615139
2025-06-19 04:35:04,FAKE,2882277388,241,2882277629,2898625391
2025-06-19 04:35:06,REAL,2882277629,8738,2882286367,2898634129
2025-06-19 04:35:08,REAL,2882286367,481,2882286848,2898634610
2025-06-19 04:35:10,FAKE,2882286848,238,2882287086,2898635090
2025-06-19 04:35:12,REAL,2882287086,491,2882287577,2898635581
2025-06-19 04:35:14,FAKE,2882287577,238,2882287815,2898636056
2025-06-19 04:35:16,REAL,2882287815,490,2882288305,2898636546
2025-06-19 04:35:18,REAL,2882288305,489,2882288794,2898637035
2025-06-19 04:35:20,REAL,2882288794,485,2882289279,2898637520
2025-06-19 04:35:22,REAL,2882289279,480,2882289759,2898638000
2025-06-19 04:35:24,REAL,2882289759,487,2882290246,2898638487
2025-06-19 04:35:26,FAKE,2882290246,241,2882290487,2898638973
2025-06-19 04:35:28,REAL,2882290487,492,2882290979,2898639465
2025-06-19 04:35:30,REAL,2882290979,494,2882291473,2898639959
2025-06-19 04:35:32,FAKE,2882291473,244,2882291717,2898640558
2025-06-19 04:35:34,REAL,2882291717,491,2882292208,2898641049
2025-06-19 04:35:36,FAKE,2882292208,243,2882292451,2898641535
2025-06-19 04:35:38,REAL,2882292451,484,2882292935,2898642019
2025-06-19 04:35:40,REAL,2882292935,489,2882293424,2898642508
2025-06-19 04:35:42,REAL,2882293424,475,2882293899,2898642983
2025-06-19 04:35:44,REAL,2882293899,483,2882294382,2898643466
2025-06-19 04:35:46,FAKE,2882294382,244,2882294626,2898643957
2025-06-19 04:35:48,FAKE,2882294626,238,2882294864,2898644438
2025-06-19 04:35:50,REAL,2882294864,484,2882295348,2898644922
2025-06-19 04:35:52,REAL,2882295348,479,2882295827,2898645401
2025-06-19 04:35:54,REAL,2882295827,487,2882296314,2898645888
2025-06-19 04:35:56,REAL,2882296314,9400,2882305714,2898655288
2025-06-19 04:35:58,REAL,2882305714,10582,2882316296,2898665870
2025-06-19 04:36:00,REAL,2882316296,10305,2882326601,2898676175
2025-06-19 04:36:02,REAL,2882326601,10257,2882336858,2898686432
2025-06-19 04:36:04,FAKE,2882336858,244,2882337102,2898696750
2025-06-19 04:36:06,REAL,2882337102,10244,2882347346,2898706994
2025-06-19 04:36:08,FAKE,2882347346,238,2882347584,2898717242
2025-06-19 04:36:10,FAKE,2882347584,238,2882347822,2898724655
2025-06-19 04:36:12,REAL,2882347822,491,2882348313,2898725146
2025-06-19 04:36:14,REAL,2882348313,487,2882348800,2898725633
2025-06-19 04:36:16,REAL,2882348800,487,2882349287,2898726120
2025-06-19 04:36:18,FAKE,2882349287,241,2882349528,2898726603
2025-06-19 04:36:20,REAL,2882349528,490,2882350018,2898727093
2025-06-19 04:36:22,REAL,2882350018,493,2882350511,2898727586
2025-06-19 04:36:24,FAKE,2882350511,243,2882350754,2898728077
2025-06-19 04:36:26,REAL,2882350754,487,2882351241,2898728564
2025-06-19 04:36:28,REAL,2882351241,10334,2882361575,2898738898
2025-06-19 04:36:30,FAKE,2882361575,238,2882361813,2898749484
2025-06-19 04:36:32,FAKE,2882361813,243,2882362056,2898759794
2025-06-19 04:36:34,FAKE,2882362056,238,2882362294,2898770117
2025-06-19 04:36:36,REAL,2882362294,10258,2882372552,2898780375
2025-06-19 04:36:38,REAL,2882372552,10075,2882382627,2898790450
2025-06-19 04:36:40,REAL,2882382627,10248,2882392875,2898800698
2025-06-19 04:36:42,REAL,2882392875,6816,2882399691,2898807514
2025-06-19 04:36:44,REAL,2882399691,475,2882400166,2898807989
2025-06-19 04:36:46,REAL,2882400166,483,2882400649,2898808472
2025-06-19 04:36:48,FAKE,2882400649,243,2882400892,2898808951
2025-06-19 04:36:50,REAL,2882400892,481,2882401373,2898809432
2025-06-19 04:36:52,REAL,2882401373,479,2882401852,2898809911
2025-06-19 04:36:54,REAL,2882401852,492,2882402344,2898810403
2025-06-19 04:36:56,FAKE,2882402344,244,2882402588,2898810879
2025-06-19 04:36:58,REAL,2882402588,488,2882403076,2898811367
2025-06-19 04:37:00,FAKE,2882403076,241,2882403317,2898811847
2025-06-19 04:37:02,REAL,2882403317,547,2882403864,2898812394
2025-06-19 04:37:04,REAL,2882403864,481,2882404345,2898812875
2025-06-19 04:37:06,REAL,2882404345,486,2882404831,2898813361
2025-06-19 04:37:08,FAKE,2882404831,241,2882405072,2898813837
2025-06-19 04:37:10,REAL,2882405072,539,2882405611,2898814376
2025-06-19 04:37:12,REAL,2882405611,475,2882406086,2898814851
2025-06-19 04:37:14,REAL,2882406086,479,2882406565,2898815330
2025-06-19 04:37:16,FAKE,2882406565,238,2882406803,2898815810
2025-06-19 04:37:18,FAKE,2882406803,243,2882407046,2898816295
2025-06-19 04:37:20,REAL,2882407046,5445,2882412491,2898821740
2025-06-19 04:37:22,REAL,2882412491,10969,2882423460,2898832709
2025-06-19 04:37:24,REAL,2882423460,10246,2882433706,2898842955
2025-06-19 04:37:26,REAL,2882433706,11354,2882445060,2898854309
2025-06-19 04:37:28,REAL,2882445060,9215,2882454275,2898863524
2025-06-19 04:37:30,REAL,2882454275,10246,2882464521,2898873770
2025-06-19 04:37:32,REAL,2882464521,10246,2882474767,2898884016
2025-06-19 04:37:34,REAL,2882474767,10370,2882485137,2898894386
2025-06-19 04:37:36,REAL,2882485137,879,2882486016,2898895265
2025-06-19 04:37:38,REAL,2882486016,489,2882486505,2898895754
2025-06-19 04:37:40,REAL,2882486505,486,2882486991,2898896240
2025-06-19 04:37:42,REAL,2882486991,485,2882487476,2898896725
2025-06-19 04:37:44,FAKE,2882487476,243,2882487719,2898897208
2025-06-19 04:37:46,REAL,2882487719,485,2882488204,2898897693
2025-06-19 04:37:48,FAKE,2882488204,238,2882488442,2898898179
2025-06-19 04:37:50,REAL,2882488442,538,2882488980,2898898717
2025-06-19 04:37:52,REAL,2882488980,7286,2882496266,2898906003
2025-06-19 04:37:54,REAL,2882496266,13293,2882509559,2898919296
2025-06-19 04:37:56,REAL,2882509559,10249,2882519808,2898929545
2025-06-19 04:37:58,REAL,2882519808,10316,2882530124,2898939861
2025-06-19 04:38:00,REAL,2882530124,10261,2882540385,2898950122
2025-06-19 04:38:02,REAL,2882540385,10254,2882550639,2898960376
2025-06-19 04:38:04,REAL,2882550639,10255,2882560894,2898970631
2025-06-19 04:38:06,REAL,2882560894,10116,2882571010,2898980747
2025-06-19 04:38:08,REAL,2882571010,541,2882571551,2898981288
2025-06-19 04:38:10,FAKE,2882571551,241,2882571792,2898981776
2025-06-19 04:38:12,REAL,2882571792,486,2882572278,2898982262
2025-06-19 04:38:14,REAL,2882572278,489,2882572767,2898982751
2025-06-19 04:38:16,REAL,2882572767,488,2882573255,2898983239
2025-06-19 04:38:18,REAL,2882573255,491,2882573746,2898983730
2025-06-19 04:38:20,REAL,2882573746,538,2882574284,2898984268
2025-06-19 04:38:22,REAL,2882574284,485,2882574769,2898984753
2025-06-19 04:38:24,REAL,2882574769,7420,2882582189,2898992173
2025-06-19 04:38:26,REAL,2882582189,10840,2882593029,2899003013
2025-06-19 04:38:28,REAL,2882593029,10248,2882603277,2899013261
2025-06-19 04:38:30,REAL,2882603277,10261,2882613538,2899023522
2025-06-19 04:38:32,REAL,2882613538,10312,2882623850,2899033834
2025-06-19 04:38:34,FAKE,2882623850,238,2882624088,2899044092
2025-06-19 04:38:36,REAL,2882624088,10260,2882634348,2899054352
2025-06-19 04:38:38,FAKE,2882634348,244,2882634592,2899063874
2025-06-19 04:38:40,REAL,2882634592,544,2882635136,2899064418
2025-06-19 04:38:42,FAKE,2882635136,243,2882635379,2899064903
2025-06-19 04:38:44,REAL,2882635379,1750,2882637129,2899066653
2025-06-19 04:38:46,REAL,2882637129,14882,2882652011,2899081535
2025-06-19 04:38:48,REAL,2882652011,10322,2882662333,2899091857
2025-06-19 04:38:50,REAL,2882662333,10250,2882672583,2899102107
2025-06-19 04:38:52,REAL,2882672583,10321,2882682904,2899112428
2025-06-19 04:38:54,REAL,2882682904,10255,2882693159,2899122683
2025-06-19 04:38:56,REAL,2882693159,10251,2882703410,2899132934
2025-06-19 04:38:58,FAKE,2882703410,244,2882703654,2899143257
2025-06-19 04:39:00,REAL,2882703654,4254,2882707908,2899147511
2025-06-19 04:39:02,FAKE,2882707908,244,2882708152,2899147987
2025-06-19 04:39:04,REAL,2882708152,483,2882708635,2899148470
2025-06-19 04:39:06,FAKE,2882708635,238,2882708873,2899148954
2025-06-19 04:39:08,REAL,2882708873,482,2882709355,2899149436
2025-06-19 04:39:10,REAL,2882709355,478,2882709833,2899149914
2025-06-19 04:39:12,FAKE,2882709833,244,2882710077,2899150459
2025-06-19 04:39:14,REAL,2882710077,545,2882710622,2899151004
2025-06-19 04:39:16,FAKE,2882710622,241,2882710863,2899153743
2025-06-19 04:39:18,REAL,2882710863,11517,2882722380,2899165260
2025-06-19 04:39:20,REAL,2882722380,10313,2882732693,2899175573
2025-06-19 04:39:22,REAL,2882732693,10252,2882742945,2899185825
2025-06-19 04:39:24,FAKE,2882742945,244,2882743189,2899196079
2025-06-19 04:39:26,REAL,2882743189,10245,2882753434,2899206324
2025-06-19 04:39:28,FAKE,2882753434,241,2882753675,2899216576
2025-06-19 04:39:30,FAKE,2882753675,241,2882753916,2899226897
2025-06-19 04:39:32,REAL,2882753916,3594,2882757510,2899230491
2025-06-19 04:39:34,REAL,2882757510,494,2882758004,2899230985
2025-06-19 04:39:36,REAL,2882758004,476,2882758480,2899231461
2025-06-19 04:39:38,REAL,2882758480,483,2882758963,2899231944
2025-06-19 04:39:40,REAL,2882758963,484,2882759447,2899232428
2025-06-19 04:39:42,REAL,2882759447,480,2882759927,2899232908
2025-06-19 04:39:44,REAL,2882759927,537,2882760464,2899233445
2025-06-19 04:39:46,FAKE,2882760464,238,2882760702,2899233987
2025-06-19 04:39:48,REAL,2882760702,492,2882761194,2899234479
2025-06-19 04:39:50,FAKE,2882761194,244,2882761438,2899234956
2025-06-19 04:39:52,FAKE,2882761438,243,2882761681,2899235433
2025-06-19 04:39:54,REAL,2882761681,483,2882762164,2899235916
2025-06-19 04:39:56,REAL,2882762164,489,2882762653,2899236405
2025-06-19 04:39:58,FAKE,2882762653,238,2882762891,2899236899
2025-06-19 04:40:00,REAL,2882762891,478,2882763369,2899237377
2025-06-19 04:40:02,REAL,2882763369,481,2882763850,2899237858
2025-06-19 04:40:04,FAKE,2882763850,244,2882764094,2899238345
2025-06-19 04:40:06,REAL,2882764094,484,2882764578,2899238829
2025-06-19 04:40:08,REAL,2882764578,487,2882765065,2899239316
2025-06-19 04:40:10,REAL,2882765065,485,2882765550,2899239801
2025-06-19 04:40:12,REAL,2882765550,483,2882766033,2899240284
2025-06-19 04:40:14,FAKE,2882766033,243,2882766276,2899240821
2025-06-19 04:40:16,REAL,2882766276,494,2882766770,2899241315
2025-06-19 04:40:18,REAL,2882766770,546,2882767316,2899241861
2025-06-19 04:40:20,FAKE,2882767316,243,2882767559,2899242344
2025-06-19 04:40:22,REAL,2882767559,487,2882768046,2899242831
2025-06-19 04:40:24,REAL,2882768046,482,2882768528,2899243313
2025-06-19 04:40:26,REAL,2882768528,482,2882769010,2899243795
2025-06-19 04:40:28,REAL,2882769010,480,2882769490,2899244275
2025-06-19 04:40:30,REAL,2882769490,485,2882769975,2899244760
2025-06-19 04:40:32,REAL,2882769975,479,2882770454,2899245239
2025-06-19 04:40:34,REAL,2882770454,478,2882770932,2899245717
2025-06-19 04:40:36,FAKE,2882770932,241,2882771173,2899246200
2025-06-19 04:40:38,REAL,2882771173,486,2882771659,2899246686
2025-06-19 04:40:40,REAL,2882771659,486,2882772145,2899247172
2025-06-19 04:40:42,REAL,2882772145,12566,2882784711,2899259738
2025-06-19 04:40:44,FAKE,2882784711,244,2882784955,2899270713
2025-06-19 04:40:46,FAKE,2882784955,244,2882785199,2899280968
2025-06-19 04:40:48,REAL,2882785199,10252,2882795451,2899291220
2025-06-19 04:40:50,REAL,2882795451,10312,2882805763,2899301532
2025-06-19 04:40:52,FAKE,2882805763,241,2882806004,2899311833
2025-06-19 04:40:54,REAL,2882806004,10257,2882816261,2899322090
2025-06-19 04:40:56,REAL,2882816261,6951,2882823212,2899329041
2025-06-19 04:40:58,REAL,2882823212,483,2882823695,2899329524
2025-06-19 04:41:00,REAL,2882823695,483,2882824178,2899330007
2025-06-19 04:41:02,FAKE,2882824178,243,2882824421,2899335055
2025-06-19 04:41:04,REAL,2882824421,10782,2882835203,2899345837
2025-06-19 04:41:06,REAL,2882835203,10325,2882845528,2899356162
2025-06-19 04:41:08,FAKE,2882845528,238,2882845766,2899366413
2025-06-19 04:41:10,FAKE,2882845766,241,2882846007,2899376666
2025-06-19 04:41:12,FAKE,2882846007,238,2882846245,2899386916
2025-06-19 04:41:14,FAKE,2882846245,238,2882846483,2899397172
2025-06-19 04:41:16,REAL,2882846483,10250,2882856733,2899407422
2025-06-19 04:41:18,REAL,2882856733,1676,2882858409,2899409098
2025-06-19 04:41:20,REAL,2882858409,489,2882858898,2899409587
2025-06-19 04:41:22,FAKE,2882858898,241,2882859139,2899410068
2025-06-19 04:41:24,REAL,2882859139,535,2882859674,2899410603
2025-06-19 04:41:26,REAL,2882859674,486,2882860160,2899411089
2025-06-19 04:41:28,REAL,2882860160,484,2882860644,2899411573
2025-06-19 04:41:30,REAL,2882860644,489,2882861133,2899412062
2025-06-19 04:41:32,REAL,2882861133,541,2882861674,2899412603
2025-06-19 04:41:34,REAL,2882861674,481,2882862155,2899413084
2025-06-19 04:41:36,REAL,2882862155,485,2882862640,2899413569
2025-06-19 04:41:38,REAL,2882862640,482,2882863122,2899414051
2025-06-19 04:41:40,FAKE,2882863122,241,2882863363,2899414543
2025-06-19 04:41:42,REAL,2882863363,492,2882863855,2899415035
2025-06-19 04:41:44,FAKE,2882863855,243,2882864098,2899415511
2025-06-19 04:41:46,REAL,2882864098,492,2882864590,2899416003
2025-06-19 04:41:48,REAL,2882864590,480,2882865070,2899416483
2025-06-19 04:41:50,REAL,2882865070,486,2882865556,2899416969
2025-06-19 04:41:52,FAKE,2882865556,244,2882865800,2899417457
2025-06-19 04:41:54,FAKE,2882865800,243,2882866043,2899417937
2025-06-19 04:41:56,REAL,2882866043,540,2882866583,2899418477
2025-06-19 04:41:58,FAKE,2882866583,244,2882866827,2899418957
2025-06-19 04:42:00,REAL,2882866827,539,2882867366,2899419496
2025-06-19 04:42:02,REAL,2882867366,485,2882867851,2899419981
2025-06-19 04:42:04,REAL,2882867851,477,2882868328,2899420458
2025-06-19 04:42:06,REAL,2882868328,482,2882868810,2899420940
2025-06-19 04:42:08,FAKE,2882868810,243,2882869053,2899421430
2025-06-19 04:42:10,REAL,2882869053,491,2882869544,2899421921
2025-06-19 04:42:12,REAL,2882869544,12377,2882881921,2899434298
2025-06-19 04:42:14,REAL,2882881921,10253,2882892174,2899444551
2025-06-19 04:42:16,REAL,2882892174,10319,2882902493,2899454870
2025-06-19 04:42:18,REAL,2882902493,10252,2882912745,2899465122
2025-06-19 04:42:20,REAL,2882912745,10245,2882922990,2899475367
2025-06-19 04:42:22,REAL,2882922990,10314,2882933304,2899485681
2025-06-19 04:42:24,REAL,2882933304,10250,2882943554,2899495931
2025-06-19 04:42:26,REAL,2882943554,5231,2882948785,2899501162
2025-06-19 04:42:28,REAL,2882948785,478,2882949263,2899501640
2025-06-19 04:42:30,FAKE,2882949263,243,2882949506,2899502124
2025-06-19 04:42:32,REAL,2882949506,481,2882949987,2899502605
2025-06-19 04:42:34,FAKE,2882949987,244,2882950231,2899503087
2025-06-19 04:42:36,REAL,2882950231,539,2882950770,2899503626
2025-06-19 04:42:38,REAL,2882950770,489,2882951259,2899504115
2025-06-19 04:42:40,FAKE,2882951259,244,2882951503,2899504593
2025-06-19 04:42:42,FAKE,2882951503,241,2882951744,2899505685
2025-06-19 04:42:44,REAL,2882951744,15062,2882966806,2899520747
2025-06-19 04:42:46,FAKE,2882966806,238,2882967044,2899531068
2025-06-19 04:42:48,REAL,2882967044,10251,2882977295,2899541319
2025-06-19 04:42:50,REAL,2882977295,10259,2882987554,2899551578
2025-06-19 04:42:52,REAL,2882987554,10259,2882997813,2899561837
2025-06-19 04:42:54,FAKE,2882997813,241,2882998054,2899572151
2025-06-19 04:42:56,FAKE,2882998054,238,2882998292,2899582409
2025-06-19 04:42:58,REAL,2882998292,4640,2883002932,2899587049
2025-06-19 04:43:00,FAKE,2883002932,238,2883003170,2899587528
2025-06-19 04:43:02,REAL,2883003170,491,2883003661,2899588019
2025-06-19 04:43:04,REAL,2883003661,481,2883004142,2899588500
2025-06-19 04:43:06,FAKE,2883004142,241,2883004383,2899588982
2025-06-19 04:43:08,REAL,2883004383,490,2883004873,2899589472
2025-06-19 04:43:10,REAL,2883004873,480,2883005353,2899589952
2025-06-19 04:43:12,REAL,2883005353,480,2883005833,2899590432
2025-06-19 04:43:14,REAL,2883005833,486,2883006319,2899590918
2025-06-19 04:43:16,REAL,2883006319,541,2883006860,2899591459
2025-06-19 04:43:18,FAKE,2883006860,238,2883007098,2899591944
2025-06-19 04:43:20,REAL,2883007098,485,2883007583,2899592429
2025-06-19 04:43:22,FAKE,2883007583,244,2883007827,2899592914
2025-06-19 04:43:24,REAL,2883007827,485,2883008312,2899593399
2025-06-19 04:43:26,REAL,2883008312,485,2883008797,2899593884
2025-06-19 04:43:28,REAL,2883008797,541,2883009338,2899594425
2025-06-19 04:43:30,FAKE,2883009338,241,2883009579,2899594918
2025-06-19 04:43:32,FAKE,2883009579,241,2883009820,2899595404
2025-06-19 04:43:34,REAL,2883009820,487,2883010307,2899595891
2025-06-19 04:43:36,REAL,2883010307,483,2883010790,2899596374
2025-06-19 04:43:38,REAL,2883010790,483,2883011273,2899596857
2025-06-19 04:43:40,FAKE,2883011273,241,2883011514,2899597346
2025-06-19 04:43:42,REAL,2883011514,487,2883012001,2899597833
2025-06-19 04:43:44,REAL,2883012001,485,2883012486,2899598318
2025-06-19 04:43:46,FAKE,2883012486,241,2883012727,2899598807
2025-06-19 04:43:48,REAL,2883012727,487,2883013214,2899599294
2025-06-19 04:43:50,FAKE,2883013214,241,2883013455,2899599779
2025-06-19 04:43:52,REAL,2883013455,478,2883013933,2899600257
2025-06-19 04:43:54,FAKE,2883013933,244,2883014177,2899600743
2025-06-19 04:43:56,REAL,2883014177,486,2883014663,2899601229
2025-06-19 04:43:58,FAKE,2883014663,244,2883014907,2899601772
2025-06-19 04:44:00,REAL,2883014907,475,2883015382,2899602247
2025-06-19 04:44:02,REAL,2883015382,485,2883015867,2899602732
2025-06-19 04:44:04,REAL,2883015867,488,2883016355,2899603220
2025-06-19 04:44:06,REAL,2883016355,480,2883016835,2899603700
2025-06-19 04:44:08,REAL,2883016835,481,2883017316,2899604181
2025-06-19 04:44:10,REAL,2883017316,489,2883017805,2899604670
2025-06-19 04:44:12,REAL,2883017805,480,2883018285,2899605150
2025-06-19 04:44:14,FAKE,2883018285,238,2883018523,2899605634
2025-06-19 04:44:16,REAL,2883018523,539,2883019062,2899606173
2025-06-19 04:44:18,REAL,2883019062,488,2883019550,2899606661
2025-06-19 04:44:20,FAKE,2883019550,243,2883019793,2899607149
2025-06-19 04:44:22,FAKE,2883019793,241,2883020034,2899607640
2025-06-19 04:44:24,REAL,2883020034,483,2883020517,2899608123
2025-06-19 04:44:26,REAL,2883020517,484,2883021001,2899608607
2025-06-19 04:44:28,REAL,2883021001,478,2883021479,2899609085
2025-06-19 04:44:30,REAL,2883021479,490,2883021969,2899609575
2025-06-19 04:44:32,REAL,2883021969,479,2883022448,2899610054
2025-06-19 04:44:34,REAL,2883022448,487,2883022935,2899610541
2025-06-19 04:44:36,FAKE,2883022935,241,2883023176,2899611022
2025-06-19 04:44:38,REAL,2883023176,538,2883023714,2899611560
2025-06-19 04:44:40,FAKE,2883023714,243,2883023957,2899612045
2025-06-19 04:44:42,REAL,2883023957,483,2883024440,2899612528
2025-06-19 04:44:44,REAL,2883024440,482,2883024922,2899613010
2025-06-19 04:44:46,REAL,2883024922,490,2883025412,2899613500
2025-06-19 04:44:48,REAL,2883025412,477,2883025889,2899613977
2025-06-19 04:44:50,REAL,2883025889,485,2883026374,2899614462
2025-06-19 04:44:52,FAKE,2883026374,244,2883026618,2899614950
2025-06-19 04:44:54,REAL,2883026618,483,2883027101,2899615433
2025-06-19 04:44:56,REAL,2883027101,480,2883027581,2899615913
2025-06-19 04:44:58,REAL,2883027581,480,2883028061,2899616393
2025-06-19 04:45:00,REAL,2883028061,489,2883028550,2899616882
2025-06-19 04:45:02,FAKE,2883028550,243,2883028793,2899617419
2025-06-19 04:45:04,FAKE,2883028793,243,2883029036,2899617902
2025-06-19 04:45:06,REAL,2883029036,483,2883029519,2899618385
2025-06-19 04:45:08,REAL,2883029519,487,2883030006,2899618872
2025-06-19 04:45:10,REAL,2883030006,4394,2883034400,2899623266
2025-06-19 04:45:12,REAL,2883034400,11446,2883045846,2899634712
2025-06-19 04:45:14,REAL,2883045846,10249,2883056095,2899644961
2025-06-19 04:45:16,FAKE,2883056095,238,2883056333,2899655277
2025-06-19 04:45:18,REAL,2883056333,10249,2883066582,2899665526
2025-06-19 04:45:20,REAL,2883066582,10303,2883076885,2899675829
2025-06-19 04:45:22,FAKE,2883076885,241,2883077126,2899686083
2025-06-19 04:45:24,FAKE,2883077126,243,2883077369,2899696336
2025-06-19 04:45:26,REAL,2883077369,2143,2883079512,2899698479
2025-06-19 04:45:28,REAL,2883079512,480,2883079992,2899698959
2025-06-19 04:45:30,REAL,2883079992,489,2883080481,2899699448
2025-06-19 04:45:32,REAL,2883080481,486,2883080967,2899699934
2025-06-19 04:45:34,FAKE,2883080967,241,2883081208,2899700411
2025-06-19 04:45:36,FAKE,2883081208,238,2883081446,2899700902
2025-06-19 04:45:38,REAL,2883081446,482,2883081928,2899701384
2025-06-19 04:45:40,FAKE,2883081928,243,2883082171,2899701868
2025-06-19 04:45:42,REAL,2883082171,485,2883082656,2899702353
2025-06-19 04:45:44,REAL,2883082656,490,2883083146,2899702843
2025-06-19 04:45:46,FAKE,2883083146,241,2883083387,2899703324
2025-06-19 04:45:48,REAL,2883083387,483,2883083870,2899703807
2025-06-19 04:45:50,FAKE,2883083870,238,2883084108,2899704299
2025-06-19 04:45:52,REAL,2883084108,479,2883084587,2899704778
2025-06-19 04:45:54,REAL,2883084587,483,2883085070,2899705261
2025-06-19 04:45:56,REAL,2883085070,540,2883085610,2899705801
2025-06-19 04:45:58,REAL,2883085610,478,2883086088,2899706279
2025-06-19 04:46:00,FAKE,2883086088,238,2883086326,2899706818
2025-06-19 04:46:02,REAL,2883086326,482,2883086808,2899707300
2025-06-19 04:46:04,REAL,2883086808,13839,2883100647,2899721139
2025-06-19 04:46:06,REAL,2883100647,10246,2883110893,2899731385
2025-06-19 04:46:08,FAKE,2883110893,238,2883111131,2899741635
2025-06-19 04:46:10,REAL,2883111131,10308,2883121439,2899751943
2025-06-19 04:46:12,REAL,2883121439,10183,2883131622,2899762126
2025-06-19 04:46:14,FAKE,2883131622,244,2883131866,2899772382
2025-06-19 04:46:16,FAKE,2883131866,238,2883132104,2899782634
2025-06-19 04:46:18,REAL,2883132104,6027,2883138131,2899788661
2025-06-19 04:46:20,FAKE,2883138131,243,2883138374,2899789149
2025-06-19 04:46:22,FAKE,2883138374,241,2883138615,2899789628
2025-06-19 04:46:24,REAL,2883138615,486,2883139101,2899790114
2025-06-19 04:46:26,REAL,2883139101,491,2883139592,2899790605
2025-06-19 04:46:28,REAL,2883139592,475,2883140067,2899791080
2025-06-19 04:46:30,REAL,2883140067,494,2883140561,2899791574
2025-06-19 04:46:32,REAL,2883140561,484,2883141045,2899792058
2025-06-19 04:46:34,REAL,2883141045,491,2883141536,2899792549
2025-06-19 04:46:36,REAL,2883141536,482,2883142018,2899793031
2025-06-19 04:46:38,REAL,2883142018,475,2883142493,2899793506
2025-06-19 04:46:40,FAKE,2883142493,238,2883142731,2899794042
2025-06-19 04:46:42,REAL,2883142731,487,2883143218,2899794529
2025-06-19 04:46:44,REAL,2883143218,482,2883143700,2899795011
2025-06-19 04:46:46,REAL,2883143700,479,2883144179,2899795490
2025-06-19 04:46:48,REAL,2883144179,537,2883144716,2899796027
2025-06-19 04:46:50,REAL,2883144716,487,2883145203,2899796514
2025-06-19 04:46:52,REAL,2883145203,479,2883145682,2899796993
2025-06-19 04:46:54,REAL,2883145682,484,2883146166,2899797477
2025-06-19 04:46:56,REAL,2883146166,482,2883146648,2899797959
2025-06-19 04:46:58,REAL,2883146648,481,2883147129,2899798440
2025-06-19 04:47:00,FAKE,2883147129,244,2883147373,2899798916
2025-06-19 04:47:02,FAKE,2883147373,243,2883147616,2899799409
2025-06-19 04:47:04,REAL,2883147616,483,2883148099,2899799892
2025-06-19 04:47:06,FAKE,2883148099,243,2883148342,2899800374
2025-06-19 04:47:08,REAL,2883148342,485,2883148827,2899800859
2025-06-19 04:47:10,REAL,2883148827,489,2883149316,2899801348
2025-06-19 04:47:12,REAL,2883149316,483,2883149799,2899801831
2025-06-19 04:47:14,REAL,2883149799,481,2883150280,2899802312
2025-06-19 04:47:16,FAKE,2883150280,244,2883150524,2899802798
2025-06-19 04:47:18,REAL,2883150524,487,2883151011,2899803285
2025-06-19 04:47:20,REAL,2883151011,481,2883151492,2899803766
2025-06-19 04:47:22,REAL,2883151492,488,2883151980,2899804254
2025-06-19 04:47:24,REAL,2883151980,531,2883152511,2899804785
2025-06-19 04:47:26,REAL,2883152511,486,2883152997,2899805271
2025-06-19 04:47:28,FAKE,2883152997,244,2883153241,2899805763
2025-06-19 04:47:30,REAL,2883153241,481,2883153722,2899806244
2025-06-19 04:47:32,REAL,2883153722,485,2883154207,2899806729
2025-06-19 04:47:34,REAL,2883154207,540,2883154747,2899807269
2025-06-19 04:47:36,REAL,2883154747,490,2883155237,2899807759
2025-06-19 04:47:38,REAL,2883155237,483,2883155720,2899808242
2025-06-19 04:47:40,REAL,2883155720,484,2883156204,2899808726
2025-06-19 04:47:42,FAKE,2883156204,238,2883156442,2899809208
2025-06-19 04:47:44,REAL,2883156442,478,2883156920,2899809686
2025-06-19 04:47:46,REAL,2883156920,483,2883157403,2899810169
2025-06-19 04:47:48,REAL,2883157403,479,2883157882,2899810648
2025-06-19 04:47:50,REAL,2883157882,476,2883158358,2899811124
2025-06-19 04:47:52,REAL,2883158358,479,2883158837,2899811603
2025-06-19 04:47:54,REAL,2883158837,486,2883159323,2899812089
2025-06-19 04:47:56,REAL,2883159323,481,2883159804,2899812570
2025-06-19 04:47:58,REAL,2883159804,490,2883160294,2899813060
2025-06-19 04:48:00,REAL,2883160294,479,2883160773,2899813539
2025-06-19 04:48:02,FAKE,2883160773,244,2883161017,2899814026
2025-06-19 04:48:04,FAKE,2883161017,238,2883161255,2899814565
2025-06-19 04:48:06,REAL,2883161255,547,2883161802,2899815112
2025-06-19 04:48:08,REAL,2883161802,487,2883162289,2899815599
2025-06-19 04:48:10,FAKE,2883162289,241,2883162530,2899816080
2025-06-19 04:48:12,FAKE,2883162530,243,2883162773,2899816564
2025-06-19 04:48:14,REAL,2883162773,483,2883163256,2899817047
2025-06-19 04:48:16,FAKE,2883163256,244,2883163500,2899817523
2025-06-19 04:48:18,REAL,2883163500,490,2883163990,2899818013
2025-06-19 04:48:20,REAL,2883163990,482,2883164472,2899818495
2025-06-19 04:48:22,FAKE,2883164472,238,2883164710,2899818979
2025-06-19 04:48:24,FAKE,2883164710,241,2883164951,2899819462
2025-06-19 04:48:26,REAL,2883164951,485,2883165436,2899819947
2025-06-19 04:48:28,REAL,2883165436,479,2883165915,2899820426
2025-06-19 04:48:30,REAL,2883165915,482,2883166397,2899820908
2025-06-19 04:48:32,REAL,2883166397,486,2883166883,2899821394
2025-06-19 04:48:34,REAL,2883166883,540,2883167423,2899821934
2025-06-19 04:48:36,REAL,2883167423,480,2883167903,2899822414
2025-06-19 04:48:38,REAL,2883167903,478,2883168381,2899822892
2025-06-19 04:48:40,FAKE,2883168381,243,2883168624,2899823380
2025-06-19 04:48:42,FAKE,2883168624,244,2883168868,2899823863
2025-06-19 04:48:44,FAKE,2883168868,238,2883169106,2899824347
2025-06-19 04:48:46,REAL,2883169106,483,2883169589,2899824830
2025-06-19 04:48:48,FAKE,2883169589,241,2883169830,2899825316
2025-06-19 04:48:50,REAL,2883169830,537,2883170367,2899825853
2025-06-19 04:48:52,FAKE,2883170367,241,2883170608,2899826335
2025-06-19 04:48:54,FAKE,2883170608,244,2883170852,2899826817
2025-06-19 04:48:56,REAL,2883170852,491,2883171343,2899827308
2025-06-19 04:48:58,FAKE,2883171343,241,2883171584,2899827791
2025-06-19 04:49:00,REAL,2883171584,482,2883172066,2899828273
2025-06-19 04:49:02,REAL,2883172066,490,2883172556,2899828763
2025-06-19 04:49:04,FAKE,2883172556,241,2883172797,2899829240
2025-06-19 04:49:06,REAL,2883172797,537,2883173334,2899829777
2025-06-19 04:49:08,REAL,2883173334,488,2883173822,2899830265
2025-06-19 04:49:10,REAL,2883173822,486,2883174308,2899830751
2025-06-19 04:49:12,REAL,2883174308,486,2883174794,2899831237
2025-06-19 04:49:14,REAL,2883174794,487,2883175281,2899831724
2025-06-19 04:49:16,FAKE,2883175281,243,2883175524,2899832216
2025-06-19 04:49:18,FAKE,2883175524,244,2883175768,2899832705
2025-06-19 04:49:20,REAL,2883175768,490,2883176258,2899833195
2025-06-19 04:49:22,REAL,2883176258,11376,2883187634,2899844571
2025-06-19 04:49:24,REAL,2883187634,11633,2883199267,2899856204
2025-06-19 04:49:26,FAKE,2883199267,243,2883199510,2899866456
2025-06-19 04:49:28,REAL,2883199510,10316,2883209826,2899876772
2025-06-19 04:49:30,REAL,2883209826,10254,2883220080,2899887026
2025-06-19 04:49:32,REAL,2883220080,10243,2883230323,2899897269
2025-06-19 04:49:34,REAL,2883230323,10314,2883240637,2899907583
2025-06-19 04:49:36,REAL,2883240637,7814,2883248451,2899915397
2025-06-19 04:49:38,FAKE,2883248451,243,2883248694,2899915878
2025-06-19 04:49:40,REAL,2883248694,476,2883249170,2899916354
2025-06-19 04:49:42,REAL,2883249170,490,2883249660,2899916844
2025-06-19 04:49:44,REAL,2883249660,493,2883250153,2899917337
2025-06-19 04:49:46,REAL,2883250153,484,2883250637,2899917821
2025-06-19 04:49:48,REAL,2883250637,482,2883251119,2899918303
2025-06-19 04:49:50,REAL,2883251119,485,2883251604,2899918788
2025-06-19 04:49:52,REAL,2883251604,535,2883252139,2899919323
2025-06-19 04:49:54,REAL,2883252139,482,2883252621,2899919805
2025-06-19 04:49:56,FAKE,2883252621,244,2883252865,2899920287
2025-06-19 04:49:58,FAKE,2883252865,243,2883253108,2899920781
2025-06-19 04:50:00,REAL,2883253108,478,2883253586,2899921259
2025-06-19 04:50:02,FAKE,2883253586,238,2883253824,2899921746
2025-06-19 04:50:04,FAKE,2883253824,243,2883254067,2899922232
2025-06-19 04:50:06,REAL,2883254067,492,2883254559,2899922724
2025-06-19 04:50:08,FAKE,2883254559,241,2883254800,2899923208
2025-06-19 04:50:10,REAL,2883254800,477,2883255277,2899923685
2025-06-19 04:50:12,REAL,2883255277,493,2883255770,2899924178
2025-06-19 04:50:14,REAL,2883255770,484,2883256254,2899924662
2025-06-19 04:50:16,REAL,2883256254,544,2883256798,2899925206
2025-06-19 04:50:18,FAKE,2883256798,241,2883257039,2899925698
2025-06-19 04:50:20,FAKE,2883257039,238,2883257277,2899926174
2025-06-19 04:50:22,REAL,2883257277,543,2883257820,2899926717
2025-06-19 04:50:24,FAKE,2883257820,241,2883258061,2899927197
2025-06-19 04:50:26,REAL,2883258061,478,2883258539,2899927675
2025-06-19 04:50:28,REAL,2883258539,483,2883259022,2899928158
2025-06-19 04:50:30,REAL,2883259022,486,2883259508,2899928644
2025-06-19 04:50:32,FAKE,2883259508,241,2883259749,2899929130
2025-06-19 04:50:34,FAKE,2883259749,238,2883259987,2899929610
2025-06-19 04:50:36,REAL,2883259987,482,2883260469,2899930092
2025-06-19 04:50:38,REAL,2883260469,474,2883260943,2899930566
2025-06-19 04:50:40,REAL,2883260943,483,2883261426,2899931049
2025-06-19 04:50:42,REAL,2883261426,13432,2883274858,2899944481
2025-06-19 04:50:44,REAL,2883274858,10314,2883285172,2899954795
2025-06-19 04:50:46,REAL,2883285172,10248,2883295420,2899965043
2025-06-19 04:50:48,REAL,2883295420,10321,2883305741,2899975364
2025-06-19 04:50:50,REAL,2883305741,10254,2883315995,2899985618
2025-06-19 04:50:52,REAL,2883315995,10248,2883326243,2899995866
2025-06-19 04:50:54,REAL,2883326243,10317,2883336560,2900006183
2025-06-19 04:50:56,REAL,2883336560,6297,2883342857,2900012480
2025-06-19 04:50:58,REAL,2883342857,480,2883343337,2900012960
2025-06-19 04:51:00,REAL,2883343337,542,2883343879,2900013502
2025-06-19 04:51:02,FAKE,2883343879,241,2883344120,2900013994
2025-06-19 04:51:04,REAL,2883344120,488,2883344608,2900014482
2025-06-19 04:51:06,FAKE,2883344608,244,2883344852,2900014964
2025-06-19 04:51:08,FAKE,2883344852,244,2883345096,2900015443
2025-06-19 04:51:10,REAL,2883345096,539,2883345635,2900015982
2025-06-19 04:51:12,REAL,2883345635,490,2883346125,2900016472
2025-06-19 04:51:14,REAL,2883346125,488,2883346613,2900016960
2025-06-19 04:51:16,REAL,2883346613,481,2883347094,2900017441
2025-06-19 04:51:18,REAL,2883347094,481,2883347575,2900017922
2025-06-19 04:51:20,REAL,2883347575,489,2883348064,2900018411
2025-06-19 04:51:22,REAL,2883348064,487,2883348551,2900018898
2025-06-19 04:51:24,REAL,2883348551,477,2883349028,2900019375
2025-06-19 04:51:26,REAL,2883349028,484,2883349512,2900019859
2025-06-19 04:51:28,REAL,2883349512,488,2883350000,2900020347
2025-06-19 04:51:30,FAKE,2883350000,243,2883350243,2900020837
2025-06-19 04:51:32,FAKE,2883350243,238,2883350481,2900021318
2025-06-19 04:51:34,REAL,2883350481,487,2883350968,2900021805
2025-06-19 04:51:36,REAL,2883350968,484,2883351452,2900022289
2025-06-19 04:51:38,REAL,2883351452,482,2883351934,2900022771
2025-06-19 04:51:40,REAL,2883351934,487,2883352421,2900023258
2025-06-19 04:51:42,REAL,2883352421,587,2883353008,2900023845
2025-06-19 04:51:44,FAKE,2883353008,244,2883353252,2900024325
2025-06-19 04:51:46,REAL,2883353252,485,2883353737,2900024810
2025-06-19 04:51:48,REAL,2883353737,478,2883354215,2900025288
2025-06-19 04:51:50,REAL,2883354215,481,2883354696,2900025769
2025-06-19 04:51:52,FAKE,2883354696,244,2883354940,2900026262
2025-06-19 04:51:54,REAL,2883354940,480,2883355420,2900026742
2025-06-19 04:51:56,REAL,2883355420,489,2883355909,2900027231
2025-06-19 04:51:58,REAL,2883355909,483,2883356392,2900027714
2025-06-19 04:52:00,FAKE,2883356392,244,2883356636,2900028205
2025-06-19 04:52:02,FAKE,2883356636,241,2883356877,2900028696
2025-06-19 04:52:04,FAKE,2883356877,244,2883357121,2900029176
2025-06-19 04:52:06,REAL,2883357121,479,2883357600,2900029655
2025-06-19 04:52:08,FAKE,2883357600,243,2883357843,2900030141
2025-06-19 04:52:10,REAL,2883357843,492,2883358335,2900030633
2025-06-19 04:52:12,REAL,2883358335,549,2883358884,2900031182
2025-06-19 04:52:14,REAL,2883358884,478,2883359362,2900031660
2025-06-19 04:52:16,REAL,2883359362,487,2883359849,2900032147
2025-06-19 04:52:18,REAL,2883359849,481,2883360330,2900032628
2025-06-19 04:52:20,FAKE,2883360330,238,2883360568,2900033114
2025-06-19 04:52:22,REAL,2883360568,481,2883361049,2900033595
2025-06-19 04:52:24,FAKE,2883361049,241,2883361290,2900034077
2025-06-19 04:52:26,REAL,2883361290,538,2883361828,2900034615
2025-06-19 04:52:28,FAKE,2883361828,241,2883362069,2900035106
2025-06-19 04:52:30,FAKE,2883362069,244,2883362313,2900035596
2025-06-19 04:52:32,REAL,2883362313,7498,2883369811,2900043094
2025-06-19 04:52:34,REAL,2883369811,10987,2883380798,2900054081
2025-06-19 04:52:36,REAL,2883380798,10249,2883391047,2900064330
2025-06-19 04:52:38,REAL,2883391047,10315,2883401362,2900074645
2025-06-19 04:52:40,REAL,2883401362,10252,2883411614,2900084897
2025-06-19 04:52:42,REAL,2883411614,10249,2883421863,2900095146
2025-06-19 04:52:44,REAL,2883421863,10321,2883432184,2900105467
2025-06-19 04:52:46,FAKE,2883432184,243,2883432427,2900114789
2025-06-19 04:52:48,FAKE,2883432427,243,2883432670,2900115270
2025-06-19 04:52:50,REAL,2883432670,475,2883433145,2900115745
2025-06-19 04:52:52,FAKE,2883433145,238,2883433383,2900116226
2025-06-19 04:52:54,REAL,2883433383,489,2883433872,2900116715
2025-06-19 04:52:56,REAL,2883433872,481,2883434353,2900117196
2025-06-19 04:52:58,FAKE,2883434353,241,2883434594,2900117683
2025-06-19 04:53:00,REAL,2883434594,541,2883435135,2900118224
2025-06-19 04:53:02,FAKE,2883435135,244,2883435379,2900118710
2025-06-19 04:53:04,REAL,2883435379,8149,2883443528,2900126859
2025-06-19 04:53:06,REAL,2883443528,10979,2883454507,2900137838
2025-06-19 04:53:08,FAKE,2883454507,238,2883454745,2900148093
2025-06-19 04:53:10,FAKE,2883454745,238,2883454983,2900158414
2025-06-19 04:53:12,REAL,2883454983,10246,2883465229,2900168660
2025-06-19 04:53:14,REAL,2883465229,10395,2883475624,2900179055
2025-06-19 04:53:16,REAL,2883475624,10255,2883485879,2900189310
2025-06-19 04:53:18,REAL,2883485879,8732,2883494611,2900198042
2025-06-19 04:53:20,REAL,2883494611,485,2883495096,2900198527
2025-06-19 04:53:22,REAL,2883495096,243,2883495339,2900198770
2025-06-19 04:53:24,FAKE,2883495339,243,2883495582,2900199251
2025-06-19 04:53:26,REAL,2883495582,487,2883496069,2900199738
2025-06-19 04:53:28,REAL,2883496069,483,2883496552,2900200221
2025-06-19 04:53:30,FAKE,2883496552,243,2883496795,2900200706
2025-06-19 04:53:32,REAL,2883496795,483,2883497278,2900201189
2025-06-19 04:53:34,FAKE,2883497278,241,2883497519,2900201676
2025-06-19 04:53:36,REAL,2883497519,540,2883498059,2900202216
2025-06-19 04:53:38,REAL,2883498059,539,2883498598,2900202755
2025-06-19 04:53:40,FAKE,2883498598,238,2883498836,2900203234
2025-06-19 04:53:42,FAKE,2883498836,238,2883499074,2900203718
2025-06-19 04:53:44,REAL,2883499074,479,2883499553,2900204197
2025-06-19 04:53:46,FAKE,2883499553,244,2883499797,2900204678
2025-06-19 04:53:48,REAL,2883499797,481,2883500278,2900205159
2025-06-19 04:53:50,FAKE,2883500278,244,2883500522,2900205652
2025-06-19 04:53:52,REAL,2883500522,485,2883501007,2900206137
2025-06-19 04:53:54,REAL,2883501007,479,2883501486,2900206616
2025-06-19 04:53:56,REAL,2883501486,475,2883501961,2900207091
2025-06-19 04:53:58,REAL,2883501961,478,2883502439,2900207569
2025-06-19 04:54:00,REAL,2883502439,480,2883502919,2900208049
2025-06-19 04:54:02,REAL,2883502919,474,2883503393,2900208523
2025-06-19 04:54:04,REAL,2883503393,480,2883503873,2900209003
2025-06-19 04:54:06,REAL,2883503873,485,2883504358,2900209488
2025-06-19 04:54:08,REAL,2883504358,9143,2883513501,2900218631
2025-06-19 04:54:10,REAL,2883513501,10573,2883524074,2900229204
2025-06-19 04:54:12,REAL,2883524074,10242,2883534316,2900239446
2025-06-19 04:54:14,REAL,2883534316,10317,2883544633,2900249763
2025-06-19 04:54:16,REAL,2883544633,10255,2883554888,2900260018
2025-06-19 04:54:18,FAKE,2883554888,241,2883555129,2900270279
2025-06-19 04:54:20,FAKE,2883555129,238,2883555367,2900280590
2025-06-19 04:54:22,REAL,2883555367,7414,2883562781,2900288004
2025-06-19 04:54:24,FAKE,2883562781,241,2883563022,2900288493
2025-06-19 04:54:26,REAL,2883563022,481,2883563503,2900288974
2025-06-19 04:54:28,REAL,2883563503,4056,2883567559,2900293030
2025-06-19 04:54:30,REAL,2883567559,11307,2883578866,2900304337
2025-06-19 04:54:32,FAKE,2883578866,241,2883579107,2900314588
2025-06-19 04:54:34,REAL,2883579107,10256,2883589363,2900324844
2025-06-19 04:54:36,REAL,2883589363,10258,2883599621,2900335102
2025-06-19 04:54:38,FAKE,2883599621,243,2883599864,2900345417
2025-06-19 04:54:40,REAL,2883599864,10256,2883610120,2900355673
2025-06-19 04:54:42,REAL,2883610120,10259,2883620379,2900365932
2025-06-19 04:54:44,REAL,2883620379,2252,2883622631,2900368184
2025-06-19 04:54:46,REAL,2883622631,483,2883623114,2900368667
2025-06-19 04:54:48,REAL,2883623114,486,2883623600,2900369153
2025-06-19 04:54:50,FAKE,2883623600,238,2883623838,2900369635
2025-06-19 04:54:52,FAKE,2883623838,241,2883624079,2900370114
2025-06-19 04:54:54,REAL,2883624079,474,2883624553,2900370588
2025-06-19 04:54:56,REAL,2883624553,482,2883625035,2900371070
2025-06-19 04:54:58,REAL,2883625035,490,2883625525,2900371560
2025-06-19 04:55:00,REAL,2883625525,5370,2883630895,2900376930
2025-06-19 04:55:02,FAKE,2883630895,238,2883631133,2900391010
2025-06-19 04:55:04,REAL,2883631133,10252,2883641385,2900401262
2025-06-19 04:55:06,FAKE,2883641385,243,2883641628,2900411577
2025-06-19 04:55:08,REAL,2883641628,10251,2883651879,2900421828
2025-06-19 04:55:10,REAL,2883651879,10248,2883662127,2900432076
2025-06-19 04:55:12,FAKE,2883662127,244,2883662371,2900442389
2025-06-19 04:55:14,REAL,2883662371,10250,2883672621,2900452639
2025-06-19 04:55:16,REAL,2883672621,1609,2883674230,2900454248
2025-06-19 04:55:18,FAKE,2883674230,243,2883674473,2900454726
2025-06-19 04:55:20,REAL,2883674473,542,2883675015,2900455268
2025-06-19 04:55:22,REAL,2883675015,11709,2883686724,2900466977
2025-06-19 04:55:24,REAL,2883686724,10319,2883697043,2900477296
2025-06-19 04:55:26,REAL,2883697043,10253,2883707296,2900487549
2025-06-19 04:55:28,REAL,2883707296,10253,2883717549,2900497802
2025-06-19 04:55:30,FAKE,2883717549,238,2883717787,2900508062
2025-06-19 04:55:32,REAL,2883717787,10252,2883728039,2900518314
2025-06-19 04:55:34,FAKE,2883728039,238,2883728277,2900528631
2025-06-19 04:55:36,FAKE,2883728277,243,2883728520,2900534662
2025-06-19 04:55:38,FAKE,2883728520,244,2883728764,2900535143
2025-06-19 04:55:40,REAL,2883728764,478,2883729242,2900535621
2025-06-19 04:55:42,FAKE,2883729242,244,2883729486,2900536097
2025-06-19 04:55:44,REAL,2883729486,487,2883729973,2900536584
2025-06-19 04:55:46,REAL,2883729973,481,2883730454,2900537065
2025-06-19 04:55:48,REAL,2883730454,478,2883730932,2900537543
2025-06-19 04:55:50,REAL,2883730932,482,2883731414,2900538025
2025-06-19 04:55:52,REAL,2883731414,488,2883731902,2900538513
2025-06-19 04:55:54,REAL,2883731902,12034,2883743936,2900550547
2025-06-19 04:55:56,FAKE,2883743936,244,2883744180,2900560799
2025-06-19 04:55:58,REAL,2883744180,10247,2883754427,2900571046
2025-06-19 04:56:00,REAL,2883754427,10325,2883764752,2900581371
2025-06-19 04:56:02,REAL,2883764752,10250,2883775002,2900591621
2025-06-19 04:56:04,REAL,2883775002,10253,2883785255,2900601874
2025-06-19 04:56:06,REAL,2883785255,10321,2883795576,2900612195
2025-06-19 04:56:08,REAL,2883795576,5437,2883801013,2900617632
2025-06-19 04:56:10,FAKE,2883801013,238,2883801251,2900618124
2025-06-19 04:56:12,REAL,2883801251,487,2883801738,2900618611
2025-06-19 04:56:14,REAL,2883801738,484,2883802222,2900619095
2025-06-19 04:56:16,REAL,2883802222,487,2883802709,2900619582
2025-06-19 04:56:18,REAL,2883802709,486,2883803195,2900620068
2025-06-19 04:56:20,REAL,2883803195,484,2883803679,2900620552
2025-06-19 04:56:22,REAL,2883803679,491,2883804170,2900621043
2025-06-19 04:56:24,REAL,2883804170,486,2883804656,2900621529
2025-06-19 04:56:26,FAKE,2883804656,241,2883804897,2900622018
2025-06-19 04:56:28,REAL,2883804897,533,2883805430,2900622551
2025-06-19 04:56:30,REAL,2883805430,540,2883805970,2900623091
2025-06-19 04:56:32,FAKE,2883805970,244,2883806214,2900623568
2025-06-19 04:56:34,FAKE,2883806214,241,2883806455,2900624055
2025-06-19 04:56:36,FAKE,2883806455,238,2883806693,2900624534
2025-06-19 04:56:38,REAL,2883806693,490,2883807183,2900625024
2025-06-19 04:56:40,FAKE,2883807183,241,2883807424,2900625510
2025-06-19 04:56:42,REAL,2883807424,480,2883807904,2900625990
2025-06-19 04:56:44,REAL,2883807904,490,2883808394,2900626480
2025-06-19 04:56:46,REAL,2883808394,488,2883808882,2900626968
2025-06-19 04:56:48,FAKE,2883808882,243,2883809125,2900627461
2025-06-19 04:56:50,REAL,2883809125,485,2883809610,2900627946
2025-06-19 04:56:52,FAKE,2883809610,243,2883809853,2900628428
2025-06-19 04:56:54,REAL,2883809853,483,2883810336,2900628911
2025-06-19 04:56:56,REAL,2883810336,482,2883810818,2900629393
2025-06-19 04:56:58,FAKE,2883810818,244,2883811062,2900629874
2025-06-19 04:57:00,FAKE,2883811062,241,2883811303,2900630363
2025-06-19 04:57:02,REAL,2883811303,481,2883811784,2900630844
2025-06-19 04:57:04,FAKE,2883811784,243,2883812027,2900631440
2025-06-19 04:57:06,REAL,2883812027,493,2883812520,2900631933
2025-06-19 04:57:08,REAL,2883812520,476,2883812996,2900632409
2025-06-19 04:57:10,REAL,2883812996,489,2883813485,2900632898
2025-06-19 04:57:12,REAL,2883813485,477,2883813962,2900633375
2025-06-19 04:57:14,REAL,2883813962,487,2883814449,2900633862
2025-06-19 04:57:16,REAL,2883814449,490,2883814939,2900634352
2025-06-19 04:57:18,FAKE,2883814939,243,2883815182,2900634836
2025-06-19 04:57:20,FAKE,2883815182,243,2883815425,2900635329
2025-06-19 04:57:22,REAL,2883815425,476,2883815901,2900635805
2025-06-19 04:57:24,REAL,2883815901,476,2883816377,2900636281
2025-06-19 04:57:26,REAL,2883816377,484,2883816861,2900636765
2025-06-19 04:57:28,REAL,2883816861,488,2883817349,2900637253
2025-06-19 04:57:30,REAL,2883817349,477,2883817826,2900637730
2025-06-19 04:57:32,REAL,2883817826,487,2883818313,2900638217
2025-06-19 04:57:34,REAL,2883818313,486,2883818799,2900638703
2025-06-19 04:57:36,FAKE,2883818799,241,2883819040,2900639189
2025-06-19 04:57:38,FAKE,2883819040,243,2883819283,2900639730
2025-06-19 04:57:40,REAL,2883819283,487,2883819770,2900640217
2025-06-19 04:57:42,REAL,2883819770,478,2883820248,2900640695
2025-06-19 04:57:44,REAL,2883820248,486,2883820734,2900641181
2025-06-19 04:57:46,REAL,2883820734,538,2883821272,2900641719
2025-06-19 04:57:48,REAL,2883821272,489,2883821761,2900642208
2025-06-19 04:57:50,REAL,2883821761,486,2883822247,2900642694
2025-06-19 04:57:52,REAL,2883822247,492,2883822739,2900643186
2025-06-19 04:57:54,FAKE,2883822739,243,2883822982,2900643673
2025-06-19 04:57:56,REAL,2883822982,492,2883823474,2900644165
2025-06-19 04:57:58,REAL,2883823474,484,2883823958,2900644649
2025-06-19 04:58:00,REAL,2883823958,540,2883824498,2900645189
2025-06-19 04:58:02,REAL,2883824498,484,2883824982,2900645673
2025-06-19 04:58:04,FAKE,2883824982,241,2883825223,2900646158
2025-06-19 04:58:06,REAL,2883825223,486,2883825709,2900646644
2025-06-19 04:58:08,FAKE,2883825709,238,2883825947,2900647133
2025-06-19 04:58:10,FAKE,2883825947,238,2883826185,2900647620
2025-06-19 04:58:12,REAL,2883826185,479,2883826664,2900648099
2025-06-19 04:58:14,FAKE,2883826664,241,2883826905,2900648579
2025-06-19 04:58:16,REAL,2883826905,485,2883827390,2900649064
2025-06-19 04:58:18,REAL,2883827390,480,2883827870,2900649544
2025-06-19 04:58:20,REAL,2883827870,536,2883828406,2900650080
2025-06-19 04:58:22,REAL,2883828406,9218,2883837624,2900659298
2025-06-19 04:58:24,REAL,2883837624,10441,2883848065,2900669739
2025-06-19 04:58:26,REAL,2883848065,10250,2883858315,2900679989
2025-06-19 04:58:28,REAL,2883858315,10316,2883868631,2900690305
2025-06-19 04:58:30,REAL,2883868631,10314,2883878945,2900700619
2025-06-19 04:58:32,REAL,2883878945,10259,2883889204,2900710878
2025-06-19 04:58:34,FAKE,2883889204,238,2883889442,2900721125
2025-06-19 04:58:36,FAKE,2883889442,238,2883889680,2900728675
2025-06-19 04:58:38,REAL,2883889680,490,2883890170,2900729165
2025-06-19 04:58:40,FAKE,2883890170,241,2883890411,2900729645
2025-06-19 04:58:42,REAL,2883890411,538,2883890949,2900730183
2025-06-19 04:58:44,FAKE,2883890949,241,2883891190,2900730673
2025-06-19 04:58:46,FAKE,2883891190,241,2883891431,2900731165
2025-06-19 04:58:48,FAKE,2883891431,243,2883891674,2900731655
2025-06-19 04:58:50,REAL,2883891674,484,2883892158,2900732139
2025-06-19 04:58:52,REAL,2883892158,484,2883892642,2900732623
2025-06-19 04:58:54,REAL,2883892642,489,2883893131,2900733112
2025-06-19 04:58:56,REAL,2883893131,484,2883893615,2900733596
2025-06-19 04:58:58,FAKE,2883893615,243,2883893858,2900734084
2025-06-19 04:59:00,REAL,2883893858,475,2883894333,2900734559
2025-06-19 04:59:02,REAL,2883894333,483,2883894816,2900735042
2025-06-19 04:59:04,FAKE,2883894816,241,2883895057,2900735585
2025-06-19 04:59:06,REAL,2883895057,484,2883895541,2900736069
2025-06-19 04:59:08,REAL,2883895541,488,2883896029,2900736557
2025-06-19 04:59:10,REAL,2883896029,479,2883896508,2900737036
2025-06-19 04:59:12,REAL,2883896508,483,2883896991,2900737519
2025-06-19 04:59:14,REAL,2883896991,540,2883897531,2900738059
2025-06-19 04:59:16,FAKE,2883897531,244,2883897775,2900738553
2025-06-19 04:59:18,REAL,2883897775,487,2883898262,2900739040
2025-06-19 04:59:20,FAKE,2883898262,244,2883898506,2900739530
2025-06-19 04:59:22,REAL,2883898506,488,2883898994,2900740018
2025-06-19 04:59:24,FAKE,2883898994,244,2883899238,2900740561
2025-06-19 04:59:26,REAL,2883899238,481,2883899719,2900741042
2025-06-19 04:59:28,REAL,2883899719,478,2883900197,2900741520
2025-06-19 04:59:30,REAL,2883900197,490,2883900687,2900742010
2025-06-19 04:59:32,REAL,2883900687,489,2883901176,2900742499
2025-06-19 04:59:34,REAL,2883901176,489,2883901665,2900742988
2025-06-19 04:59:36,REAL,2883901665,486,2883902151,2900743474
2025-06-19 04:59:38,FAKE,2883902151,244,2883902395,2900743950
2025-06-19 04:59:40,REAL,2883902395,481,2883902876,2900744431
2025-06-19 04:59:42,REAL,2883902876,478,2883903354,2900744909
2025-06-19 04:59:44,REAL,2883903354,490,2883903844,2900745399
2025-06-19 04:59:46,REAL,2883903844,535,2883904379,2900745934
2025-06-19 04:59:48,REAL,2883904379,490,2883904869,2900746424
2025-06-19 04:59:50,REAL,2883904869,482,2883905351,2900746906
2025-06-19 04:59:52,REAL,2883905351,486,2883905837,2900747392
2025-06-19 04:59:54,FAKE,2883905837,241,2883906078,2900747875
2025-06-19 04:59:56,REAL,2883906078,484,2883906562,2900748359
2025-06-19 04:59:58,REAL,2883906562,490,2883907052,2900748849
2025-06-19 05:00:00,FAKE,2883907052,243,2883907295,2900749389
2025-06-19 05:00:02,REAL,2883907295,484,2883907779,2900749873
2025-06-19 05:00:04,FAKE,2883907779,238,2883908017,2900750365
2025-06-19 05:00:06,REAL,2883908017,534,2883908551,2900750899
2025-06-19 05:00:08,FAKE,2883908551,243,2883908794,2900751381
2025-06-19 05:00:10,REAL,2883908794,478,2883909272,2900751859
2025-06-19 05:00:12,REAL,2883909272,488,2883909760,2900752347
2025-06-19 05:00:14,REAL,2883909760,478,2883910238,2900752825
2025-06-19 05:00:16,REAL,2883910238,489,2883910727,2900753314
2025-06-19 05:00:18,REAL,2883910727,488,2883911215,2900753802
2025-06-19 05:00:20,FAKE,2883911215,238,2883911453,2900754284
2025-06-19 05:00:22,REAL,2883911453,474,2883911927,2900754758
2025-06-19 05:00:24,REAL,2883911927,491,2883912418,2900755249
2025-06-19 05:00:26,FAKE,2883912418,243,2883912661,2900755727
2025-06-19 05:00:28,REAL,2883912661,542,2883913203,2900756269
2025-06-19 05:00:30,REAL,2883913203,484,2883913687,2900756753
2025-06-19 05:00:32,REAL,2883913687,482,2883914169,2900757235
2025-06-19 05:00:34,FAKE,2883914169,244,2883914413,2900757718
2025-06-19 05:00:36,REAL,2883914413,483,2883914896,2900758201
2025-06-19 05:00:38,REAL,2883914896,484,2883915380,2900758685
2025-06-19 05:00:40,FAKE,2883915380,244,2883915624,2900759169
2025-06-19 05:00:42,REAL,2883915624,546,2883916170,2900759715
2025-06-19 05:00:44,FAKE,2883916170,243,2883916413,2900766213
2025-06-19 05:00:46,FAKE,2883916413,241,2883916654,2900777326
2025-06-19 05:00:48,REAL,2883916654,10242,2883926896,2900787568
2025-06-19 05:00:50,REAL,2883926896,10320,2883937216,2900797888
2025-06-19 05:00:52,FAKE,2883937216,241,2883937457,2900808137
2025-06-19 05:00:54,REAL,2883937457,10250,2883947707,2900818387
2025-06-19 05:00:56,REAL,2883947707,10322,2883958029,2900828709
2025-06-19 05:00:58,REAL,2883958029,9790,2883967819,2900838499
2025-06-19 05:01:00,FAKE,2883967819,238,2883968057,2900838988
2025-06-19 05:01:02,REAL,2883968057,484,2883968541,2900839472
2025-06-19 05:01:04,REAL,2883968541,536,2883969077,2900840008
2025-06-19 05:01:06,FAKE,2883969077,241,2883969318,2900840495
2025-06-19 05:01:08,REAL,2883969318,480,2883969798,2900840975
2025-06-19 05:01:10,FAKE,2883969798,238,2883970036,2900841451
2025-06-19 05:01:12,REAL,2883970036,478,2883970514,2900841929
2025-06-19 05:01:14,REAL,2883970514,485,2883970999,2900842414
2025-06-19 05:01:16,FAKE,2883970999,244,2883971243,2900850101
2025-06-19 05:01:18,REAL,2883971243,10714,2883981957,2900860815
2025-06-19 05:01:20,REAL,2883981957,10322,2883992279,2900871137
2025-06-19 05:01:22,REAL,2883992279,10251,2884002530,2900881388
2025-06-19 05:01:24,REAL,2884002530,10323,2884012853,2900891711
2025-06-19 05:01:26,REAL,2884012853,10257,2884023110,2900901968
2025-06-19 05:01:28,REAL,2884023110,10372,2884033482,2900912340
2025-06-19 05:01:30,REAL,2884033482,9197,2884042679,2900921537
2025-06-19 05:01:32,REAL,2884042679,478,2884043157,2900922015
2025-06-19 05:01:34,REAL,2884043157,482,2884043639,2900922497
2025-06-19 05:01:36,REAL,2884043639,3646,2884047285,2900926143
2025-06-19 05:01:38,REAL,2884047285,10857,2884058142,2900937000
2025-06-19 05:01:40,REAL,2884058142,10252,2884068394,2900947252
2025-06-19 05:01:42,FAKE,2884068394,241,2884068635,2900957509
2025-06-19 05:01:44,REAL,2884068635,10318,2884078953,2900967827
2025-06-19 05:01:46,FAKE,2884078953,238,2884079191,2900978081
2025-06-19 05:01:48,REAL,2884079191,10254,2884089445,2900988335
2025-06-19 05:01:50,REAL,2884089445,10310,2884099755,2900998645
2025-06-19 05:01:52,REAL,2884099755,3911,2884103666,2901002556
2025-06-19 05:01:54,REAL,2884103666,487,2884104153,2901003043
2025-06-19 05:01:56,REAL,2884104153,482,2884104635,2901003525
2025-06-19 05:01:58,REAL,2884104635,535,2884105170,2901004060
2025-06-19 05:02:00,REAL,2884105170,489,2884105659,2901004549
2025-06-19 05:02:02,FAKE,2884105659,238,2884105897,2901005039
2025-06-19 05:02:04,FAKE,2884105897,243,2884106140,2901005532
2025-06-19 05:02:06,REAL,2884106140,482,2884106622,2901006014
2025-06-19 05:02:08,FAKE,2884106622,238,2884106860,2901006500
2025-06-19 05:02:10,REAL,2884106860,488,2884107348,2901006988
2025-06-19 05:02:12,REAL,2884107348,539,2884107887,2901007527
2025-06-19 05:02:14,REAL,2884107887,476,2884108363,2901008003
2025-06-19 05:02:16,REAL,2884108363,485,2884108848,2901008488
2025-06-19 05:02:18,REAL,2884108848,537,2884109385,2901009025
2025-06-19 05:02:20,REAL,2884109385,475,2884109860,2901009500
2025-06-19 05:02:22,REAL,2884109860,478,2884110338,2901009978
2025-06-19 05:02:24,FAKE,2884110338,241,2884110579,2901010458
2025-06-19 05:02:26,REAL,2884110579,490,2884111069,2901010948
2025-06-19 05:02:28,FAKE,2884111069,238,2884111307,2901011430
2025-06-19 05:02:30,REAL,2884111307,482,2884111789,2901011912
2025-06-19 05:02:32,REAL,2884111789,479,2884112268,2901012391
2025-06-19 05:02:34,REAL,2884112268,481,2884112749,2901012872
2025-06-19 05:02:36,REAL,2884112749,476,2884113225,2901013348
2025-06-19 05:02:38,FAKE,2884113225,243,2884113468,2901013827
2025-06-19 05:02:40,REAL,2884113468,539,2884114007,2901014366
2025-06-19 05:02:42,REAL,2884114007,484,2884114491,2901014850
2025-06-19 05:02:44,FAKE,2884114491,238,2884114729,2901015326
2025-06-19 05:02:46,REAL,2884114729,480,2884115209,2901015806
2025-06-19 05:02:48,FAKE,2884115209,241,2884115450,2901016297
2025-06-19 05:02:50,REAL,2884115450,3594,2884119044,2901019891
2025-06-19 05:02:52,REAL,2884119044,11175,2884130219,2901031066
2025-06-19 05:02:54,REAL,2884130219,10253,2884140472,2901041319
2025-06-19 05:02:56,FAKE,2884140472,241,2884140713,2901051575
2025-06-19 05:02:58,FAKE,2884140713,244,2884140957,2901061893
2025-06-19 05:03:00,FAKE,2884140957,244,2884141201,2901072136
2025-06-19 05:03:02,REAL,2884141201,10253,2884151454,2901082389
2025-06-19 05:03:04,REAL,2884151454,10380,2884161834,2901092769
2025-06-19 05:03:06,REAL,2884161834,2731,2884164565,2901095500
2025-06-19 05:03:08,REAL,2884164565,481,2884165046,2901095981
2025-06-19 05:03:10,REAL,2884165046,490,2884165536,2901096471
2025-06-19 05:03:12,REAL,2884165536,536,2884166072,2901097007
2025-06-19 05:03:14,REAL,2884166072,487,2884166559,2901097494
2025-06-19 05:03:16,REAL,2884166559,483,2884167042,2901097977
2025-06-19 05:03:18,REAL,2884167042,480,2884167522,2901098457
2025-06-19 05:03:20,FAKE,2884167522,244,2884167766,2901098949
2025-06-19 05:03:22,FAKE,2884167766,243,2884168009,2901099432
2025-06-19 05:03:24,REAL,2884168009,493,2884168502,2901099925
2025-06-19 05:03:26,REAL,2884168502,491,2884168993,2901100416
2025-06-19 05:03:28,REAL,2884168993,485,2884169478,2901100901
2025-06-19 05:03:30,REAL,2884169478,478,2884169956,2901101379
2025-06-19 05:03:32,REAL,2884169956,481,2884170437,2901101860
2025-06-19 05:03:34,REAL,2884170437,483,2884170920,2901102343
2025-06-19 05:03:36,FAKE,2884170920,241,2884171161,2901102884
2025-06-19 05:03:38,REAL,2884171161,482,2884171643,2901103366
2025-06-19 05:03:40,REAL,2884171643,482,2884172125,2901103848
2025-06-19 05:03:42,REAL,2884172125,486,2884172611,2901104334
2025-06-19 05:03:44,FAKE,2884172611,243,2884172854,2901104811
2025-06-19 05:03:46,FAKE,2884172854,243,2884173097,2901105292
2025-06-19 05:03:48,REAL,2884173097,482,2884173579,2901105774
2025-06-19 05:03:50,REAL,2884173579,487,2884174066,2901106261
2025-06-19 05:03:52,REAL,2884174066,480,2884174546,2901106741
2025-06-19 05:03:54,REAL,2884174546,483,2884175029,2901107224
2025-06-19 05:03:56,REAL,2884175029,531,2884175560,2901107755
2025-06-19 05:03:58,REAL,2884175560,487,2884176047,2901108242
2025-06-19 05:04:00,REAL,2884176047,542,2884176589,2901108784
2025-06-19 05:04:02,REAL,2884176589,482,2884177071,2901109266
2025-06-19 05:04:04,REAL,2884177071,494,2884177565,2901109760
2025-06-19 05:04:06,REAL,2884177565,485,2884178050,2901110245
2025-06-19 05:04:08,REAL,2884178050,487,2884178537,2901110732
2025-06-19 05:04:10,REAL,2884178537,488,2884179025,2901111220
2025-06-19 05:04:12,REAL,2884179025,492,2884179517,2901111712
2025-06-19 05:04:14,REAL,2884179517,482,2884179999,2901112194
2025-06-19 05:04:16,FAKE,2884179999,241,2884180240,2901112676
2025-06-19 05:04:18,REAL,2884180240,492,2884180732,2901113168
2025-06-19 05:04:20,REAL,2884180732,478,2884181210,2901113646
2025-06-19 05:04:22,REAL,2884181210,481,2884181691,2901114127
2025-06-19 05:04:24,FAKE,2884181691,244,2884181935,2901114668
2025-06-19 05:04:26,REAL,2884181935,6759,2884188694,2901121427
2025-06-19 05:04:28,REAL,2884188694,13023,2884201717,2901134450
2025-06-19 05:04:30,REAL,2884201717,10323,2884212040,2901144773
2025-06-19 05:04:32,REAL,2884212040,10253,2884222293,2901155026
2025-06-19 05:04:34,REAL,2884222293,10315,2884232608,2901165341
2025-06-19 05:04:36,REAL,2884232608,10259,2884242867,2901175600
2025-06-19 05:04:38,REAL,2884242867,10255,2884253122,2901185855
2025-06-19 05:04:40,FAKE,2884253122,238,2884253360,2901196104
2025-06-19 05:04:42,REAL,2884253360,876,2884254236,2901196980
2025-06-19 05:04:44,FAKE,2884254236,238,2884254474,2901197464
2025-06-19 05:04:46,REAL,2884254474,547,2884255021,2901198011
2025-06-19 05:04:48,FAKE,2884255021,241,2884255262,2901198559
2025-06-19 05:04:50,REAL,2884255262,477,2884255739,2901199036
2025-06-19 05:04:52,FAKE,2884255739,244,2884255983,2901199526
2025-06-19 05:04:54,REAL,2884255983,481,2884256464,2901200007
2025-06-19 05:04:56,FAKE,2884256464,238,2884256702,2901200494
2025-06-19 05:04:58,REAL,2884256702,7416,2884264118,2901207910
2025-06-19 05:05:00,REAL,2884264118,12896,2884277014,2901220806
2025-06-19 05:05:02,FAKE,2884277014,244,2884277258,2901231060
2025-06-19 05:05:04,REAL,2884277258,10323,2884287581,2901241383
2025-06-19 05:05:06,FAKE,2884287581,241,2884287822,2901251637
2025-06-19 05:05:08,FAKE,2884287822,244,2884288066,2901261890
2025-06-19 05:05:10,FAKE,2884288066,243,2884288309,2901272146
2025-06-19 05:05:12,FAKE,2884288309,238,2884288547,2901282125
2025-06-19 05:05:14,FAKE,2884288547,244,2884288791,2901282606
2025-06-19 05:05:16,REAL,2884288791,489,2884289280,2901283095
2025-06-19 05:05:18,FAKE,2884289280,243,2884289523,2901283578
2025-06-19 05:05:20,REAL,2884289523,544,2884290067,2901284122
2025-06-19 05:05:22,REAL,2884290067,483,2884290550,2901284605
2025-06-19 05:05:24,REAL,2884290550,484,2884291034,2901285089
2025-06-19 05:05:26,REAL,2884291034,483,2884291517,2901285572
2025-06-19 05:05:28,REAL,2884291517,492,2884292009,2901286064
2025-06-19 05:05:30,REAL,2884292009,482,2884292491,2901286546
2025-06-19 05:05:32,REAL,2884292491,485,2884292976,2901287031
2025-06-19 05:05:34,FAKE,2884292976,244,2884293220,2901287506
2025-06-19 05:05:36,REAL,2884293220,486,2884293706,2901287992
2025-06-19 05:05:38,FAKE,2884293706,243,2884293949,2901288534
2025-06-19 05:05:40,REAL,2884293949,483,2884294432,2901289017
2025-06-19 05:05:42,FAKE,2884294432,243,2884294675,2901289500
2025-06-19 05:05:44,REAL,2884294675,482,2884295157,2901289982
2025-06-19 05:05:46,REAL,2884295157,534,2884295691,2901290516
2025-06-19 05:05:48,REAL,2884295691,489,2884296180,2901291005
2025-06-19 05:05:50,FAKE,2884296180,243,2884296423,2901291492
2025-06-19 05:05:52,REAL,2884296423,485,2884296908,2901291977
2025-06-19 05:05:54,REAL,2884296908,479,2884297387,2901292456
2025-06-19 05:05:56,REAL,2884297387,484,2884297871,2901292940
2025-06-19 05:05:58,REAL,2884297871,485,2884298356,2901293425
2025-06-19 05:06:00,REAL,2884298356,486,2884298842,2901293911
2025-06-19 05:06:02,REAL,2884298842,480,2884299322,2901294391
2025-06-19 05:06:04,FAKE,2884299322,244,2884299566,2901294874
2025-06-19 05:06:06,REAL,2884299566,476,2884300042,2901295350
2025-06-19 05:06:08,REAL,2884300042,489,2884300531,2901295839
2025-06-19 05:06:10,FAKE,2884300531,244,2884300775,2901296376
2025-06-19 05:06:12,FAKE,2884300775,243,2884301018,2901296869
2025-06-19 05:06:14,REAL,2884301018,493,2884301511,2901297362
2025-06-19 05:06:16,FAKE,2884301511,238,2884301749,2901297841
2025-06-19 05:06:18,REAL,2884301749,481,2884302230,2901298322
2025-06-19 05:06:20,REAL,2884302230,484,2884302714,2901298806
2025-06-19 05:06:22,REAL,2884302714,485,2884303199,2901299291
2025-06-19 05:06:24,FAKE,2884303199,241,2884303440,2901299773
2025-06-19 05:06:26,REAL,2884303440,482,2884303922,2901300255
2025-06-19 05:06:28,REAL,2884303922,484,2884304406,2901300739
2025-06-19 05:06:30,REAL,2884304406,532,2884304938,2901301271
2025-06-19 05:06:32,REAL,2884304938,480,2884305418,2901301751
2025-06-19 05:06:34,FAKE,2884305418,243,2884305661,2901302286
2025-06-19 05:06:36,REAL,2884305661,493,2884306154,2901302779
2025-06-19 05:06:38,FAKE,2884306154,241,2884306395,2901303260
2025-06-19 05:06:40,FAKE,2884306395,238,2884306633,2901303740
2025-06-19 05:06:42,REAL,2884306633,484,2884307117,2901304224
2025-06-19 05:06:44,REAL,2884307117,490,2884307607,2901304714
2025-06-19 05:06:46,FAKE,2884307607,241,2884307848,2901305200
2025-06-19 05:06:48,REAL,2884307848,483,2884308331,2901305683
2025-06-19 05:06:50,FAKE,2884308331,241,2884308572,2901306169
2025-06-19 05:06:52,REAL,2884308572,481,2884309053,2901306650
2025-06-19 05:06:54,REAL,2884309053,3467,2884312520,2901310117
2025-06-19 05:06:56,FAKE,2884312520,244,2884312764,2901321767
2025-06-19 05:06:58,REAL,2884312764,10245,2884323009,2901332012
2025-06-19 05:07:00,FAKE,2884323009,244,2884323253,2901342268
2025-06-19 05:07:02,FAKE,2884323253,244,2884323497,2901352582
2025-06-19 05:07:04,REAL,2884323497,10249,2884333746,2901362831
2025-06-19 05:07:06,REAL,2884333746,10249,2884343995,2901373080
2025-06-19 05:07:08,FAKE,2884343995,244,2884344239,2901383399
2025-06-19 05:07:10,REAL,2884344239,2921,2884347160,2901386320
2025-06-19 05:07:12,REAL,2884347160,484,2884347644,2901386804
2025-06-19 05:07:14,REAL,2884347644,489,2884348133,2901387293
2025-06-19 05:07:16,REAL,2884348133,480,2884348613,2901387773
2025-06-19 05:07:18,REAL,2884348613,550,2884349163,2901388323
2025-06-19 05:07:20,REAL,2884349163,542,2884349705,2901388865
2025-06-19 05:07:22,FAKE,2884349705,238,2884349943,2901389354
2025-06-19 05:07:24,REAL,2884349943,489,2884350432,2901389843
2025-06-19 05:07:26,REAL,2884350432,4131,2884354563,2901393974
2025-06-19 05:07:28,FAKE,2884354563,244,2884354807,2901405219
2025-06-19 05:07:30,FAKE,2884354807,244,2884355051,2901415478
2025-06-19 05:07:32,FAKE,2884355051,243,2884355294,2901425791
2025-06-19 05:07:34,REAL,2884355294,10248,2884365542,2901436039
2025-06-19 05:07:36,REAL,2884365542,10251,2884375793,2901446290
2025-06-19 05:07:38,REAL,2884375793,10316,2884386109,2901456606
2025-06-19 05:07:40,FAKE,2884386109,243,2884386352,2901466864
2025-06-19 05:07:42,REAL,2884386352,2262,2884388614,2901469126
2025-06-19 05:07:44,FAKE,2884388614,238,2884388852,2901469614
2025-06-19 05:07:46,FAKE,2884388852,241,2884389093,2901470100
2025-06-19 05:07:48,REAL,2884389093,485,2884389578,2901470585
2025-06-19 05:07:50,REAL,2884389578,481,2884390059,2901471066
2025-06-19 05:07:52,REAL,2884390059,480,2884390539,2901471546
2025-06-19 05:07:54,FAKE,2884390539,243,2884390782,2901472035
2025-06-19 05:07:56,FAKE,2884390782,244,2884391026,2901472569
2025-06-19 05:07:58,REAL,2884391026,5056,2884396082,2901477625
2025-06-19 05:08:00,FAKE,2884396082,241,2884396323,2901488603
2025-06-19 05:08:02,FAKE,2884396323,244,2884396567,2901498927
2025-06-19 05:08:04,REAL,2884396567,10249,2884406816,2901509176
2025-06-19 05:08:06,FAKE,2884406816,238,2884407054,2901519424
2025-06-19 05:08:08,FAKE,2884407054,243,2884407297,2901529674
2025-06-19 05:08:10,REAL,2884407297,10250,2884417547,2901539924
2025-06-19 05:08:12,REAL,2884417547,10316,2884427863,2901550240
2025-06-19 05:08:14,FAKE,2884427863,243,2884428106,2901551848
2025-06-19 05:08:16,REAL,2884428106,483,2884428589,2901552331
2025-06-19 05:08:18,FAKE,2884428589,243,2884428832,2901552822
2025-06-19 05:08:20,REAL,2884428832,478,2884429310,2901553300
2025-06-19 05:08:22,REAL,2884429310,493,2884429803,2901553793
2025-06-19 05:08:24,REAL,2884429803,478,2884430281,2901554271
2025-06-19 05:08:26,REAL,2884430281,487,2884430768,2901554758
2025-06-19 05:08:28,FAKE,2884430768,244,2884431012,2901555244
2025-06-19 05:08:30,FAKE,2884431012,241,2884431253,2901560812
2025-06-19 05:08:32,FAKE,2884431253,243,2884431496,2901572447
2025-06-19 05:08:34,FAKE,2884431496,241,2884431737,2901582690
2025-06-19 05:08:36,FAKE,2884431737,241,2884431978,2901592950
2025-06-19 05:08:38,REAL,2884431978,10248,2884442226,2901603198
2025-06-19 05:08:40,FAKE,2884442226,244,2884442470,2901613441
2025-06-19 05:08:42,REAL,2884442470,10253,2884452723,2901623694
2025-06-19 05:08:44,REAL,2884452723,10247,2884462970,2901633941
2025-06-19 05:08:46,REAL,2884462970,1069,2884464039,2901635010
2025-06-19 05:08:48,REAL,2884464039,479,2884464518,2901635489
2025-06-19 05:08:50,FAKE,2884464518,238,2884464756,2901635974
2025-06-19 05:08:52,REAL,2884464756,488,2884465244,2901636462
2025-06-19 05:08:54,REAL,2884465244,485,2884465729,2901636947
2025-06-19 05:08:56,REAL,2884465729,483,2884466212,2901637430
2025-06-19 05:08:58,REAL,2884466212,483,2884466695,2901637913
2025-06-19 05:09:00,FAKE,2884466695,241,2884466936,2901638398
2025-06-19 05:09:02,REAL,2884466936,6243,2884473179,2901644641
2025-06-19 05:09:04,FAKE,2884473179,238,2884473417,2901655876
2025-06-19 05:09:06,REAL,2884473417,10319,2884483736,2901666195
2025-06-19 05:09:08,FAKE,2884483736,241,2884483977,2901676449
2025-06-19 05:09:10,REAL,2884483977,10370,2884494347,2901686819
2025-06-19 05:09:12,FAKE,2884494347,243,2884494590,2901697076
2025-06-19 05:09:14,REAL,2884494590,10250,2884504840,2901707326
2025-06-19 05:09:16,REAL,2884504840,10182,2884515022,2901717508
2025-06-19 05:09:18,FAKE,2884515022,238,2884515260,2901717999
2025-06-19 05:09:20,REAL,2884515260,480,2884515740,2901718479
2025-06-19 05:09:22,REAL,2884515740,490,2884516230,2901718969
2025-06-19 05:09:24,REAL,2884516230,492,2884516722,2901719461
2025-06-19 05:09:26,REAL,2884516722,488,2884517210,2901719949
2025-06-19 05:09:28,REAL,2884517210,479,2884517689,2901720428
2025-06-19 05:09:30,REAL,2884517689,492,2884518181,2901720920
2025-06-19 05:09:32,REAL,2884518181,484,2884518665,2901721404
2025-06-19 05:09:34,REAL,2884518665,479,2884519144,2901721883
2025-06-19 05:09:36,REAL,2884519144,492,2884519636,2901722375
2025-06-19 05:09:38,REAL,2884519636,488,2884520124,2901722863
2025-06-19 05:09:40,REAL,2884520124,478,2884520602,2901723341
2025-06-19 05:09:42,REAL,2884520602,483,2884521085,2901723824
2025-06-19 05:09:44,REAL,2884521085,493,2884521578,2901724317
2025-06-19 05:09:46,REAL,2884521578,545,2884522123,2901724862
2025-06-19 05:09:48,REAL,2884522123,490,2884522613,2901725352
2025-06-19 05:09:50,FAKE,2884522613,243,2884522856,2901725833
2025-06-19 05:09:52,REAL,2884522856,485,2884523341,2901726318
2025-06-19 05:09:54,REAL,2884523341,547,2884523888,2901726865
2025-06-19 05:09:56,REAL,2884523888,482,2884524370,2901727347
2025-06-19 05:09:58,REAL,2884524370,476,2884524846,2901727823
2025-06-19 05:10:00,REAL,2884524846,483,2884525329,2901728306
2025-06-19 05:10:02,REAL,2884525329,488,2884525817,2901728794
2025-06-19 05:10:04,FAKE,2884525817,244,2884526061,2901729273
2025-06-19 05:10:06,REAL,2884526061,484,2884526545,2901729757
2025-06-19 05:10:08,REAL,2884526545,247,2884526792,2901730004
2025-06-19 05:10:10,REAL,2884526792,488,2884527280,2901730492
2025-06-19 05:10:12,FAKE,2884527280,241,2884527521,2901730975
2025-06-19 05:10:14,REAL,2884527521,488,2884528009,2901731463
2025-06-19 05:10:16,REAL,2884528009,483,2884528492,2901731946
2025-06-19 05:10:18,REAL,2884528492,488,2884528980,2901732434
2025-06-19 05:10:20,REAL,2884528980,479,2884529459,2901732913
2025-06-19 05:10:22,REAL,2884529459,545,2884530004,2901733458
2025-06-19 05:10:24,REAL,2884530004,476,2884530480,2901733934
2025-06-19 05:10:26,REAL,2884530480,481,2884530961,2901734415
2025-06-19 05:10:28,FAKE,2884530961,244,2884531205,2901734900
2025-06-19 05:10:30,REAL,2884531205,489,2884531694,2901735389
2025-06-19 05:10:32,FAKE,2884531694,238,2884531932,2901735871
2025-06-19 05:10:34,FAKE,2884531932,241,2884532173,2901736355
2025-06-19 05:10:36,FAKE,2884532173,238,2884532411,2901736846
2025-06-19 05:10:38,REAL,2884532411,486,2884532897,2901737332
2025-06-19 05:10:40,FAKE,2884532897,241,2884533138,2901737816
2025-06-19 05:10:42,REAL,2884533138,486,2884533624,2901738302
2025-06-19 05:10:44,REAL,2884533624,534,2884534158,2901738836
2025-06-19 05:10:46,REAL,2884534158,479,2884534637,2901739315
2025-06-19 05:10:48,FAKE,2884534637,244,2884534881,2901739803
2025-06-19 05:10:50,REAL,2884534881,481,2884535362,2901740284
2025-06-19 05:10:52,FAKE,2884535362,238,2884535600,2901740772
2025-06-19 05:10:54,REAL,2884535600,488,2884536088,2901741260
2025-06-19 05:10:56,REAL,2884536088,482,2884536570,2901741742
2025-06-19 05:10:58,REAL,2884536570,3122,2884539692,2901744864
2025-06-19 05:11:00,FAKE,2884539692,244,2884539936,2901756431
2025-06-19 05:11:02,REAL,2884539936,10256,2884550192,2901766687
2025-06-19 05:11:04,REAL,2884550192,10314,2884560506,2901777001
2025-06-19 05:11:06,FAKE,2884560506,243,2884560749,2901787260
2025-06-19 05:11:08,REAL,2884560749,10251,2884571000,2901797511
2025-06-19 05:11:10,REAL,2884571000,10251,2884581251,2901807762
2025-06-19 05:11:12,REAL,2884581251,10255,2884591506,2901818017
2025-06-19 05:11:14,REAL,2884591506,3064,2884594570,2901821081
2025-06-19 05:11:16,REAL,2884594570,474,2884595044,2901821555
2025-06-19 05:11:18,FAKE,2884595044,244,2884595288,2901822044
2025-06-19 05:11:20,REAL,2884595288,493,2884595781,2901822537
2025-06-19 05:11:22,FAKE,2884595781,241,2884596022,2901823024
2025-06-19 05:11:24,REAL,2884596022,479,2884596501,2901823503
2025-06-19 05:11:26,REAL,2884596501,477,2884596978,2901823980
2025-06-19 05:11:28,REAL,2884596978,486,2884597464,2901824466
2025-06-19 05:11:30,FAKE,2884597464,244,2884597708,2901828256
2025-06-19 05:11:32,REAL,2884597708,11301,2884609009,2901839557
2025-06-19 05:11:34,FAKE,2884609009,241,2884609250,2901849804
2025-06-19 05:11:36,REAL,2884609250,10247,2884619497,2901860051
2025-06-19 05:11:38,REAL,2884619497,10316,2884629813,2901870367
2025-06-19 05:11:40,REAL,2884629813,10257,2884640070,2901880624
2025-06-19 05:11:42,REAL,2884640070,10253,2884650323,2901890877
2025-06-19 05:11:44,REAL,2884650323,10310,2884660633,2901901187
2025-06-19 05:11:46,REAL,2884660633,2399,2884663032,2901903586
2025-06-19 05:11:48,REAL,2884663032,476,2884663508,2901904062
2025-06-19 05:11:50,FAKE,2884663508,244,2884663752,2901904546
2025-06-19 05:11:52,REAL,2884663752,10470,2884674222,2901915016
2025-06-19 05:11:54,FAKE,2884674222,244,2884674466,2901925393
2025-06-19 05:11:56,REAL,2884674466,10252,2884684718,2901935645
2025-06-19 05:11:58,REAL,2884684718,10254,2884694972,2901945899
2025-06-19 05:12:00,REAL,2884694972,10327,2884705299,2901956226
2025-06-19 05:12:02,REAL,2884705299,10260,2884715559,2901966486
2025-06-19 05:12:04,REAL,2884715559,10252,2884725811,2901976738
2025-06-19 05:12:06,REAL,2884725811,6957,2884732768,2901983695
2025-06-19 05:12:08,REAL,2884732768,486,2884733254,2901984181
2025-06-19 05:12:10,FAKE,2884733254,241,2884733495,2901984722
2025-06-19 05:12:12,FAKE,2884733495,241,2884733736,2901985211
2025-06-19 05:12:14,REAL,2884733736,491,2884734227,2901985702
2025-06-19 05:12:16,REAL,2884734227,479,2884734706,2901986181
2025-06-19 05:12:18,REAL,2884734706,490,2884735196,2901986671
2025-06-19 05:12:20,REAL,2884735196,478,2884735674,2901987149
2025-06-19 05:12:22,FAKE,2884735674,241,2884735915,2901987627
2025-06-19 05:12:24,REAL,2884735915,11312,2884747227,2901998939
2025-06-19 05:12:26,FAKE,2884747227,238,2884747465,2902009393
2025-06-19 05:12:28,REAL,2884747465,10256,2884757721,2902019649
2025-06-19 05:12:30,REAL,2884757721,10247,2884767968,2902029896
2025-06-19 05:12:32,REAL,2884767968,10308,2884778276,2902040204
2025-06-19 05:12:34,FAKE,2884778276,244,2884778520,2902050457
2025-06-19 05:12:36,FAKE,2884778520,243,2884778763,2902060711
2025-06-19 05:12:38,REAL,2884778763,6356,2884785119,2902067067
2025-06-19 05:12:40,FAKE,2884785119,244,2884785363,2902067552
2025-06-19 05:12:42,FAKE,2884785363,243,2884785606,2902068032
2025-06-19 05:12:44,FAKE,2884785606,244,2884785850,2902068513
2025-06-19 05:12:46,REAL,2884785850,485,2884786335,2902068998
2025-06-19 05:12:48,REAL,2884786335,491,2884786826,2902069489
2025-06-19 05:12:50,REAL,2884786826,479,2884787305,2902069968
2025-06-19 05:12:52,REAL,2884787305,484,2884787789,2902070452
2025-06-19 05:12:54,REAL,2884787789,533,2884788322,2902070985
2025-06-19 05:12:56,REAL,2884788322,482,2884788804,2902071467
2025-06-19 05:12:58,FAKE,2884788804,238,2884789042,2902071948
2025-06-19 05:13:00,REAL,2884789042,482,2884789524,2902072430
2025-06-19 05:13:02,FAKE,2884789524,243,2884789767,2902072913
2025-06-19 05:13:04,REAL,2884789767,478,2884790245,2902073391
2025-06-19 05:13:06,FAKE,2884790245,238,2884790483,2902073879
2025-06-19 05:13:08,REAL,2884790483,484,2884790967,2902074363
2025-06-19 05:13:10,FAKE,2884790967,244,2884791211,2902074844
2025-06-19 05:13:12,REAL,2884791211,474,2884791685,2902075318
2025-06-19 05:13:14,REAL,2884791685,537,2884792222,2902075855
2025-06-19 05:13:16,REAL,2884792222,6372,2884798594,2902082227
2025-06-19 05:13:18,FAKE,2884798594,238,2884798832,2902093334
2025-06-19 05:13:20,FAKE,2884798832,241,2884799073,2902103589
2025-06-19 05:13:22,REAL,2884799073,10252,2884809325,2902113841
2025-06-19 05:13:24,REAL,2884809325,10246,2884819571,2902124087
2025-06-19 05:13:26,REAL,2884819571,10310,2884829881,2902134397
2025-06-19 05:13:28,FAKE,2884829881,241,2884830122,2902144651
2025-06-19 05:13:30,REAL,2884830122,10251,2884840373,2902154902
2025-06-19 05:13:32,FAKE,2884840373,244,2884840617,2902155388
2025-06-19 05:13:34,REAL,2884840617,484,2884841101,2902155872
2025-06-19 05:13:36,REAL,2884841101,478,2884841579,2902156350
2025-06-19 05:13:38,FAKE,2884841579,238,2884841817,2902156827
2025-06-19 05:13:40,REAL,2884841817,485,2884842302,2902157312
2025-06-19 05:13:42,REAL,2884842302,547,2884842849,2902157859
2025-06-19 05:13:44,FAKE,2884842849,241,2884843090,2902158349
2025-06-19 05:13:46,FAKE,2884843090,243,2884843333,2902158834
2025-06-19 05:13:48,FAKE,2884843333,238,2884843571,2902159317
2025-06-19 05:13:50,REAL,2884843571,482,2884844053,2902159799
2025-06-19 05:13:52,REAL,2884844053,479,2884844532,2902160278
2025-06-19 05:13:54,REAL,2884844532,487,2884845019,2902160765
2025-06-19 05:13:56,REAL,2884845019,482,2884845501,2902161247
2025-06-19 05:13:58,REAL,2884845501,491,2884845992,2902161738
2025-06-19 05:14:00,REAL,2884845992,490,2884846482,2902162228
2025-06-19 05:14:02,FAKE,2884846482,238,2884846720,2902162710
2025-06-19 05:14:04,REAL,2884846720,540,2884847260,2902163250
2025-06-19 05:14:06,REAL,2884847260,486,2884847746,2902163736
2025-06-19 05:14:08,REAL,2884847746,490,2884848236,2902164226
2025-06-19 05:14:10,REAL,2884848236,480,2884848716,2902164706
2025-06-19 05:14:12,REAL,2884848716,485,2884849201,2902165191
2025-06-19 05:14:14,REAL,2884849201,488,2884849689,2902165679
2025-06-19 05:14:16,FAKE,2884849689,238,2884849927,2902166166
2025-06-19 05:14:18,REAL,2884849927,489,2884850416,2902166655
2025-06-19 05:14:20,REAL,2884850416,490,2884850906,2902167145
2025-06-19 05:14:22,REAL,2884850906,487,2884851393,2902167632
2025-06-19 05:14:24,REAL,2884851393,485,2884851878,2902168117
2025-06-19 05:14:26,FAKE,2884851878,238,2884852116,2902168609
2025-06-19 05:14:28,REAL,2884852116,541,2884852657,2902169150
2025-06-19 05:14:30,REAL,2884852657,490,2884853147,2902169640
2025-06-19 05:14:32,FAKE,2884853147,238,2884853385,2902170131
2025-06-19 05:14:34,FAKE,2884853385,241,2884853626,2902170623
2025-06-19 05:14:36,FAKE,2884853626,238,2884853864,2902171112
2025-06-19 05:14:38,REAL,2884853864,484,2884854348,2902171596
2025-06-19 05:14:40,REAL,2884854348,475,2884854823,2902172071
2025-06-19 05:14:42,REAL,2884854823,484,2884855307,2902172555
2025-06-19 05:14:44,FAKE,2884855307,241,2884855548,2902173034
2025-06-19 05:14:46,REAL,2884855548,480,2884856028,2902173514
2025-06-19 05:14:48,FAKE,2884856028,238,2884856266,2902173997
2025-06-19 05:14:50,REAL,2884856266,2266,2884858532,2902176263
2025-06-19 05:14:52,REAL,2884858532,11828,2884870360,2902188091
2025-06-19 05:14:54,FAKE,2884870360,243,2884870603,2902198404
2025-06-19 05:14:56,REAL,2884870603,10253,2884880856,2902208657
2025-06-19 05:14:58,REAL,2884880856,10255,2884891111,2902218912
2025-06-19 05:15:00,FAKE,2884891111,244,2884891355,2902229165
2025-06-19 05:15:02,REAL,2884891355,10247,2884901602,2902239412
2025-06-19 05:15:04,FAKE,2884901602,244,2884901846,2902249728
2025-06-19 05:15:06,FAKE,2884901846,238,2884902084,2902253577
2025-06-19 05:15:08,REAL,2884902084,485,2884902569,2902254062
2025-06-19 05:15:10,REAL,2884902569,493,2884903062,2902254555
2025-06-19 05:15:12,FAKE,2884903062,241,2884903303,2902255036
2025-06-19 05:15:14,REAL,2884903303,482,2884903785,2902255518
2025-06-19 05:15:16,REAL,2884903785,546,2884904331,2902256064
2025-06-19 05:15:18,REAL,2884904331,488,2884904819,2902256552
2025-06-19 05:15:20,REAL,2884904819,485,2884905304,2902257037
2025-06-19 05:15:22,REAL,2884905304,484,2884905788,2902257521
2025-06-19 05:15:24,FAKE,2884905788,241,2884906029,2902258013
2025-06-19 05:15:26,REAL,2884906029,492,2884906521,2902258505
2025-06-19 05:15:28,REAL,2884906521,484,2884907005,2902258989
2025-06-19 05:15:30,REAL,2884907005,477,2884907482,2902259466
2025-06-19 05:15:32,REAL,2884907482,491,2884907973,2902259957
2025-06-19 05:15:34,REAL,2884907973,490,2884908463,2902260447
2025-06-19 05:15:36,FAKE,2884908463,238,2884908701,2902260931
2025-06-19 05:15:38,REAL,2884908701,478,2884909179,2902261409
2025-06-19 05:15:40,REAL,2884909179,542,2884909721,2902261951
2025-06-19 05:15:42,REAL,2884909721,485,2884910206,2902262436
2025-06-19 05:15:44,REAL,2884910206,485,2884910691,2902262921
2025-06-19 05:15:46,REAL,2884910691,481,2884911172,2902263402
2025-06-19 05:15:48,REAL,2884911172,486,2884911658,2902263888
2025-06-19 05:15:50,REAL,2884911658,487,2884912145,2902264375
2025-06-19 05:15:52,FAKE,2884912145,241,2884912386,2902264856
2025-06-19 05:15:54,FAKE,2884912386,244,2884912630,2902265335
2025-06-19 05:15:56,FAKE,2884912630,238,2884912868,2902265821
2025-06-19 05:15:58,REAL,2884912868,488,2884913356,2902266309
2025-06-19 05:16:00,REAL,2884913356,478,2884913834,2902266787
2025-06-19 05:16:02,REAL,2884913834,541,2884914375,2902267328
2025-06-19 05:16:04,FAKE,2884914375,241,2884914616,2902267807
2025-06-19 05:16:06,REAL,2884914616,481,2884915097,2902268288
2025-06-19 05:16:08,REAL,2884915097,480,2884915577,2902268768
2025-06-19 05:16:10,REAL,2884915577,3920,2884919497,2902272688
2025-06-19 05:16:12,REAL,2884919497,14541,2884934038,2902287229
2025-06-19 05:16:14,REAL,2884934038,10247,2884944285,2902297476
2025-06-19 05:16:16,FAKE,2884944285,241,2884944526,2902307726
2025-06-19 05:16:18,REAL,2884944526,10248,2884954774,2902317974
2025-06-19 05:16:20,REAL,2884954774,10251,2884965025,2902328225
2025-06-19 05:16:22,FAKE,2884965025,243,2884965268,2902338474
2025-06-19 05:16:24,REAL,2884965268,10250,2884975518,2902348724
2025-06-19 05:16:26,REAL,2884975518,2332,2884977850,2902351056
2025-06-19 05:16:28,FAKE,2884977850,241,2884978091,2902351536
2025-06-19 05:16:30,FAKE,2884978091,244,2884978335,2902352021
2025-06-19 05:16:32,FAKE,2884978335,243,2884978578,2902362171
2025-06-19 05:16:34,FAKE,2884978578,241,2884978819,2902372678
2025-06-19 05:16:36,REAL,2884978819,10255,2884989074,2902382933
2025-06-19 05:16:38,FAKE,2884989074,238,2884989312,2902393184
2025-06-19 05:16:40,REAL,2884989312,10319,2884999631,2902403503
2025-06-19 05:16:42,FAKE,2884999631,243,2884999874,2902413752
2025-06-19 05:16:44,REAL,2884999874,10248,2885010122,2902424000
2025-06-19 05:16:46,FAKE,2885010122,244,2885010366,2902431021
2025-06-19 05:16:48,FAKE,2885010366,244,2885010610,2902431508
2025-06-19 05:16:50,REAL,2885010610,547,2885011157,2902432055
2025-06-19 05:16:52,REAL,2885011157,485,2885011642,2902432540
2025-06-19 05:16:54,REAL,2885011642,482,2885012124,2902433022
2025-06-19 05:16:56,FAKE,2885012124,243,2885012367,2902433508
2025-06-19 05:16:58,REAL,2885012367,484,2885012851,2902433992
2025-06-19 05:17:00,FAKE,2885012851,244,2885013095,2902434474
2025-06-19 05:17:02,FAKE,2885013095,238,2885013333,2902434962
2025-06-19 05:17:04,REAL,2885013333,481,2885013814,2902435443
2025-06-19 05:17:06,REAL,2885013814,491,2885014305,2902435934
2025-06-19 05:17:08,REAL,2885014305,486,2885014791,2902436420
2025-06-19 05:17:10,REAL,2885014791,488,2885015279,2902436908
2025-06-19 05:17:12,FAKE,2885015279,243,2885015522,2902437398
2025-06-19 05:17:14,REAL,2885015522,482,2885016004,2902437880
2025-06-19 05:17:16,REAL,2885016004,493,2885016497,2902438373
2025-06-19 05:17:18,REAL,2885016497,491,2885016988,2902438864
2025-06-19 05:17:20,REAL,2885016988,483,2885017471,2902439347
2025-06-19 05:17:22,REAL,2885017471,548,2885018019,2902439895
2025-06-19 05:17:24,REAL,2885018019,5445,2885023464,2902445340
2025-06-19 05:17:26,FAKE,2885023464,241,2885023705,2902456053
2025-06-19 05:17:28,REAL,2885023705,10245,2885033950,2902466298
2025-06-19 05:17:30,REAL,2885033950,10242,2885044192,2902476540
2025-06-19 05:17:32,REAL,2885044192,10323,2885054515,2902486863
2025-06-19 05:17:34,FAKE,2885054515,243,2885054758,2902497112
2025-06-19 05:17:36,REAL,2885054758,10301,2885065059,2902507413
2025-06-19 05:17:38,REAL,2885065059,10314,2885075373,2902517727
2025-06-19 05:17:40,REAL,2885075373,1141,2885076514,2902518868
2025-06-19 05:17:42,REAL,2885076514,489,2885077003,2902519357
2025-06-19 05:17:44,REAL,2885077003,484,2885077487,2902519841
2025-06-19 05:17:46,FAKE,2885077487,241,2885077728,2902520330
2025-06-19 05:17:48,REAL,2885077728,483,2885078211,2902520813
2025-06-19 05:17:50,REAL,2885078211,482,2885078693,2902521295
2025-06-19 05:17:52,FAKE,2885078693,241,2885078934,2902521787
2025-06-19 05:17:54,FAKE,2885078934,241,2885079175,2902522269
2025-06-19 05:17:56,REAL,2885079175,7363,2885086538,2902529632
2025-06-19 05:17:58,REAL,2885086538,13307,2885099845,2902542939
2025-06-19 05:18:00,REAL,2885099845,10252,2885110097,2902553191
2025-06-19 05:18:02,FAKE,2885110097,244,2885110341,2902563514
2025-06-19 05:18:04,FAKE,2885110341,238,2885110579,2902573821
2025-06-19 05:18:06,FAKE,2885110579,241,2885110820,2902584067
2025-06-19 05:18:08,FAKE,2885110820,243,2885111063,2902594388
2025-06-19 05:18:10,FAKE,2885111063,244,2885111307,2902604577
2025-06-19 05:18:12,REAL,2885111307,480,2885111787,2902605057
2025-06-19 05:18:14,FAKE,2885111787,243,2885112030,2902605541
2025-06-19 05:18:16,REAL,2885112030,483,2885112513,2902606024
2025-06-19 05:18:18,FAKE,2885112513,243,2885112756,2902606511
2025-06-19 05:18:20,REAL,2885112756,479,2885113235,2902606990
2025-06-19 05:18:22,REAL,2885113235,479,2885113714,2902607469
2025-06-19 05:18:24,REAL,2885113714,476,2885114190,2902607945
2025-06-19 05:18:26,REAL,2885114190,485,2885114675,2902608430
2025-06-19 05:18:28,REAL,2885114675,481,2885115156,2902608911
2025-06-19 05:18:30,FAKE,2885115156,238,2885115394,2902609452
2025-06-19 05:18:32,REAL,2885115394,486,2885115880,2902609938
2025-06-19 05:18:34,FAKE,2885115880,244,2885116124,2902610428
2025-06-19 05:18:36,FAKE,2885116124,244,2885116368,2902610908
2025-06-19 05:18:38,REAL,2885116368,491,2885116859,2902611399
2025-06-19 05:18:40,REAL,2885116859,541,2885117400,2902611940
2025-06-19 05:18:42,REAL,2885117400,480,2885117880,2902612420
2025-06-19 05:18:44,FAKE,2885117880,238,2885118118,2902612903
2025-06-19 05:18:46,REAL,2885118118,483,2885118601,2902613386
2025-06-19 05:18:48,FAKE,2885118601,244,2885118845,2902613871
2025-06-19 05:18:50,REAL,2885118845,488,2885119333,2902614359
2025-06-19 05:18:52,FAKE,2885119333,241,2885119574,2902614842
2025-06-19 05:18:54,FAKE,2885119574,244,2885119818,2902615327
2025-06-19 05:18:56,REAL,2885119818,543,2885120361,2902615870
2025-06-19 05:18:58,REAL,2885120361,490,2885120851,2902616360
2025-06-19 05:19:00,REAL,2885120851,483,2885121334,2902616843
2025-06-19 05:19:02,REAL,2885121334,486,2885121820,2902617329
2025-06-19 05:19:04,REAL,2885121820,476,2885122296,2902617805
2025-06-19 05:19:06,FAKE,2885122296,244,2885122540,2902618279
2025-06-19 05:19:08,REAL,2885122540,483,2885123023,2902618762
2025-06-19 05:19:10,REAL,2885123023,481,2885123504,2902619243
2025-06-19 05:19:12,FAKE,2885123504,238,2885123742,2902619730
2025-06-19 05:19:14,FAKE,2885123742,238,2885123980,2902620213
2025-06-19 05:19:16,REAL,2885123980,487,2885124467,2902620700
2025-06-19 05:19:18,FAKE,2885124467,243,2885124710,2902621177
2025-06-19 05:19:20,REAL,2885124710,481,2885125191,2902621658
2025-06-19 05:19:22,REAL,2885125191,587,2885125778,2902622245
2025-06-19 05:19:24,REAL,2885125778,484,2885126262,2902622729
2025-06-19 05:19:26,FAKE,2885126262,243,2885126505,2902623217
2025-06-19 05:19:28,REAL,2885126505,485,2885126990,2902623702
2025-06-19 05:19:30,FAKE,2885126990,244,2885127234,2902624186
2025-06-19 05:19:32,FAKE,2885127234,241,2885127475,2902624670
2025-06-19 05:19:34,FAKE,2885127475,241,2885127716,2902625150
2025-06-19 05:19:36,FAKE,2885127716,241,2885127957,2902625628
2025-06-19 05:19:38,REAL,2885127957,480,2885128437,2902626108
2025-06-19 05:19:40,REAL,2885128437,489,2885128926,2902626597
2025-06-19 05:19:42,REAL,2885128926,482,2885129408,2902627079
2025-06-19 05:19:44,FAKE,2885129408,238,2885129646,2902627564
2025-06-19 05:19:46,FAKE,2885129646,244,2885129890,2902628050
2025-06-19 05:19:48,FAKE,2885129890,243,2885130133,2902628533
2025-06-19 05:19:50,FAKE,2885130133,241,2885130374,2902629072
2025-06-19 05:19:52,REAL,2885130374,485,2885130859,2902629557
2025-06-19 05:19:54,FAKE,2885130859,238,2885131097,2902630038
2025-06-19 05:19:56,FAKE,2885131097,241,2885131338,2902630523
2025-06-19 05:19:58,REAL,2885131338,8669,2885140007,2902639192
2025-06-19 05:20:00,REAL,2885140007,10907,2885150914,2902650099
2025-06-19 05:20:02,REAL,2885150914,10249,2885161163,2902660348
2025-06-19 05:20:04,REAL,2885161163,10249,2885171412,2902670597
2025-06-19 05:20:06,REAL,2885171412,10260,2885181672,2902680857
2025-06-19 05:20:08,FAKE,2885181672,241,2885181913,2902691109
2025-06-19 05:20:10,FAKE,2885181913,244,2885182157,2902701364
2025-06-19 05:20:12,REAL,2885182157,8132,2885190289,2902709496
2025-06-19 05:20:14,REAL,2885190289,482,2885190771,2902709978
2025-06-19 05:20:16,REAL,2885190771,538,2885191309,2902710516
2025-06-19 05:20:18,REAL,2885191309,490,2885191799,2902711006
2025-06-19 05:20:20,FAKE,2885191799,238,2885192037,2902711489
2025-06-19 05:20:22,REAL,2885192037,479,2885192516,2902711968
2025-06-19 05:20:24,REAL,2885192516,484,2885193000,2902712452
2025-06-19 05:20:26,REAL,2885193000,483,2885193483,2902712935
2025-06-19 05:20:28,FAKE,2885193483,241,2885193724,2902713418
2025-06-19 05:20:30,FAKE,2885193724,241,2885193965,2902713901
2025-06-19 05:20:32,REAL,2885193965,478,2885194443,2902714379
2025-06-19 05:20:34,REAL,2885194443,482,2885194925,2902714861
2025-06-19 05:20:36,FAKE,2885194925,238,2885195163,2902715342
2025-06-19 05:20:38,FAKE,2885195163,238,2885195401,2902715831
2025-06-19 05:20:40,REAL,2885195401,530,2885195931,2902716361
2025-06-19 05:20:42,REAL,2885195931,535,2885196466,2902716896
2025-06-19 05:20:44,REAL,2885196466,483,2885196949,2902717379
2025-06-19 05:20:46,FAKE,2885196949,238,2885197187,2902717866
2025-06-19 05:20:48,REAL,2885197187,480,2885197667,2902718346
2025-06-19 05:20:50,FAKE,2885197667,238,2885197905,2902722131
2025-06-19 05:20:52,FAKE,2885197905,238,2885198143,2902733380
2025-06-19 05:20:54,REAL,2885198143,10318,2885208461,2902743698
2025-06-19 05:20:56,REAL,2885208461,10253,2885218714,2902753951
2025-06-19 05:20:58,FAKE,2885218714,238,2885218952,2902764206
2025-06-19 05:21:00,REAL,2885218952,10317,2885229269,2902774523
2025-06-19 05:21:02,REAL,2885229269,10258,2885239527,2902784781
2025-06-19 05:21:04,REAL,2885239527,10253,2885249780,2902795034
2025-06-19 05:21:06,REAL,2885249780,2461,2885252241,2902797495
2025-06-19 05:21:08,REAL,2885252241,491,2885252732,2902797986
2025-06-19 05:21:10,FAKE,2885252732,244,2885252976,2902798526
2025-06-19 05:21:12,FAKE,2885252976,241,2885253217,2902799007
2025-06-19 05:21:14,REAL,2885253217,490,2885253707,2902799497
2025-06-19 05:21:16,FAKE,2885253707,241,2885253948,2902799980
2025-06-19 05:21:18,REAL,2885253948,479,2885254427,2902800459
2025-06-19 05:21:20,FAKE,2885254427,238,2885254665,2902800950
2025-06-19 05:21:22,REAL,2885254665,4393,2885259058,2902805343
2025-06-19 05:21:24,FAKE,2885259058,241,2885259299,2902816714
2025-06-19 05:21:26,REAL,2885259299,10256,2885269555,2902826970
2025-06-19 05:21:28,REAL,2885269555,10250,2885279805,2902837220
2025-06-19 05:21:30,REAL,2885279805,10260,2885290065,2902847480
2025-06-19 05:21:32,FAKE,2885290065,238,2885290303,2902857797
2025-06-19 05:21:34,REAL,2885290303,10254,2885300557,2902868051
2025-06-19 05:21:36,FAKE,2885300557,243,2885300800,2902878357
2025-06-19 05:21:38,REAL,2885300800,1871,2885302671,2902880228
2025-06-19 05:21:40,REAL,2885302671,489,2885303160,2902880717
2025-06-19 05:21:42,REAL,2885303160,477,2885303637,2902881194
2025-06-19 05:21:44,REAL,2885303637,484,2885304121,2902881678
2025-06-19 05:21:46,REAL,2885304121,481,2885304602,2902882159
2025-06-19 05:21:48,REAL,2885304602,487,2885305089,2902882646
2025-06-19 05:21:50,REAL,2885305089,478,2885305567,2902883124
2025-06-19 05:21:52,FAKE,2885305567,244,2885305811,2902883609
2025-06-19 05:21:54,REAL,2885305811,483,2885306294,2902884092
2025-06-19 05:21:56,REAL,2885306294,486,2885306780,2902884578
2025-06-19 05:21:58,REAL,2885306780,490,2885307270,2902885068
2025-06-19 05:22:00,REAL,2885307270,490,2885307760,2902885558
2025-06-19 05:22:02,FAKE,2885307760,238,2885307998,2902886097
2025-06-19 05:22:04,REAL,2885307998,483,2885308481,2902886580
2025-06-19 05:22:06,REAL,2885308481,541,2885309022,2902887121
2025-06-19 05:22:08,REAL,2885309022,479,2885309501,2902887600
2025-06-19 05:22:10,REAL,2885309501,486,2885309987,2902888086
2025-06-19 05:22:12,REAL,2885309987,484,2885310471,2902888570
2025-06-19 05:22:14,FAKE,2885310471,243,2885310714,2902889054
2025-06-19 05:22:16,REAL,2885310714,484,2885311198,2902889538
2025-06-19 05:22:18,REAL,2885311198,483,2885311681,2902890021
2025-06-19 05:22:20,FAKE,2885311681,243,2885311924,2902890503
2025-06-19 05:22:22,REAL,2885311924,484,2885312408,2902890987
2025-06-19 05:22:24,REAL,2885312408,486,2885312894,2902891473
2025-06-19 05:22:26,REAL,2885312894,485,2885313379,2902891958
2025-06-19 05:22:28,REAL,2885313379,484,2885313863,2902892442
2025-06-19 05:22:30,REAL,2885313863,541,2885314404,2902892983
2025-06-19 05:22:32,REAL,2885314404,478,2885314882,2902893461
2025-06-19 05:22:34,REAL,2885314882,486,2885315368,2902893947
2025-06-19 05:22:36,REAL,2885315368,6236,2885321604,2902900183
2025-06-19 05:22:38,REAL,2885321604,10848,2885332452,2902911031
2025-06-19 05:22:40,FAKE,2885332452,241,2885332693,2902921276
2025-06-19 05:22:42,REAL,2885332693,10310,2885343003,2902931586
2025-06-19 05:22:44,REAL,2885343003,10314,2885353317,2902941900
2025-06-19 05:22:46,REAL,2885353317,10257,2885363574,2902952157
2025-06-19 05:22:48,FAKE,2885363574,244,2885363818,2902962474
2025-06-19 05:22:50,FAKE,2885363818,241,2885364059,2902972782
2025-06-19 05:22:52,REAL,2885364059,483,2885364542,2902973265
2025-06-19 05:22:54,REAL,2885364542,490,2885365032,2902973755
2025-06-19 05:22:56,REAL,2885365032,481,2885365513,2902974236
2025-06-19 05:22:58,REAL,2885365513,484,2885365997,2902974720
2025-06-19 05:23:00,REAL,2885365997,540,2885366537,2902975260
2025-06-19 05:23:02,FAKE,2885366537,244,2885366781,2902975737
2025-06-19 05:23:04,REAL,2885366781,482,2885367263,2902976219
2025-06-19 05:23:06,REAL,2885367263,484,2885367747,2902976703
2025-06-19 05:23:08,REAL,2885367747,8606,2885376353,2902985309
2025-06-19 05:23:10,REAL,2885376353,11443,2885387796,2902996752
2025-06-19 05:23:12,FAKE,2885387796,241,2885388037,2903007003
2025-06-19 05:23:14,FAKE,2885388037,243,2885388280,2903017252
2025-06-19 05:23:16,REAL,2885388280,10313,2885398593,2903027565
2025-06-19 05:23:18,FAKE,2885398593,243,2885398836,2903037826
2025-06-19 05:23:20,REAL,2885398836,10246,2885409082,2903048072
2025-06-19 05:23:22,FAKE,2885409082,243,2885409325,2903057726
2025-06-19 05:23:24,FAKE,2885409325,244,2885409569,2903058212
2025-06-19 05:23:26,REAL,2885409569,480,2885410049,2903058692
2025-06-19 05:23:28,FAKE,2885410049,243,2885410292,2903059166
2025-06-19 05:23:30,FAKE,2885410292,238,2885410530,2903059647
2025-06-19 05:23:32,REAL,2885410530,540,2885411070,2903060187
2025-06-19 05:23:34,FAKE,2885411070,244,2885411314,2903060673
2025-06-19 05:23:36,FAKE,2885411314,244,2885411558,2903061152
2025-06-19 05:23:38,FAKE,2885411558,244,2885411802,2903061634
2025-06-19 05:23:40,REAL,2885411802,482,2885412284,2903062116
2025-06-19 05:23:42,FAKE,2885412284,243,2885412527,2903062594
2025-06-19 05:23:44,REAL,2885412527,492,2885413019,2903063086
2025-06-19 05:23:46,REAL,2885413019,486,2885413505,2903063572
2025-06-19 05:23:48,FAKE,2885413505,238,2885413743,2903064052
2025-06-19 05:23:50,FAKE,2885413743,244,2885413987,2903064534
2025-06-19 05:23:52,REAL,2885413987,483,2885414470,2903065017
2025-06-19 05:23:54,REAL,2885414470,492,2885414962,2903065509
2025-06-19 05:23:56,REAL,2885414962,534,2885415496,2903066043
2025-06-19 05:23:58,FAKE,2885415496,244,2885415740,2903066522
2025-06-19 05:24:00,FAKE,2885415740,238,2885415978,2903067002
2025-06-19 05:24:02,REAL,2885415978,539,2885416517,2903067541
2025-06-19 05:24:04,FAKE,2885416517,244,2885416761,2903068021
2025-06-19 05:24:06,REAL,2885416761,482,2885417243,2903068503
2025-06-19 05:24:08,REAL,2885417243,476,2885417719,2903068979
2025-06-19 05:24:10,REAL,2885417719,483,2885418202,2903069462
2025-06-19 05:24:12,REAL,2885418202,485,2885418687,2903069947
2025-06-19 05:24:14,FAKE,2885418687,243,2885418930,2903070424
2025-06-19 05:24:16,REAL,2885418930,491,2885419421,2903070915
2025-06-19 05:24:18,REAL,2885419421,475,2885419896,2903071390
2025-06-19 05:24:20,REAL,2885419896,481,2885420377,2903071871
2025-06-19 05:24:22,REAL,2885420377,482,2885420859,2903072353
2025-06-19 05:24:24,REAL,2885420859,491,2885421350,2903072844
2025-06-19 05:24:26,FAKE,2885421350,244,2885421594,2903073326
2025-06-19 05:24:28,REAL,2885421594,479,2885422073,2903073805
2025-06-19 05:24:30,REAL,2885422073,487,2885422560,2903074292
2025-06-19 05:24:32,FAKE,2885422560,238,2885422798,2903074834
2025-06-19 05:24:34,REAL,2885422798,486,2885423284,2903075320
2025-06-19 05:24:36,FAKE,2885423284,241,2885423525,2903075798
2025-06-19 05:24:38,REAL,2885423525,491,2885424016,2903076289
2025-06-19 05:24:40,REAL,2885424016,482,2885424498,2903076771
2025-06-19 05:24:42,FAKE,2885424498,244,2885424742,2903077261
2025-06-19 05:24:44,REAL,2885424742,484,2885425226,2903077745
2025-06-19 05:24:46,REAL,2885425226,536,2885425762,2903078281
2025-06-19 05:24:48,FAKE,2885425762,243,2885426005,2903081612
2025-06-19 05:24:50,REAL,2885426005,11774,2885437779,2903093386
2025-06-19 05:24:52,FAKE,2885437779,238,2885438017,2903103638
2025-06-19 05:24:54,REAL,2885438017,10249,2885448266,2903113887
2025-06-19 05:24:56,FAKE,2885448266,243,2885448509,2903124201
2025-06-19 05:24:58,FAKE,2885448509,238,2885448747,2903134445
2025-06-19 05:25:00,FAKE,2885448747,241,2885448988,2903144690
2025-06-19 05:25:02,REAL,2885448988,10314,2885459302,2903155004
2025-06-19 05:25:04,REAL,2885459302,2980,2885462282,2903157984
2025-06-19 05:25:06,FAKE,2885462282,238,2885462520,2903158475
2025-06-19 05:25:08,REAL,2885462520,491,2885463011,2903158966
2025-06-19 05:25:10,REAL,2885463011,485,2885463496,2903159451
2025-06-19 05:25:12,FAKE,2885463496,241,2885463737,2903159942
2025-06-19 05:25:14,FAKE,2885463737,244,2885463981,2903160421
2025-06-19 05:25:16,REAL,2885463981,481,2885464462,2903160902
2025-06-19 05:25:18,FAKE,2885464462,241,2885464703,2903161380
2025-06-19 05:25:20,REAL,2885464703,3727,2885468430,2903165107
2025-06-19 05:25:22,REAL,2885468430,11045,2885479475,2903176152
2025-06-19 05:25:24,REAL,2885479475,10246,2885489721,2903186398
2025-06-19 05:25:26,REAL,2885489721,10320,2885500041,2903196718
2025-06-19 05:25:28,FAKE,2885500041,244,2885500285,2903206966
2025-06-19 05:25:30,REAL,2885500285,10319,2885510604,2903217285
2025-06-19 05:25:32,REAL,2885510604,10323,2885520927,2903227608
2025-06-19 05:25:34,FAKE,2885520927,238,2885521165,2903237919
2025-06-19 05:25:36,REAL,2885521165,2403,2885523568,2903240322
2025-06-19 05:25:38,REAL,2885523568,487,2885524055,2903240809
2025-06-19 05:25:40,REAL,2885524055,483,2885524538,2903241292
2025-06-19 05:25:42,REAL,2885524538,484,2885525022,2903241776
2025-06-19 05:25:44,REAL,2885525022,480,2885525502,2903242256
2025-06-19 05:25:46,REAL,2885525502,481,2885525983,2903242737
2025-06-19 05:25:48,REAL,2885525983,491,2885526474,2903243228
2025-06-19 05:25:50,REAL,2885526474,490,2885526964,2903243718
2025-06-19 05:25:52,FAKE,2885526964,243,2885527207,2903244198
2025-06-19 05:25:54,REAL,2885527207,487,2885527694,2903244685
2025-06-19 05:25:56,REAL,2885527694,476,2885528170,2903245161
2025-06-19 05:25:58,REAL,2885528170,478,2885528648,2903245639
2025-06-19 05:26:00,REAL,2885528648,482,2885529130,2903246121
2025-06-19 05:26:02,REAL,2885529130,487,2885529617,2903246608
2025-06-19 05:26:04,REAL,2885529617,536,2885530153,2903247144
2025-06-19 05:26:06,REAL,2885530153,482,2885530635,2903247626
2025-06-19 05:26:08,REAL,2885530635,533,2885531168,2903248159
2025-06-19 05:26:10,REAL,2885531168,479,2885531647,2903248638
2025-06-19 05:26:12,REAL,2885531647,486,2885532133,2903249124
2025-06-19 05:26:14,REAL,2885532133,482,2885532615,2903249606
2025-06-19 05:26:16,FAKE,2885532615,238,2885532853,2903250092
2025-06-19 05:26:18,REAL,2885532853,486,2885533339,2903250578
2025-06-19 05:26:20,REAL,2885533339,482,2885533821,2903251060
2025-06-19 05:26:22,REAL,2885533821,482,2885534303,2903251542
2025-06-19 05:26:24,REAL,2885534303,485,2885534788,2903252027
2025-06-19 05:26:26,REAL,2885534788,486,2885535274,2903252513
2025-06-19 05:26:28,FAKE,2885535274,243,2885535517,2903252995
2025-06-19 05:26:30,REAL,2885535517,484,2885536001,2903253479
2025-06-19 05:26:32,REAL,2885536001,484,2885536485,2903253963
2025-06-19 05:26:34,REAL,2885536485,479,2885536964,2903254442
2025-06-19 05:26:36,REAL,2885536964,534,2885537498,2903254976
2025-06-19 05:26:38,REAL,2885537498,491,2885537989,2903255467
2025-06-19 05:26:40,REAL,2885537989,481,2885538470,2903255948
2025-06-19 05:26:42,FAKE,2885538470,241,2885538711,2903256438
2025-06-19 05:26:44,FAKE,2885538711,238,2885538949,2903256678
2025-06-19 05:26:46,REAL,2885538949,12573,2885551522,2903269251
2025-06-19 05:26:48,REAL,2885551522,10322,2885561844,2903279573
2025-06-19 05:26:50,FAKE,2885561844,241,2885562085,2903289819
2025-06-19 05:26:52,FAKE,2885562085,243,2885562328,2903300135
2025-06-19 05:26:54,FAKE,2885562328,238,2885562566,2903310387
2025-06-19 05:26:56,REAL,2885562566,10251,2885572817,2903320638
2025-06-19 05:26:58,REAL,2885572817,10258,2885583075,2903330896
2025-06-19 05:27:00,REAL,2885583075,5831,2885588906,2903336727
2025-06-19 05:27:02,REAL,2885588906,484,2885589390,2903337211
2025-06-19 05:27:04,REAL,2885589390,488,2885589878,2903337699
2025-06-19 05:27:06,FAKE,2885589878,238,2885590116,2903338230
2025-06-19 05:27:08,FAKE,2885590116,243,2885590359,2903338707
2025-06-19 05:27:10,REAL,2885590359,482,2885590841,2903339189
2025-06-19 05:27:12,FAKE,2885590841,244,2885591085,2903339680
2025-06-19 05:27:14,FAKE,2885591085,238,2885591323,2903340156
2025-06-19 05:27:16,REAL,2885591323,487,2885591810,2903340643
2025-06-19 05:27:18,REAL,2885591810,11444,2885603254,2903352087
2025-06-19 05:27:20,REAL,2885603254,10249,2885613503,2903362336
2025-06-19 05:27:22,REAL,2885613503,10317,2885623820,2903372653
2025-06-19 05:27:24,REAL,2885623820,10250,2885634070,2903382903
2025-06-19 05:27:26,REAL,2885634070,10245,2885644315,2903393148
2025-06-19 05:27:28,REAL,2885644315,10252,2885654567,2903403400
2025-06-19 05:27:30,FAKE,2885654567,243,2885654810,2903413720
2025-06-19 05:27:32,REAL,2885654810,5170,2885659980,2903418890
2025-06-19 05:27:34,REAL,2885659980,478,2885660458,2903419368
2025-06-19 05:27:36,FAKE,2885660458,241,2885660699,2903419858
2025-06-19 05:27:38,FAKE,2885660699,244,2885660943,2903420395
2025-06-19 05:27:40,REAL,2885660943,489,2885661432,2903420884
2025-06-19 05:27:42,REAL,2885661432,483,2885661915,2903421367
2025-06-19 05:27:44,FAKE,2885661915,244,2885662159,2903421855
2025-06-19 05:27:46,REAL,2885662159,478,2885662637,2903422333
2025-06-19 05:27:48,REAL,2885662637,1219,2885663856,2903423552
2025-06-19 05:27:50,REAL,2885663856,11901,2885675757,2903435453
2025-06-19 05:27:52,FAKE,2885675757,241,2885675998,2903445697
2025-06-19 05:27:54,REAL,2885675998,10252,2885686250,2903455949
2025-06-19 05:27:56,REAL,2885686250,10322,2885696572,2903466271
2025-06-19 05:27:58,REAL,2885696572,10248,2885706820,2903476519
2025-06-19 05:28:00,REAL,2885706820,10252,2885717072,2903486771
2025-06-19 05:28:02,REAL,2885717072,10318,2885727390,2903497089
2025-06-19 05:28:04,REAL,2885727390,4514,2885731904,2903501603
2025-06-19 05:28:06,REAL,2885731904,484,2885732388,2903502087
2025-06-19 05:28:08,REAL,2885732388,482,2885732870,2903502569
2025-06-19 05:28:10,FAKE,2885732870,241,2885733111,2903503115
2025-06-19 05:28:12,REAL,2885733111,487,2885733598,2903503602
2025-06-19 05:28:14,REAL,2885733598,479,2885734077,2903504081
2025-06-19 05:28:16,REAL,2885734077,487,2885734564,2903504568
2025-06-19 05:28:18,REAL,2885734564,486,2885735050,2903505054
2025-06-19 05:28:20,REAL,2885735050,2336,2885737386,2903507390
2025-06-19 05:28:22,REAL,2885737386,11572,2885748958,2903518962
2025-06-19 05:28:24,REAL,2885748958,10247,2885759205,2903529209
2025-06-19 05:28:26,FAKE,2885759205,244,2885759449,2903539457
2025-06-19 05:28:28,REAL,2885759449,10312,2885769761,2903549769
2025-06-19 05:28:30,REAL,2885769761,10251,2885780012,2903560020
2025-06-19 05:28:32,REAL,2885780012,10250,2885790262,2903570270
2025-06-19 05:28:34,REAL,2885790262,10257,2885800519,2903580527
2025-06-19 05:28:36,REAL,2885800519,3978,2885804497,2903584505
2025-06-19 05:28:38,REAL,2885804497,487,2885804984,2903584992
2025-06-19 05:28:40,REAL,2885804984,483,2885805467,2903585475
2025-06-19 05:28:42,REAL,2885805467,543,2885806010,2903586018
2025-06-19 05:28:44,REAL,2885806010,485,2885806495,2903586503
2025-06-19 05:28:46,REAL,2885806495,478,2885806973,2903586981
2025-06-19 05:28:48,REAL,2885806973,480,2885807453,2903587461
2025-06-19 05:28:50,REAL,2885807453,485,2885807938,2903587946
2025-06-19 05:28:52,FAKE,2885807938,244,2885808182,2903588426
2025-06-19 05:28:54,FAKE,2885808182,241,2885808423,2903588912
2025-06-19 05:28:56,REAL,2885808423,541,2885808964,2903589453
2025-06-19 05:28:58,REAL,2885808964,481,2885809445,2903589934
2025-06-19 05:29:00,REAL,2885809445,480,2885809925,2903590414
2025-06-19 05:29:02,REAL,2885809925,483,2885810408,2903590897
2025-06-19 05:29:04,REAL,2885810408,480,2885810888,2903591377
2025-06-19 05:29:06,FAKE,2885810888,238,2885811126,2903591857
2025-06-19 05:29:08,FAKE,2885811126,244,2885811370,2903592337
2025-06-19 05:29:10,REAL,2885811370,477,2885811847,2903592814
2025-06-19 05:29:12,FAKE,2885811847,241,2885812088,2903593305
2025-06-19 05:29:14,REAL,2885812088,11117,2885823205,2903604422
2025-06-19 05:29:16,REAL,2885823205,11694,2885834899,2903616116
2025-06-19 05:29:18,REAL,2885834899,10247,2885845146,2903626363
2025-06-19 05:29:20,REAL,2885845146,10257,2885855403,2903636620
2025-06-19 05:29:22,FAKE,2885855403,244,2885855647,2903646870
2025-06-19 05:29:24,FAKE,2885855647,244,2885855891,2903657119
2025-06-19 05:29:26,REAL,2885855891,10311,2885866202,2903667430
2025-06-19 05:29:28,FAKE,2885866202,244,2885866446,2903675372
2025-06-19 05:29:30,REAL,2885866446,486,2885866932,2903675858
2025-06-19 05:29:32,FAKE,2885866932,244,2885867176,2903676350
2025-06-19 05:29:34,FAKE,2885867176,243,2885867419,2903676837
2025-06-19 05:29:36,REAL,2885867419,486,2885867905,2903677323
2025-06-19 05:29:38,REAL,2885867905,490,2885868395,2903677813
2025-06-19 05:29:40,REAL,2885868395,494,2885868889,2903678307
2025-06-19 05:29:42,REAL,2885868889,483,2885869372,2903678790
2025-06-19 05:29:44,REAL,2885869372,488,2885869860,2903679278
2025-06-19 05:29:46,FAKE,2885869860,243,2885870103,2903688673
2025-06-19 05:29:48,REAL,2885870103,10441,2885880544,2903699114
2025-06-19 05:29:50,REAL,2885880544,10251,2885890795,2903709365
2025-06-19 05:29:52,REAL,2885890795,10257,2885901052,2903719622
2025-06-19 05:29:54,REAL,2885901052,10249,2885911301,2903729871
2025-06-19 05:29:56,REAL,2885911301,10324,2885921625,2903740195
2025-06-19 05:29:58,REAL,2885921625,10250,2885931875,2903750445
2025-06-19 05:30:00,REAL,2885931875,7348,2885939223,2903757793
2025-06-19 05:30:02,REAL,2885939223,490,2885939713,2903758283
2025-06-19 05:30:04,REAL,2885939713,476,2885940189,2903758759
2025-06-19 05:30:06,REAL,2885940189,485,2885940674,2903759244
2025-06-19 05:30:08,FAKE,2885940674,243,2885940917,2903759729
2025-06-19 05:30:10,REAL,2885940917,490,2885941407,2903760219
2025-06-19 05:30:12,FAKE,2885941407,243,2885941650,2903760701
2025-06-19 05:30:14,REAL,2885941650,486,2885942136,2903761187
2025-06-19 05:30:16,REAL,2885942136,486,2885942622,2903761673
2025-06-19 05:30:18,REAL,2885942622,485,2885943107,2903762158
2025-06-19 05:30:20,REAL,2885943107,593,2885943700,2903762751
2025-06-19 05:30:22,FAKE,2885943700,238,2885943938,2903763235
2025-06-19 05:30:24,REAL,2885943938,488,2885944426,2903763723
2025-06-19 05:30:26,REAL,2885944426,481,2885944907,2903764204
2025-06-19 05:30:28,FAKE,2885944907,243,2885945150,2903764682
2025-06-19 05:30:30,REAL,2885945150,480,2885945630,2903765162
2025-06-19 05:30:32,REAL,2885945630,481,2885946111,2903765643
2025-06-19 05:30:34,REAL,2885946111,477,2885946588,2903766120
2025-06-19 05:30:36,FAKE,2885946588,238,2885946826,2903766595
2025-06-19 05:30:38,REAL,2885946826,489,2885947315,2903767084
2025-06-19 05:30:40,FAKE,2885947315,244,2885947559,2903767569
2025-06-19 05:30:42,REAL,2885947559,491,2885948050,2903768060
2025-06-19 05:30:44,FAKE,2885948050,244,2885948294,2903768544
2025-06-19 05:30:46,REAL,2885948294,481,2885948775,2903769025
2025-06-19 05:30:48,REAL,2885948775,486,2885949261,2903769511
2025-06-19 05:30:50,REAL,2885949261,488,2885949749,2903769999
2025-06-19 05:30:52,REAL,2885949749,483,2885950232,2903770482
2025-06-19 05:30:54,REAL,2885950232,586,2885950818,2903771068
2025-06-19 05:30:56,FAKE,2885950818,238,2885951056,2903771552
2025-06-19 05:30:58,REAL,2885951056,483,2885951539,2903772035
2025-06-19 05:31:00,REAL,2885951539,486,2885952025,2903772521
2025-06-19 05:31:02,REAL,2885952025,485,2885952510,2903773006
2025-06-19 05:31:04,REAL,2885952510,486,2885952996,2903773492
2025-06-19 05:31:06,FAKE,2885952996,244,2885953240,2903773975
2025-06-19 05:31:08,REAL,2885953240,478,2885953718,2903774453
2025-06-19 05:31:10,REAL,2885953718,5767,2885959485,2903780220
2025-06-19 05:31:12,FAKE,2885959485,244,2885959729,2903791528
2025-06-19 05:31:14,FAKE,2885959729,238,2885959967,2903801849
2025-06-19 05:31:16,FAKE,2885959967,243,2885960210,2903812100
2025-06-19 05:31:18,REAL,2885960210,10310,2885970520,2903822410
2025-06-19 05:31:20,REAL,2885970520,10252,2885980772,2903832662
2025-06-19 05:31:22,REAL,2885980772,10261,2885991033,2903842923
2025-06-19 05:31:24,REAL,2885991033,10314,2886001347,2903853237
2025-06-19 05:31:26,REAL,2886001347,939,2886002286,2903854176
2025-06-19 05:31:28,REAL,2886002286,489,2886002775,2903854665
2025-06-19 05:31:30,REAL,2886002775,489,2886003264,2903855154
2025-06-19 05:31:32,FAKE,2886003264,243,2886003507,2903855635
2025-06-19 05:31:34,REAL,2886003507,485,2886003992,2903856120
2025-06-19 05:31:36,REAL,2886003992,481,2886004473,2903856601
2025-06-19 05:31:38,REAL,2886004473,484,2886004957,2903857085
2025-06-19 05:31:40,FAKE,2886004957,244,2886005201,2903857566
2025-06-19 05:31:42,FAKE,2886005201,244,2886005445,2903858053
2025-06-19 05:31:44,REAL,2886005445,539,2886005984,2903858592
2025-06-19 05:31:46,REAL,2886005984,485,2886006469,2903859077
2025-06-19 05:31:48,FAKE,2886006469,243,2886006712,2903859564
2025-06-19 05:31:50,REAL,2886006712,484,2886007196,2903860048
2025-06-19 05:31:52,REAL,2886007196,493,2886007689,2903860541
2025-06-19 05:31:54,REAL,2886007689,480,2886008169,2903861021
2025-06-19 05:31:56,FAKE,2886008169,238,2886008407,2903861505
2025-06-19 05:31:58,FAKE,2886008407,244,2886008651,2903862050
2025-06-19 05:32:00,FAKE,2886008651,244,2886008895,2903862535
2025-06-19 05:32:02,REAL,2886008895,485,2886009380,2903863020
2025-06-19 05:32:04,REAL,2886009380,488,2886009868,2903863508
2025-06-19 05:32:06,REAL,2886009868,489,2886010357,2903863997
2025-06-19 05:32:08,REAL,2886010357,483,2886010840,2903864480
2025-06-19 05:32:10,REAL,2886010840,474,2886011314,2903864954
2025-06-19 05:32:12,REAL,2886011314,486,2886011800,2903865440
2025-06-19 05:32:14,REAL,2886011800,8885,2886020685,2903874325
2025-06-19 05:32:16,FAKE,2886020685,244,2886020929,2903887158
2025-06-19 05:32:18,REAL,2886020929,10317,2886031246,2903897475
2025-06-19 05:32:20,REAL,2886031246,10252,2886041498,2903907727
2025-06-19 05:32:22,FAKE,2886041498,244,2886041742,2903918040
2025-06-19 05:32:24,FAKE,2886041742,243,2886041985,2903928291
2025-06-19 05:32:26,REAL,2886041985,10314,2886052299,2903938605
2025-06-19 05:32:28,REAL,2886052299,9399,2886061698,2903948004
2025-06-19 05:32:30,REAL,2886061698,534,2886062232,2903948538
2025-06-19 05:32:32,REAL,2886062232,486,2886062718,2903949024
2025-06-19 05:32:34,REAL,2886062718,491,2886063209,2903949515
2025-06-19 05:32:36,REAL,2886063209,479,2886063688,2903949994
2025-06-19 05:32:38,REAL,2886063688,486,2886064174,2903950480
2025-06-19 05:32:40,FAKE,2886064174,238,2886064412,2903950961
2025-06-19 05:32:42,FAKE,2886064412,244,2886064656,2903951440
2025-06-19 05:32:44,FAKE,2886064656,243,2886064899,2903951923
2025-06-19 05:32:46,REAL,2886064899,487,2886065386,2903952410
2025-06-19 05:32:48,REAL,2886065386,484,2886065870,2903952894
2025-06-19 05:32:50,REAL,2886065870,543,2886066413,2903953437
2025-06-19 05:32:52,REAL,2886066413,484,2886066897,2903953921
2025-06-19 05:32:54,FAKE,2886066897,238,2886067135,2903954412
2025-06-19 05:32:56,REAL,2886067135,479,2886067614,2903954891
2025-06-19 05:32:58,FAKE,2886067614,238,2886067852,2903955376
2025-06-19 05:33:00,REAL,2886067852,478,2886068330,2903955854
2025-06-19 05:33:02,REAL,2886068330,484,2886068814,2903956338
2025-06-19 05:33:04,REAL,2886068814,487,2886069301,2903956825
2025-06-19 05:33:06,FAKE,2886069301,241,2886069542,2903957310
2025-06-19 05:33:08,REAL,2886069542,480,2886070022,2903957790
2025-06-19 05:33:10,REAL,2886070022,491,2886070513,2903958281
2025-06-19 05:33:12,FAKE,2886070513,243,2886070756,2903958762
2025-06-19 05:33:14,REAL,2886070756,484,2886071240,2903959246
2025-06-19 05:33:16,REAL,2886071240,540,2886071780,2903959786
2025-06-19 05:33:18,REAL,2886071780,484,2886072264,2903960270
2025-06-19 05:33:20,REAL,2886072264,481,2886072745,2903960751
2025-06-19 05:33:22,REAL,2886072745,491,2886073236,2903961242
2025-06-19 05:33:24,REAL,2886073236,538,2886073774,2903961780
2025-06-19 05:33:26,REAL,2886073774,482,2886074256,2903962262
2025-06-19 05:33:28,REAL,2886074256,479,2886074735,2903962741
2025-06-19 05:33:30,REAL,2886074735,484,2886075219,2903963225
2025-06-19 05:33:32,FAKE,2886075219,238,2886075457,2903963708
2025-06-19 05:33:34,REAL,2886075457,481,2886075938,2903964189
2025-06-19 05:33:36,REAL,2886075938,483,2886076421,2903964672
2025-06-19 05:33:38,FAKE,2886076421,238,2886076659,2903967800
2025-06-19 05:33:40,FAKE,2886076659,243,2886076902,2903979586
2025-06-19 05:33:42,FAKE,2886076902,243,2886077145,2903989837
2025-06-19 05:33:44,FAKE,2886077145,243,2886077388,2904000154
2025-06-19 05:33:46,FAKE,2886077388,238,2886077626,2904010401
2025-06-19 05:33:48,REAL,2886077626,10321,2886087947,2904020722
2025-06-19 05:33:50,REAL,2886087947,10254,2886098201,2904030976
2025-06-19 05:33:52,FAKE,2886098201,243,2886098444,2904041294
2025-06-19 05:33:54,REAL,2886098444,3066,2886101510,2904044360
2025-06-19 05:33:56,FAKE,2886101510,238,2886101748,2904044847
2025-06-19 05:33:58,REAL,2886101748,482,2886102230,2904045329
2025-06-19 05:34:00,REAL,2886102230,485,2886102715,2904045814
2025-06-19 05:34:02,FAKE,2886102715,241,2886102956,2904046300
2025-06-19 05:34:04,REAL,2886102956,543,2886103499,2904046843
2025-06-19 05:34:06,REAL,2886103499,487,2886103986,2904047330
2025-06-19 05:34:08,FAKE,2886103986,238,2886104224,2904047812
2025-06-19 05:34:10,REAL,2886104224,539,2886104763,2904048351
2025-06-19 05:34:12,REAL,2886104763,488,2886105251,2904048839
2025-06-19 05:34:14,FAKE,2886105251,238,2886105489,2904049320
2025-06-19 05:34:16,REAL,2886105489,486,2886105975,2904049806
2025-06-19 05:34:18,FAKE,2886105975,241,2886106216,2904050287
2025-06-19 05:34:20,FAKE,2886106216,238,2886106454,2904050773
2025-06-19 05:34:22,FAKE,2886106454,238,2886106692,2904051264
2025-06-19 05:34:24,REAL,2886106692,474,2886107166,2904051738
2025-06-19 05:34:26,REAL,2886107166,490,2886107656,2904052228
2025-06-19 05:34:28,FAKE,2886107656,238,2886107894,2904052715
2025-06-19 05:34:30,REAL,2886107894,475,2886108369,2904053190
2025-06-19 05:34:32,REAL,2886108369,483,2886108852,2904053673
2025-06-19 05:34:34,FAKE,2886108852,238,2886109090,2904054161
2025-06-19 05:34:36,FAKE,2886109090,238,2886109328,2904054647
2025-06-19 05:34:38,REAL,2886109328,482,2886109810,2904055129
2025-06-19 05:34:40,REAL,2886109810,484,2886110294,2904055613
2025-06-19 05:34:42,REAL,2886110294,481,2886110775,2904056094
2025-06-19 05:34:44,REAL,2886110775,538,2886111313,2904056632
2025-06-19 05:34:46,REAL,2886111313,484,2886111797,2904057116
2025-06-19 05:34:48,REAL,2886111797,488,2886112285,2904057604
2025-06-19 05:34:50,FAKE,2886112285,244,2886112529,2904058146
2025-06-19 05:34:52,FAKE,2886112529,243,2886112772,2904058626
2025-06-19 05:34:54,REAL,2886112772,492,2886113264,2904059118
2025-06-19 05:34:56,FAKE,2886113264,241,2886113505,2904059606
2025-06-19 05:34:58,FAKE,2886113505,244,2886113749,2904060089
2025-06-19 05:35:00,FAKE,2886113749,243,2886113992,2904060581
2025-06-19 05:35:02,FAKE,2886113992,243,2886114235,2904061061
2025-06-19 05:35:04,REAL,2886114235,10459,2886124694,2904071520
2025-06-19 05:35:06,REAL,2886124694,10447,2886135141,2904081967
2025-06-19 05:35:08,REAL,2886135141,10318,2886145459,2904092285
2025-06-19 05:35:10,REAL,2886145459,10255,2886155714,2904102540
2025-06-19 05:35:12,REAL,2886155714,10317,2886166031,2904112857
2025-06-19 05:35:14,REAL,2886166031,10247,2886176278,2904123104
2025-06-19 05:35:16,REAL,2886176278,10316,2886186594,2904133420
2025-06-19 05:35:18,FAKE,2886186594,241,2886186835,2904139708
2025-06-19 05:35:20,FAKE,2886186835,238,2886187073,2904140190
2025-06-19 05:35:22,FAKE,2886187073,243,2886187316,2904140671
2025-06-19 05:35:24,FAKE,2886187316,241,2886187557,2904141157
2025-06-19 05:35:26,REAL,2886187557,487,2886188044,2904141644
2025-06-19 05:35:28,REAL,2886188044,491,2886188535,2904142135
2025-06-19 05:35:30,REAL,2886188535,479,2886189014,2904142614
2025-06-19 05:35:32,FAKE,2886189014,241,2886189255,2904143091
2025-06-19 05:35:34,REAL,2886189255,479,2886189734,2904143570
2025-06-19 05:35:36,FAKE,2886189734,238,2886189972,2904159322
2025-06-19 05:35:38,FAKE,2886189972,244,2886190216,2904169625
2025-06-19 05:35:40,REAL,2886190216,10326,2886200542,2904179951
2025-06-19 05:35:42,REAL,2886200542,10245,2886210787,2904190196
2025-06-19 05:35:44,REAL,2886210787,10249,2886221036,2904200445
2025-06-19 05:35:46,REAL,2886221036,10312,2886231348,2904210757
2025-06-19 05:35:48,REAL,2886231348,10251,2886241599,2904221008
2025-06-19 05:35:50,REAL,2886241599,5758,2886247357,2904226766
2025-06-19 05:35:52,REAL,2886247357,481,2886247838,2904227247
2025-06-19 05:35:54,REAL,2886247838,486,2886248324,2904227733
2025-06-19 05:35:56,REAL,2886248324,490,2886248814,2904228223
2025-06-19 05:35:58,FAKE,2886248814,241,2886249055,2904228712
2025-06-19 05:36:00,REAL,2886249055,483,2886249538,2904229195
2025-06-19 05:36:02,FAKE,2886249538,238,2886249776,2904229677
2025-06-19 05:36:04,REAL,2886249776,479,2886250255,2904230156
2025-06-19 05:36:06,FAKE,2886250255,243,2886250498,2904230645
2025-06-19 05:36:08,FAKE,2886250498,241,2886250739,2904242499
2025-06-19 05:36:10,FAKE,2886250739,238,2886250977,2904252741
2025-06-19 05:36:12,REAL,2886250977,10321,2886261298,2904263062
2025-06-19 05:36:14,REAL,2886261298,10259,2886271557,2904273321
2025-06-19 05:36:16,FAKE,2886271557,243,2886271800,2904283575
2025-06-19 05:36:18,REAL,2886271800,10251,2886282051,2904293826
2025-06-19 05:36:20,REAL,2886282051,11236,2886293287,2904305062
2025-06-19 05:36:22,REAL,2886293287,4178,2886297465,2904309240
2025-06-19 05:36:24,REAL,2886297465,549,2886298014,2904309789
2025-06-19 05:36:26,REAL,2886298014,486,2886298500,2904310275
2025-06-19 05:36:28,REAL,2886298500,478,2886298978,2904310753
2025-06-19 05:36:30,REAL,2886298978,490,2886299468,2904311243
2025-06-19 05:36:32,REAL,2886299468,482,2886299950,2904311725
2025-06-19 05:36:34,FAKE,2886299950,243,2886300193,2904312201
2025-06-19 05:36:36,FAKE,2886300193,238,2886300431,2904312690
2025-06-19 05:36:38,REAL,2886300431,1346,2886301777,2904314036
2025-06-19 05:36:40,FAKE,2886301777,238,2886302015,2904326069
2025-06-19 05:36:42,REAL,2886302015,10315,2886312330,2904336384
2025-06-19 05:36:44,REAL,2886312330,10250,2886322580,2904346634
2025-06-19 05:36:46,REAL,2886322580,10318,2886332898,2904356952
2025-06-19 05:36:48,FAKE,2886332898,244,2886333142,2904367210
2025-06-19 05:36:50,FAKE,2886333142,241,2886333383,2904377521
2025-06-19 05:36:52,REAL,2886333383,10253,2886343636,2904387774
2025-06-19 05:36:54,REAL,2886343636,4510,2886348146,2904392284
2025-06-19 05:36:56,FAKE,2886348146,243,2886348389,2904392776
2025-06-19 05:36:58,REAL,2886348389,487,2886348876,2904393263
2025-06-19 05:37:00,REAL,2886348876,484,2886349360,2904393747
2025-06-19 05:37:02,REAL,2886349360,480,2886349840,2904394227
2025-06-19 05:37:04,FAKE,2886349840,241,2886350081,2904394711
2025-06-19 05:37:06,REAL,2886350081,486,2886350567,2904395197
2025-06-19 05:37:08,REAL,2886350567,488,2886351055,2904395685
2025-06-19 05:37:10,REAL,2886351055,2340,2886353395,2904398025
2025-06-19 05:37:12,REAL,2886353395,11961,2886365356,2904409986
2025-06-19 05:37:14,FAKE,2886365356,243,2886365599,2904420241
2025-06-19 05:37:16,REAL,2886365599,10318,2886375917,2904430559
2025-06-19 05:37:18,FAKE,2886375917,244,2886376161,2904440809
2025-06-19 05:37:20,REAL,2886376161,10258,2886386419,2904451067
2025-06-19 05:37:22,REAL,2886386419,10256,2886396675,2904461323
2025-06-19 05:37:24,REAL,2886396675,10260,2886406935,2904471583
2025-06-19 05:37:26,REAL,2886406935,3844,2886410779,2904475427
2025-06-19 05:37:28,REAL,2886410779,492,2886411271,2904475919
2025-06-19 05:37:30,FAKE,2886411271,243,2886411514,2904476405
2025-06-19 05:37:32,REAL,2886411514,484,2886411998,2904476889
2025-06-19 05:37:34,FAKE,2886411998,244,2886412242,2904477371
2025-06-19 05:37:36,FAKE,2886412242,244,2886412486,2904477851
2025-06-19 05:37:38,FAKE,2886412486,238,2886412724,2904478331
2025-06-19 05:37:40,REAL,2886412724,488,2886413212,2904478819
2025-06-19 05:37:42,FAKE,2886413212,243,2886413455,2904481824
2025-06-19 05:37:44,REAL,2886413455,11442,2886424897,2904493266
2025-06-19 05:37:46,REAL,2886424897,10251,2886435148,2904503517
2025-06-19 05:37:48,FAKE,2886435148,243,2886435391,2904513778
2025-06-19 05:37:50,REAL,2886435391,10256,2886445647,2904524034
2025-06-19 05:37:52,REAL,2886445647,10321,2886455968,2904534355
2025-06-19 05:37:54,FAKE,2886455968,238,2886456206,2904544610
2025-06-19 05:37:56,REAL,2886456206,10250,2886466456,2904554860
2025-06-19 05:37:58,FAKE,2886466456,244,2886466700,2904558118
2025-06-19 05:38:00,REAL,2886466700,537,2886467237,2904558655
2025-06-19 05:38:02,REAL,2886467237,479,2886467716,2904559134
2025-06-19 05:38:04,REAL,2886467716,482,2886468198,2904559616
2025-06-19 05:38:06,REAL,2886468198,486,2886468684,2904560102
2025-06-19 05:38:08,REAL,2886468684,488,2886469172,2904560590
2025-06-19 05:38:10,REAL,2886469172,474,2886469646,2904561064
2025-06-19 05:38:12,REAL,2886469646,493,2886470139,2904561557
2025-06-19 05:38:14,REAL,2886470139,3855,2886473994,2904565412
2025-06-19 05:38:16,REAL,2886473994,11504,2886485498,2904576916
2025-06-19 05:38:18,FAKE,2886485498,241,2886485739,2904587237
2025-06-19 05:38:20,REAL,2886485739,10253,2886495992,2904597490
2025-06-19 05:38:22,FAKE,2886495992,238,2886496230,2904607812
2025-06-19 05:38:24,REAL,2886496230,10255,2886506485,2904618067
2025-06-19 05:38:26,REAL,2886506485,10251,2886516736,2904628318
2025-06-19 05:38:28,REAL,2886516736,10246,2886526982,2904638564
2025-06-19 05:38:30,FAKE,2886526982,241,2886527223,2904641230
2025-06-19 05:38:32,REAL,2886527223,481,2886527704,2904641711
2025-06-19 05:38:34,REAL,2886527704,485,2886528189,2904642196
2025-06-19 05:38:36,FAKE,2886528189,244,2886528433,2904655658
2025-06-19 05:38:38,REAL,2886528433,10782,2886539215,2904666440
2025-06-19 05:38:40,REAL,2886539215,10253,2886549468,2904676693
2025-06-19 05:38:42,REAL,2886549468,10315,2886559783,2904687008
2025-06-19 05:38:44,REAL,2886559783,10311,2886570094,2904697319
2025-06-19 05:38:46,FAKE,2886570094,238,2886570332,2904707567
2025-06-19 05:38:48,REAL,2886570332,10249,2886580581,2904717816
2025-06-19 05:38:50,REAL,2886580581,7152,2886587733,2904724968
2025-06-19 05:38:52,FAKE,2886587733,241,2886587974,2904725451
2025-06-19 05:38:54,FAKE,2886587974,241,2886588215,2904725937
2025-06-19 05:38:56,REAL,2886588215,484,2886588699,2904726421
2025-06-19 05:38:58,FAKE,2886588699,238,2886588937,2904726903
2025-06-19 05:39:00,FAKE,2886588937,241,2886589178,2904727383
2025-06-19 05:39:02,REAL,2886589178,487,2886589665,2904727870
2025-06-19 05:39:04,FAKE,2886589665,238,2886589903,2904728361
2025-06-19 05:39:06,REAL,2886589903,487,2886590390,2904728848
2025-06-19 05:39:08,REAL,2886590390,11052,2886601442,2904739900
2025-06-19 05:39:10,FAKE,2886601442,238,2886601680,2904750159
2025-06-19 05:39:12,REAL,2886601680,10246,2886611926,2904760405
2025-06-19 05:39:14,REAL,2886611926,10245,2886622171,2904770650
2025-06-19 05:39:16,REAL,2886622171,10249,2886632420,2904780899
2025-06-19 05:39:18,REAL,2886632420,10255,2886642675,2904791154
2025-06-19 05:39:20,FAKE,2886642675,243,2886642918,2904801405
2025-06-19 05:39:22,REAL,2886642918,6490,2886649408,2904807895
2025-06-19 05:39:24,REAL,2886649408,478,2886649886,2904808373
2025-06-19 05:39:26,FAKE,2886649886,243,2886650129,2904808852
2025-06-19 05:39:28,REAL,2886650129,489,2886650618,2904809341
2025-06-19 05:39:30,REAL,2886650618,549,2886651167,2904809890
2025-06-19 05:39:32,REAL,2886651167,489,2886651656,2904810379
2025-06-19 05:39:34,FAKE,2886651656,241,2886651897,2904810869
2025-06-19 05:39:36,REAL,2886651897,485,2886652382,2904811354
2025-06-19 05:39:38,FAKE,2886652382,244,2886652626,2904811841
2025-06-19 05:39:40,REAL,2886652626,537,2886653163,2904812378
2025-06-19 05:39:42,FAKE,2886653163,244,2886653407,2904812856
2025-06-19 05:39:44,FAKE,2886653407,244,2886653651,2904813338
2025-06-19 05:39:46,REAL,2886653651,483,2886654134,2904813821
2025-06-19 05:39:48,REAL,2886654134,481,2886654615,2904814302
2025-06-19 05:39:50,REAL,2886654615,485,2886655100,2904814787
2025-06-19 05:39:52,REAL,2886655100,483,2886655583,2904815270
2025-06-19 05:39:54,REAL,2886655583,491,2886656074,2904815761
2025-06-19 05:39:56,FAKE,2886656074,243,2886656317,2904816245
2025-06-19 05:39:58,FAKE,2886656317,244,2886656561,2904816735
2025-06-19 05:40:00,REAL,2886656561,491,2886657052,2904817226
2025-06-19 05:40:02,REAL,2886657052,482,2886657534,2904817708
2025-06-19 05:40:04,FAKE,2886657534,243,2886657777,2904818189
2025-06-19 05:40:06,REAL,2886657777,478,2886658255,2904818667
2025-06-19 05:40:08,FAKE,2886658255,244,2886658499,2904819151
2025-06-19 05:40:10,REAL,2886658499,491,2886658990,2904819642
2025-06-19 05:40:12,REAL,2886658990,478,2886659468,2904820120
2025-06-19 05:40:14,REAL,2886659468,540,2886660008,2904820660
2025-06-19 05:40:16,FAKE,2886660008,244,2886660252,2904821192
2025-06-19 05:40:18,REAL,2886660252,482,2886660734,2904821674
2025-06-19 05:40:20,FAKE,2886660734,241,2886660975,2904822168
2025-06-19 05:40:22,REAL,2886660975,487,2886661462,2904822655
2025-06-19 05:40:24,REAL,2886661462,478,2886661940,2904823133
2025-06-19 05:40:26,REAL,2886661940,484,2886662424,2904823617
2025-06-19 05:40:28,FAKE,2886662424,238,2886662662,2904824097
2025-06-19 05:40:30,FAKE,2886662662,241,2886662903,2904824578
2025-06-19 05:40:32,REAL,2886662903,478,2886663381,2904825056
2025-06-19 05:40:34,FAKE,2886663381,243,2886663624,2904825539
2025-06-19 05:40:36,REAL,2886663624,483,2886664107,2904826022
2025-06-19 05:40:38,REAL,2886664107,494,2886664601,2904826516
2025-06-19 05:40:40,FAKE,2886664601,241,2886664842,2904827009
2025-06-19 05:40:42,FAKE,2886664842,243,2886665085,2904827493
2025-06-19 05:40:44,FAKE,2886665085,238,2886665323,2904827974
2025-06-19 05:40:46,REAL,2886665323,530,2886665853,2904828504
2025-06-19 05:40:48,FAKE,2886665853,238,2886666091,2904828992
2025-06-19 05:40:50,FAKE,2886666091,243,2886666334,2904829473
2025-06-19 05:40:52,REAL,2886666334,476,2886666810,2904829949
2025-06-19 05:40:54,FAKE,2886666810,238,2886667048,2904830431
2025-06-19 05:40:56,REAL,2886667048,482,2886667530,2904830913
2025-06-19 05:40:58,REAL,2886667530,483,2886668013,2904831396
2025-06-19 05:41:00,FAKE,2886668013,241,2886668254,2904831938
2025-06-19 05:41:02,FAKE,2886668254,243,2886668497,2904832423
2025-06-19 05:41:04,REAL,2886668497,484,2886668981,2904832907
2025-06-19 05:41:06,REAL,2886668981,488,2886669469,2904833395
2025-06-19 05:41:08,REAL,2886669469,489,2886669958,2904833884
2025-06-19 05:41:10,FAKE,2886669958,244,2886670202,2904834370
2025-06-19 05:41:12,REAL,2886670202,487,2886670689,2904834857
2025-06-19 05:41:14,REAL,2886670689,8808,2886679497,2904843665
2025-06-19 05:41:16,REAL,2886679497,12829,2886692326,2904856494
2025-06-19 05:41:18,REAL,2886692326,10310,2886702636,2904866804
2025-06-19 05:41:20,REAL,2886702636,10252,2886712888,2904877056
2025-06-19 05:41:22,REAL,2886712888,10320,2886723208,2904887376
2025-06-19 05:41:24,REAL,2886723208,10258,2886733466,2904897634
2025-06-19 05:41:26,REAL,2886733466,10251,2886743717,2904907885
2025-06-19 05:41:28,FAKE,2886743717,243,2886743960,2904917141
2025-06-19 05:41:30,REAL,2886743960,487,2886744447,2904917628
2025-06-19 05:41:32,REAL,2886744447,483,2886744930,2904918111
2025-06-19 05:41:34,REAL,2886744930,486,2886745416,2904918597
2025-06-19 05:41:36,REAL,2886745416,490,2886745906,2904919087
2025-06-19 05:41:38,REAL,2886745906,478,2886746384,2904919565
2025-06-19 05:41:40,REAL,2886746384,474,2886746858,2904920039
2025-06-19 05:41:42,REAL,2886746858,487,2886747345,2904920526
2025-06-19 05:41:44,REAL,2886747345,484,2886747829,2904921010
2025-06-19 05:41:46,REAL,2886747829,538,2886748367,2904921548
2025-06-19 05:41:48,REAL,2886748367,489,2886748856,2904922037
2025-06-19 05:41:50,FAKE,2886748856,243,2886749099,2904922520
2025-06-19 05:41:52,REAL,2886749099,544,2886749643,2904923064
2025-06-19 05:41:54,REAL,2886749643,480,2886750123,2904923544
2025-06-19 05:41:56,FAKE,2886750123,238,2886750361,2904924026
2025-06-19 05:41:58,REAL,2886750361,477,2886750838,2904924503
2025-06-19 05:42:00,FAKE,2886750838,241,2886751079,2904924987
2025-06-19 05:42:02,FAKE,2886751079,243,2886751322,2904925478
2025-06-19 05:42:04,REAL,2886751322,483,2886751805,2904925961
2025-06-19 05:42:06,FAKE,2886751805,238,2886752043,2904928564
2025-06-19 05:42:08,REAL,2886752043,11629,2886763672,2904940193
2025-06-19 05:42:10,REAL,2886763672,10319,2886773991,2904950512
2025-06-19 05:42:12,REAL,2886773991,10258,2886784249,2904960770
2025-06-19 05:42:14,FAKE,2886784249,238,2886784487,2904971091
2025-06-19 05:42:16,FAKE,2886784487,244,2886784731,2904981353
2025-06-19 05:42:18,REAL,2886784731,10261,2886794992,2904991614
2025-06-19 05:42:20,REAL,2886794992,10251,2886805243,2905001865
2025-06-19 05:42:22,REAL,2886805243,3398,2886808641,2905005263
2025-06-19 05:42:24,REAL,2886808641,489,2886809130,2905005752
2025-06-19 05:42:26,REAL,2886809130,481,2886809611,2905006233
2025-06-19 05:42:28,REAL,2886809611,476,2886810087,2905006709
2025-06-19 05:42:30,REAL,2886810087,547,2886810634,2905007256
2025-06-19 05:42:32,FAKE,2886810634,241,2886810875,2905007743
2025-06-19 05:42:34,REAL,2886810875,484,2886811359,2905008227
2025-06-19 05:42:36,REAL,2886811359,484,2886811843,2905008711
2025-06-19 05:42:38,REAL,2886811843,538,2886812381,2905009249
2025-06-19 05:42:40,REAL,2886812381,484,2886812865,2905009733
2025-06-19 05:42:42,FAKE,2886812865,243,2886813108,2905010208
2025-06-19 05:42:44,FAKE,2886813108,238,2886813346,2905010695
2025-06-19 05:42:46,REAL,2886813346,483,2886813829,2905011178
2025-06-19 05:42:48,FAKE,2886813829,244,2886814073,2905011668
2025-06-19 05:42:50,FAKE,2886814073,241,2886814314,2905012148
2025-06-19 05:42:52,REAL,2886814314,482,2886814796,2905012630
2025-06-19 05:42:54,REAL,2886814796,484,2886815280,2905013114
2025-06-19 05:42:56,FAKE,2886815280,238,2886815518,2905013596
2025-06-19 05:42:58,FAKE,2886815518,241,2886815759,2905014082
2025-06-19 05:43:00,FAKE,2886815759,243,2886816002,2905014570
2025-06-19 05:43:02,REAL,2886816002,489,2886816491,2905015059
2025-06-19 05:43:04,REAL,2886816491,483,2886816974,2905015542
2025-06-19 05:43:06,FAKE,2886816974,244,2886817218,2905016025
2025-06-19 05:43:08,FAKE,2886817218,241,2886817459,2905016509
2025-06-19 05:43:10,REAL,2886817459,4504,2886821963,2905021013
2025-06-19 05:43:12,REAL,2886821963,11051,2886833014,2905032064
2025-06-19 05:43:14,REAL,2886833014,10249,2886843263,2905042313
2025-06-19 05:43:16,REAL,2886843263,10375,2886853638,2905052688
2025-06-19 05:43:18,REAL,2886853638,10247,2886863885,2905062935
2025-06-19 05:43:20,REAL,2886863885,10247,2886874132,2905073182
2025-06-19 05:43:22,FAKE,2886874132,241,2886874373,2905083499
2025-06-19 05:43:24,REAL,2886874373,10251,2886884624,2905093750
2025-06-19 05:43:26,FAKE,2886884624,244,2886884868,2905095941
2025-06-19 05:43:28,REAL,2886884868,476,2886885344,2905096417
2025-06-19 05:43:30,REAL,2886885344,247,2886885591,2905096664
2025-06-19 05:43:32,REAL,2886885591,482,2886886073,2905097146
2025-06-19 05:43:34,REAL,2886886073,488,2886886561,2905097634
2025-06-19 05:43:36,REAL,2886886561,475,2886887036,2905098109
2025-06-19 05:43:38,FAKE,2886887036,244,2886887280,2905098592
2025-06-19 05:43:40,REAL,2886887280,487,2886887767,2905099079
2025-06-19 05:43:42,REAL,2886887767,5312,2886893079,2905104391
2025-06-19 05:43:44,REAL,2886893079,11112,2886904191,2905115503
2025-06-19 05:43:46,REAL,2886904191,10255,2886914446,2905125758
2025-06-19 05:43:48,REAL,2886914446,10316,2886924762,2905136074
2025-06-19 05:43:50,FAKE,2886924762,238,2886925000,2905146382
2025-06-19 05:43:52,FAKE,2886925000,243,2886925243,2905156635
2025-06-19 05:43:54,REAL,2886925243,10321,2886935564,2905166956
2025-06-19 05:43:56,REAL,2886935564,10248,2886945812,2905177204
2025-06-19 05:43:58,REAL,2886945812,1548,2886947360,2905178752
2025-06-19 05:44:00,REAL,2886947360,493,2886947853,2905179245
2025-06-19 05:44:02,REAL,2886947853,484,2886948337,2905179729
2025-06-19 05:44:04,FAKE,2886948337,241,2886948578,2905180211
2025-06-19 05:44:06,REAL,2886948578,479,2886949057,2905180690
2025-06-19 05:44:08,FAKE,2886949057,243,2886949300,2905181173
2025-06-19 05:44:10,REAL,2886949300,485,2886949785,2905181658
2025-06-19 05:44:12,REAL,2886949785,489,2886950274,2905182147
2025-06-19 05:44:14,REAL,2886950274,476,2886950750,2905182623
2025-06-19 05:44:16,FAKE,2886950750,241,2886950991,2905183165
2025-06-19 05:44:18,REAL,2886950991,483,2886951474,2905183648
2025-06-19 05:44:20,REAL,2886951474,479,2886951953,2905184127
2025-06-19 05:44:22,REAL,2886951953,491,2886952444,2905184618
2025-06-19 05:44:24,REAL,2886952444,540,2886952984,2905185158
2025-06-19 05:44:26,FAKE,2886952984,238,2886953222,2905185636
2025-06-19 05:44:28,REAL,2886953222,489,2886953711,2905186125
2025-06-19 05:44:30,FAKE,2886953711,243,2886953954,2905186608
2025-06-19 05:44:32,REAL,2886953954,475,2886954429,2905187083
2025-06-19 05:44:34,REAL,2886954429,491,2886954920,2905187574
2025-06-19 05:44:36,FAKE,2886954920,244,2886955164,2905188065
2025-06-19 05:44:38,FAKE,2886955164,241,2886955405,2905188547
2025-06-19 05:44:40,FAKE,2886955405,244,2886955649,2905189037
2025-06-19 05:44:42,FAKE,2886955649,241,2886955890,2905189525
2025-06-19 05:44:44,FAKE,2886955890,244,2886956134,2905190011
2025-06-19 05:44:46,REAL,2886956134,7490,2886963624,2905197501
2025-06-19 05:44:48,REAL,2886963624,12842,2886976466,2905210343
2025-06-19 05:44:50,REAL,2886976466,10255,2886986721,2905220598
2025-06-19 05:44:52,REAL,2886986721,10324,2886997045,2905230922
2025-06-19 05:44:54,FAKE,2886997045,243,2886997288,2905241169
2025-06-19 05:44:56,REAL,2886997288,10260,2887007548,2905251429
2025-06-19 05:44:58,REAL,2887007548,10260,2887017808,2905261689
2025-06-19 05:45:00,REAL,2887017808,10178,2887027986,2905271867
2025-06-19 05:45:02,REAL,2887027986,487,2887028473,2905272354
2025-06-19 05:45:04,FAKE,2887028473,241,2887028714,2905272840
2025-06-19 05:45:06,REAL,2887028714,474,2887029188,2905273314
2025-06-19 05:45:08,REAL,2887029188,482,2887029670,2905273796
2025-06-19 05:45:10,REAL,2887029670,490,2887030160,2905274286
2025-06-19 05:45:12,REAL,2887030160,494,2887030654,2905274780
2025-06-19 05:45:14,REAL,2887030654,487,2887031141,2905275267
2025-06-19 05:45:16,REAL,2887031141,476,2887031617,2905275743
2025-06-19 05:45:18,REAL,2887031617,482,2887032099,2905276225
2025-06-19 05:45:20,FAKE,2887032099,238,2887032337,2905276765
2025-06-19 05:45:22,FAKE,2887032337,243,2887032580,2905277247
2025-06-19 05:45:24,REAL,2887032580,492,2887033072,2905277739
2025-06-19 05:45:26,REAL,2887033072,483,2887033555,2905278222
2025-06-19 05:45:28,REAL,2887033555,478,2887034033,2905278700
2025-06-19 05:45:30,REAL,2887034033,486,2887034519,2905279186
2025-06-19 05:45:32,REAL,2887034519,477,2887034996,2905279663
2025-06-19 05:45:34,REAL,2887034996,541,2887035537,2905280204
2025-06-19 05:45:36,REAL,2887035537,492,2887036029,2905280696
2025-06-19 05:45:38,FAKE,2887036029,244,2887036273,2905281182
2025-06-19 05:45:40,REAL,2887036273,482,2887036755,2905281664
2025-06-19 05:45:42,FAKE,2887036755,238,2887036993,2905282144
2025-06-19 05:45:44,FAKE,2887036993,243,2887037236,2905282624
2025-06-19 05:45:46,REAL,2887037236,484,2887037720,2905283108
2025-06-19 05:45:48,FAKE,2887037720,243,2887037963,2905283588
2025-06-19 05:45:50,REAL,2887037963,484,2887038447,2905284072
2025-06-19 05:45:52,REAL,2887038447,492,2887038939,2905284564
2025-06-19 05:45:54,REAL,2887038939,539,2887039478,2905285103
2025-06-19 05:45:56,REAL,2887039478,485,2887039963,2905285588
2025-06-19 05:45:58,FAKE,2887039963,243,2887040206,2905286075
2025-06-19 05:46:00,REAL,2887040206,481,2887040687,2905286556
2025-06-19 05:46:02,REAL,2887040687,483,2887041170,2905287039
2025-06-19 05:46:04,REAL,2887041170,479,2887041649,2905287518
2025-06-19 05:46:06,REAL,2887041649,8959,2887050608,2905296477
2025-06-19 05:46:08,REAL,2887050608,10784,2887061392,2905307261
2025-06-19 05:46:10,REAL,2887061392,10313,2887071705,2905317574
2025-06-19 05:46:12,REAL,2887071705,10321,2887082026,2905327895
2025-06-19 05:46:14,REAL,2887082026,10253,2887092279,2905338148
2025-06-19 05:46:16,REAL,2887092279,10251,2887102530,2905348399
2025-06-19 05:46:18,REAL,2887102530,10319,2887112849,2905358718
2025-06-19 05:46:20,REAL,2887112849,8468,2887121317,2905367186
2025-06-19 05:46:22,REAL,2887121317,487,2887121804,2905367673
2025-06-19 05:46:24,FAKE,2887121804,241,2887122045,2905368396
2025-06-19 05:46:26,FAKE,2887122045,241,2887122286,2905368634
2025-06-19 05:46:28,REAL,2887122286,482,2887122768,2905369116
2025-06-19 05:46:30,REAL,2887122768,486,2887123254,2905369602
2025-06-19 05:46:32,REAL,2887123254,482,2887123736,2905370084
2025-06-19 05:46:34,REAL,2887123736,486,2887124222,2905370570
2025-06-19 05:46:36,REAL,2887124222,492,2887124714,2905371062
2025-06-19 05:46:38,FAKE,2887124714,238,2887124952,2905371602
2025-06-19 05:46:40,FAKE,2887124952,244,2887125196,2905372089
2025-06-19 05:46:42,FAKE,2887125196,238,2887125434,2905372568
2025-06-19 05:46:44,REAL,2887125434,543,2887125977,2905373111
2025-06-19 05:46:46,REAL,2887125977,480,2887126457,2905373591
2025-06-19 05:46:48,FAKE,2887126457,238,2887126695,2905374080
2025-06-19 05:46:50,FAKE,2887126695,243,2887126938,2905374562
2025-06-19 05:46:52,REAL,2887126938,480,2887127418,2905375042
2025-06-19 05:46:54,REAL,2887127418,485,2887127903,2905375527
2025-06-19 05:46:56,REAL,2887127903,483,2887128386,2905376010
2025-06-19 05:46:58,REAL,2887128386,489,2887128875,2905376499
2025-06-19 05:47:00,FAKE,2887128875,244,2887129119,2905376978
2025-06-19 05:47:02,FAKE,2887129119,244,2887129363,2905377466
2025-06-19 05:47:04,REAL,2887129363,486,2887129849,2905377952
2025-06-19 05:47:06,REAL,2887129849,483,2887130332,2905378435
2025-06-19 05:47:08,REAL,2887130332,476,2887130808,2905378911
2025-06-19 05:47:10,REAL,2887130808,478,2887131286,2905379389
2025-06-19 05:47:12,FAKE,2887131286,244,2887131530,2905379934
2025-06-19 05:47:14,REAL,2887131530,476,2887132006,2905380410
2025-06-19 05:47:16,FAKE,2887132006,243,2887132249,2905380894
2025-06-19 05:47:18,REAL,2887132249,540,2887132789,2905381434
2025-06-19 05:47:20,REAL,2887132789,486,2887133275,2905381920
2025-06-19 05:47:22,REAL,2887133275,484,2887133759,2905382404
2025-06-19 05:47:24,FAKE,2887133759,243,2887134002,2905382889
2025-06-19 05:47:26,REAL,2887134002,488,2887134490,2905383377
2025-06-19 05:47:28,REAL,2887134490,484,2887134974,2905383861
2025-06-19 05:47:30,REAL,2887134974,487,2887135461,2905384348
2025-06-19 05:47:32,REAL,2887135461,486,2887135947,2905384834
2025-06-19 05:47:34,FAKE,2887135947,243,2887136190,2905385323
2025-06-19 05:47:36,REAL,2887136190,478,2887136668,2905385801
2025-06-19 05:47:38,REAL,2887136668,481,2887137149,2905386282
2025-06-19 05:47:40,REAL,2887137149,488,2887137637,2905386770
2025-06-19 05:47:42,REAL,2887137637,484,2887138121,2905387254
2025-06-19 05:47:44,REAL,2887138121,544,2887138665,2905387798
2025-06-19 05:47:46,REAL,2887138665,475,2887139140,2905388273
2025-06-19 05:47:48,REAL,2887139140,480,2887139620,2905388753
2025-06-19 05:47:50,REAL,2887139620,482,2887140102,2905389235
2025-06-19 05:47:52,REAL,2887140102,491,2887140593,2905389726
2025-06-19 05:47:54,FAKE,2887140593,238,2887140831,2905390265
2025-06-19 05:47:56,REAL,2887140831,484,2887141315,2905390749
2025-06-19 05:47:58,REAL,2887141315,487,2887141802,2905391236
2025-06-19 05:48:00,REAL,2887141802,485,2887142287,2905391721
2025-06-19 05:48:02,REAL,2887142287,485,2887142772,2905392206
2025-06-19 05:48:04,REAL,2887142772,490,2887143262,2905392696
2025-06-19 05:48:06,REAL,2887143262,486,2887143748,2905393182
2025-06-19 05:48:08,FAKE,2887143748,238,2887143986,2905393661
2025-06-19 05:48:10,REAL,2887143986,488,2887144474,2905394149
2025-06-19 05:48:12,FAKE,2887144474,238,2887144712,2905394635
2025-06-19 05:48:14,REAL,2887144712,478,2887145190,2905395113
2025-06-19 05:48:16,REAL,2887145190,482,2887145672,2905395595
2025-06-19 05:48:18,REAL,2887145672,537,2887146209,2905396132
2025-06-19 05:48:20,REAL,2887146209,489,2887146698,2905396621
2025-06-19 05:48:22,REAL,2887146698,481,2887147179,2905397102
2025-06-19 05:48:24,FAKE,2887147179,244,2887147423,2905397585
2025-06-19 05:48:26,REAL,2887147423,482,2887147905,2905398067
2025-06-19 05:48:28,FAKE,2887147905,244,2887148149,2905398608
2025-06-19 05:48:30,REAL,2887148149,476,2887148625,2905399084
2025-06-19 05:48:32,REAL,2887148625,487,2887149112,2905399571
2025-06-19 05:48:34,REAL,2887149112,479,2887149591,2905400050
2025-06-19 05:48:36,REAL,2887149591,487,2887150078,2905400537
2025-06-19 05:48:38,REAL,2887150078,481,2887150559,2905401018
2025-06-19 05:48:40,FAKE,2887150559,244,2887150803,2905401502
2025-06-19 05:48:42,REAL,2887150803,488,2887151291,2905401990
2025-06-19 05:48:44,REAL,2887151291,479,2887151770,2905402469
2025-06-19 05:48:46,REAL,2887151770,474,2887152244,2905402943
2025-06-19 05:48:48,REAL,2887152244,483,2887152727,2905403426
2025-06-19 05:48:50,REAL,2887152727,485,2887153212,2905403911
2025-06-19 05:48:52,REAL,2887153212,487,2887153699,2905404398
2025-06-19 05:48:54,REAL,2887153699,479,2887154178,2905404877
2025-06-19 05:48:56,REAL,2887154178,546,2887154724,2905405423
2025-06-19 05:48:58,FAKE,2887154724,238,2887154962,2905405909
2025-06-19 05:49:00,REAL,2887154962,486,2887155448,2905406395
2025-06-19 05:49:02,REAL,2887155448,533,2887155981,2905406928
2025-06-19 05:49:04,FAKE,2887155981,243,2887156224,2905407417
2025-06-19 05:49:06,REAL,2887156224,479,2887156703,2905407896
2025-06-19 05:49:08,REAL,2887156703,478,2887157181,2905408374
2025-06-19 05:49:10,REAL,2887157181,486,2887157667,2905408860
2025-06-19 05:49:12,FAKE,2887157667,241,2887157908,2905409344
2025-06-19 05:49:14,FAKE,2887157908,243,2887158151,2905409828
2025-06-19 05:49:16,REAL,2887158151,489,2887158640,2905410317
2025-06-19 05:49:18,REAL,2887158640,484,2887159124,2905410801
2025-06-19 05:49:20,REAL,2887159124,483,2887159607,2905411284
2025-06-19 05:49:22,REAL,2887159607,483,2887160090,2905411767
2025-06-19 05:49:24,REAL,2887160090,482,2887160572,2905412249
2025-06-19 05:49:26,REAL,2887160572,491,2887161063,2905412740
2025-06-19 05:49:28,FAKE,2887161063,243,2887161306,2905413224
2025-06-19 05:49:30,REAL,2887161306,489,2887161795,2905413713
2025-06-19 05:49:32,FAKE,2887161795,241,2887162036,2905414203
2025-06-19 05:49:34,REAL,2887162036,491,2887162527,2905414694
2025-06-19 05:49:36,REAL,2887162527,481,2887163008,2905415175
2025-06-19 05:49:38,REAL,2887163008,594,2887163602,2905415769
2025-06-19 05:49:40,REAL,2887163602,477,2887164079,2905416246
2025-06-19 05:49:42,FAKE,2887164079,241,2887164320,2905416725
2025-06-19 05:49:44,FAKE,2887164320,243,2887164563,2905417215
2025-06-19 05:49:46,REAL,2887164563,476,2887165039,2905417691
2025-06-19 05:49:48,FAKE,2887165039,241,2887165280,2905418174
2025-06-19 05:49:50,FAKE,2887165280,243,2887165523,2905418662
2025-06-19 05:49:52,REAL,2887165523,488,2887166011,2905419150
2025-06-19 05:49:54,REAL,2887166011,489,2887166500,2905419639
2025-06-19 05:49:56,FAKE,2887166500,244,2887166744,2905420123
2025-06-19 05:49:58,REAL,2887166744,481,2887167225,2905420604
2025-06-19 05:50:00,FAKE,2887167225,238,2887167463,2905421086
2025-06-19 05:50:02,FAKE,2887167463,241,2887167704,2905421562
2025-06-19 05:50:04,FAKE,2887167704,244,2887167948,2905422044
2025-06-19 05:50:06,REAL,2887167948,490,2887168438,2905422534
2025-06-19 05:50:08,REAL,2887168438,487,2887168925,2905423021
2025-06-19 05:50:10,REAL,2887168925,488,2887169413,2905423509
2025-06-19 05:50:12,FAKE,2887169413,244,2887169657,2905424051
2025-06-19 05:50:14,FAKE,2887169657,241,2887169898,2905424536
2025-06-19 05:50:16,REAL,2887169898,480,2887170378,2905425016
2025-06-19 05:50:18,FAKE,2887170378,241,2887170619,2905425555
2025-06-19 05:50:20,FAKE,2887170619,241,2887170860,2905426035
2025-06-19 05:50:22,REAL,2887170860,476,2887171336,2905426511
2025-06-19 05:50:24,REAL,2887171336,484,2887171820,2905426995
2025-06-19 05:50:26,REAL,2887171820,493,2887172313,2905427488
2025-06-19 05:50:28,REAL,2887172313,486,2887172799,2905427974
2025-06-19 05:50:30,REAL,2887172799,480,2887173279,2905428454
2025-06-19 05:50:32,FAKE,2887173279,244,2887173523,2905428937
2025-06-19 05:50:34,REAL,2887173523,479,2887174002,2905429416
2025-06-19 05:50:36,REAL,2887174002,483,2887174485,2905429899
2025-06-19 05:50:38,REAL,2887174485,491,2887174976,2905430390
2025-06-19 05:50:40,REAL,2887174976,484,2887175460,2905430874
2025-06-19 05:50:42,REAL,2887175460,488,2887175948,2905431362
2025-06-19 05:50:44,REAL,2887175948,482,2887176430,2905431844
2025-06-19 05:50:46,REAL,2887176430,475,2887176905,2905432319
2025-06-19 05:50:48,REAL,2887176905,537,2887177442,2905432856
2025-06-19 05:50:50,REAL,2887177442,488,2887177930,2905433344
2025-06-19 05:50:52,REAL,2887177930,9207,2887187137,2905442551
2025-06-19 05:50:54,REAL,2887187137,10776,2887197913,2905453327
2025-06-19 05:50:56,REAL,2887197913,11300,2887209213,2905464627
2025-06-19 05:50:58,FAKE,2887209213,238,2887209451,2905473890
2025-06-19 05:51:00,REAL,2887209451,10251,2887219702,2905484141
2025-06-19 05:51:02,REAL,2887219702,10322,2887230024,2905494463
2025-06-19 05:51:04,REAL,2887230024,10247,2887240271,2905504710
2025-06-19 05:51:06,FAKE,2887240271,243,2887240514,2905512851
2025-06-19 05:51:08,REAL,2887240514,488,2887241002,2905513339
2025-06-19 05:51:10,REAL,2887241002,492,2887241494,2905513831
2025-06-19 05:51:12,REAL,2887241494,486,2887241980,2905514317
2025-06-19 05:51:14,REAL,2887241980,483,2887242463,2905514800
2025-06-19 05:51:16,REAL,2887242463,485,2887242948,2905515285
2025-06-19 05:51:18,REAL,2887242948,491,2887243439,2905515776
2025-06-19 05:51:20,FAKE,2887243439,241,2887243680,2905516262
2025-06-19 05:51:22,FAKE,2887243680,243,2887243923,2905516804
2025-06-19 05:51:24,FAKE,2887243923,238,2887244161,2905526618
2025-06-19 05:51:26,FAKE,2887244161,238,2887244399,2905537131
2025-06-19 05:51:28,REAL,2887244399,10184,2887254583,2905547315
2025-06-19 05:51:30,REAL,2887254583,10321,2887264904,2905557636
2025-06-19 05:51:32,REAL,2887264904,10245,2887275149,2905567881
2025-06-19 05:51:34,FAKE,2887275149,243,2887275392,2905578199
2025-06-19 05:51:36,REAL,2887275392,10253,2887285645,2905588452
2025-06-19 05:51:38,REAL,2887285645,7485,2887293130,2905595937
2025-06-19 05:51:40,FAKE,2887293130,243,2887293373,2905596423
2025-06-19 05:51:42,REAL,2887293373,489,2887293862,2905596912
2025-06-19 05:51:44,REAL,2887293862,490,2887294352,2905597402
2025-06-19 05:51:46,REAL,2887294352,485,2887294837,2905597887
2025-06-19 05:51:48,FAKE,2887294837,241,2887295078,2905598370
2025-06-19 05:51:50,FAKE,2887295078,243,2887295321,2905598854
2025-06-19 05:51:52,REAL,2887295321,480,2887295801,2905599334
2025-06-19 05:51:54,FAKE,2887295801,243,2887296044,2905599819
2025-06-19 05:51:56,REAL,2887296044,10195,2887306239,2905610014
2025-06-19 05:51:58,FAKE,2887306239,238,2887306477,2905620325
2025-06-19 05:52:00,FAKE,2887306477,238,2887306715,2905630578
2025-06-19 05:52:02,REAL,2887306715,10257,2887316972,2905640835
2025-06-19 05:52:04,FAKE,2887316972,244,2887317216,2905651088
2025-06-19 05:52:06,REAL,2887317216,10323,2887327539,2905661411
2025-06-19 05:52:08,FAKE,2887327539,244,2887327783,2905671655
2025-06-19 05:52:10,FAKE,2887327783,241,2887328024,2905678471
2025-06-19 05:52:12,REAL,2887328024,488,2887328512,2905678959
2025-06-19 05:52:14,FAKE,2887328512,243,2887328755,2905679440
2025-06-19 05:52:16,FAKE,2887328755,238,2887328993,2905679922
2025-06-19 05:52:18,FAKE,2887328993,244,2887329237,2905680411
2025-06-19 05:52:20,FAKE,2887329237,238,2887329475,2905680898
2025-06-19 05:52:22,REAL,2887329475,483,2887329958,2905681381
2025-06-19 05:52:24,FAKE,2887329958,244,2887330202,2905681862
2025-06-19 05:52:26,REAL,2887330202,492,2887330694,2905682354
2025-06-19 05:52:28,FAKE,2887330694,244,2887330938,2905682841
2025-06-19 05:52:30,REAL,2887330938,481,2887331419,2905683322
2025-06-19 05:52:32,FAKE,2887331419,243,2887331662,2905683805
2025-06-19 05:52:34,REAL,2887331662,537,2887332199,2905684342
2025-06-19 05:52:36,REAL,2887332199,542,2887332741,2905684884
2025-06-19 05:52:38,REAL,2887332741,483,2887333224,2905685367
2025-06-19 05:52:40,FAKE,2887333224,243,2887333467,2905685853
2025-06-19 05:52:42,FAKE,2887333467,243,2887333710,2905686329
2025-06-19 05:52:44,FAKE,2887333710,244,2887333954,2905686808
2025-06-19 05:52:46,FAKE,2887333954,244,2887334198,2905687293
2025-06-19 05:52:48,FAKE,2887334198,238,2887334436,2905693262
2025-06-19 05:52:50,FAKE,2887334436,238,2887334674,2905704172
2025-06-19 05:52:52,FAKE,2887334674,241,2887334915,2905714426
2025-06-19 05:52:54,REAL,2887334915,10246,2887345161,2905724672
2025-06-19 05:52:56,REAL,2887345161,10321,2887355482,2905734993
2025-06-19 05:52:58,FAKE,2887355482,244,2887355726,2905745246
2025-06-19 05:53:00,FAKE,2887355726,243,2887355969,2905755559
2025-06-19 05:53:02,REAL,2887355969,10247,2887366216,2905765806
2025-06-19 05:53:04,FAKE,2887366216,241,2887366457,2905766746
2025-06-19 05:53:06,FAKE,2887366457,238,2887366695,2905767228
2025-06-19 05:53:08,FAKE,2887366695,241,2887366936,2905767715
2025-06-19 05:53:10,REAL,2887366936,12177,2887379113,2905779892
2025-06-19 05:53:12,REAL,2887379113,10314,2887389427,2905790206
2025-06-19 05:53:14,FAKE,2887389427,244,2887389671,2905800466
2025-06-19 05:53:16,REAL,2887389671,10318,2887399989,2905810784
2025-06-19 05:53:18,FAKE,2887399989,241,2887400230,2905821028
2025-06-19 05:53:20,REAL,2887400230,10311,2887410541,2905831339
2025-06-19 05:53:22,FAKE,2887410541,244,2887410785,2905841590
2025-06-19 05:53:24,REAL,2887410785,5505,2887416290,2905847095
2025-06-19 05:53:26,REAL,2887416290,492,2887416782,2905847587
2025-06-19 05:53:28,FAKE,2887416782,244,2887417026,2905848078
2025-06-19 05:53:30,REAL,2887417026,474,2887417500,2905848552
2025-06-19 05:53:32,REAL,2887417500,476,2887417976,2905849028
2025-06-19 05:53:34,FAKE,2887417976,244,2887418220,2905849506
2025-06-19 05:53:36,REAL,2887418220,484,2887418704,2905849990
2025-06-19 05:53:38,REAL,2887418704,484,2887419188,2905850474
2025-06-19 05:53:40,FAKE,2887419188,243,2887419431,2905850958
2025-06-19 05:53:42,REAL,2887419431,485,2887419916,2905851443
2025-06-19 05:53:44,REAL,2887419916,480,2887420396,2905851923
2025-06-19 05:53:46,FAKE,2887420396,238,2887420634,2905852401
2025-06-19 05:53:48,REAL,2887420634,536,2887421170,2905852937
2025-06-19 05:53:50,FAKE,2887421170,243,2887421413,2905853420
2025-06-19 05:53:52,REAL,2887421413,545,2887421958,2905853965
2025-06-19 05:53:54,REAL,2887421958,482,2887422440,2905854447
2025-06-19 05:53:56,FAKE,2887422440,241,2887422681,2905854932
2025-06-19 05:53:58,FAKE,2887422681,238,2887422919,2905855413
2025-06-19 05:54:00,REAL,2887422919,485,2887423404,2905855898
2025-06-19 05:54:02,REAL,2887423404,486,2887423890,2905856384
2025-06-19 05:54:04,FAKE,2887423890,241,2887424131,2905856872
2025-06-19 05:54:06,REAL,2887424131,484,2887424615,2905857356
2025-06-19 05:54:08,REAL,2887424615,489,2887425104,2905857845
2025-06-19 05:54:10,REAL,2887425104,485,2887425589,2905858330
2025-06-19 05:54:12,REAL,2887425589,486,2887426075,2905858816
2025-06-19 05:54:14,REAL,2887426075,479,2887426554,2905859295
2025-06-19 05:54:16,REAL,2887426554,483,2887427037,2905859778
2025-06-19 05:54:18,REAL,2887427037,486,2887427523,2905860264
2025-06-19 05:54:20,FAKE,2887427523,244,2887427767,2905860749
2025-06-19 05:54:22,REAL,2887427767,479,2887428246,2905861228
2025-06-19 05:54:24,REAL,2887428246,532,2887428778,2905861760
2025-06-19 05:54:26,REAL,2887428778,482,2887429260,2905862242
2025-06-19 05:54:28,REAL,2887429260,486,2887429746,2905862728
2025-06-19 05:54:30,REAL,2887429746,487,2887430233,2905863215
2025-06-19 05:54:32,REAL,2887430233,479,2887430712,2905863694
2025-06-19 05:54:34,FAKE,2887430712,238,2887430950,2905864180
2025-06-19 05:54:36,REAL,2887430950,539,2887431489,2905864719
2025-06-19 05:54:38,REAL,2887431489,487,2887431976,2905865206
2025-06-19 05:54:40,REAL,2887431976,485,2887432461,2905865691
2025-06-19 05:54:42,FAKE,2887432461,238,2887432699,2905866173
2025-06-19 05:54:44,REAL,2887432699,491,2887433190,2905866664
2025-06-19 05:54:46,REAL,2887433190,486,2887433676,2905867150
2025-06-19 05:54:48,FAKE,2887433676,243,2887433919,2905867631
2025-06-19 05:54:50,REAL,2887433919,483,2887434402,2905868114
2025-06-19 05:54:52,FAKE,2887434402,238,2887434640,2905868600
2025-06-19 05:54:54,REAL,2887434640,486,2887435126,2905869086
2025-06-19 05:54:56,REAL,2887435126,482,2887435608,2905869568
2025-06-19 05:54:58,FAKE,2887435608,244,2887435852,2905870048
2025-06-19 05:55:00,REAL,2887435852,542,2887436394,2905870590
2025-06-19 05:55:02,REAL,2887436394,486,2887436880,2905871076
2025-06-19 05:55:04,REAL,2887436880,484,2887437364,2905871560
2025-06-19 05:55:06,REAL,2887437364,493,2887437857,2905872053
2025-06-19 05:55:08,REAL,2887437857,476,2887438333,2905872529
2025-06-19 05:55:10,FAKE,2887438333,244,2887438577,2905873006
2025-06-19 05:55:12,REAL,2887438577,488,2887439065,2905873494
2025-06-19 05:55:14,FAKE,2887439065,244,2887439309,2905873987
2025-06-19 05:55:16,REAL,2887439309,484,2887439793,2905874471
2025-06-19 05:55:18,REAL,2887439793,538,2887440331,2905875009
2025-06-19 05:55:20,FAKE,2887440331,241,2887440572,2905875495
2025-06-19 05:55:22,FAKE,2887440572,244,2887440816,2905875984
2025-06-19 05:55:24,REAL,2887440816,483,2887441299,2905876467
2025-06-19 05:55:26,FAKE,2887441299,241,2887441540,2905876956
2025-06-19 05:55:28,REAL,2887441540,480,2887442020,2905877436
2025-06-19 05:55:30,REAL,2887442020,477,2887442497,2905877913
2025-06-19 05:55:32,REAL,2887442497,480,2887442977,2905878393
2025-06-19 05:55:34,REAL,2887442977,492,2887443469,2905878885
2025-06-19 05:55:36,FAKE,2887443469,238,2887443707,2905879369
2025-06-19 05:55:38,REAL,2887443707,544,2887444251,2905879913
2025-06-19 05:55:40,REAL,2887444251,483,2887444734,2905880396
2025-06-19 05:55:42,REAL,2887444734,483,2887445217,2905880879
2025-06-19 05:55:44,REAL,2887445217,492,2887445709,2905881371
2025-06-19 05:55:46,REAL,2887445709,483,2887446192,2905881854
2025-06-19 05:55:48,FAKE,2887446192,241,2887446433,2905882335
2025-06-19 05:55:50,REAL,2887446433,494,2887446927,2905882829
2025-06-19 05:55:52,REAL,2887446927,489,2887447416,2905883318
2025-06-19 05:55:54,REAL,2887447416,482,2887447898,2905883800
2025-06-19 05:55:56,REAL,2887447898,491,2887448389,2905884291
2025-06-19 05:55:58,REAL,2887448389,478,2887448867,2905884769
2025-06-19 05:56:00,REAL,2887448867,483,2887449350,2905885252
2025-06-19 05:56:02,REAL,2887449350,537,2887449887,2905885789
2025-06-19 05:56:04,REAL,2887449887,484,2887450371,2905886273
2025-06-19 05:56:06,REAL,2887450371,492,2887450863,2905886765
2025-06-19 05:56:08,REAL,2887450863,483,2887451346,2905887248
2025-06-19 05:56:10,REAL,2887451346,486,2887451832,2905887734
2025-06-19 05:56:12,REAL,2887451832,488,2887452320,2905888222
2025-06-19 05:56:14,REAL,2887452320,538,2887452858,2905888760
2025-06-19 05:56:16,FAKE,2887452858,241,2887453099,2905889238
2025-06-19 05:56:18,REAL,2887453099,482,2887453581,2905889720
2025-06-19 05:56:20,FAKE,2887453581,238,2887453819,2905890205
2025-06-19 05:56:22,FAKE,2887453819,244,2887454063,2905890690
2025-06-19 05:56:24,REAL,2887454063,486,2887454549,2905891176
2025-06-19 05:56:26,REAL,2887454549,10785,2887465334,2905901961
2025-06-19 05:56:28,REAL,2887465334,10519,2887475853,2905912480
2025-06-19 05:56:30,REAL,2887475853,10243,2887486096,2905922723
2025-06-19 05:56:32,FAKE,2887486096,238,2887486334,2905933041
2025-06-19 05:56:34,FAKE,2887486334,244,2887486578,2905943291
2025-06-19 05:56:36,REAL,2887486578,10253,2887496831,2905953544
2025-06-19 05:56:38,FAKE,2887496831,238,2887497069,2905963797
2025-06-19 05:56:40,REAL,2887497069,6628,2887503697,2905970425
2025-06-19 05:56:42,FAKE,2887503697,238,2887503935,2905970919
2025-06-19 05:56:44,FAKE,2887503935,241,2887504176,2905971403
2025-06-19 05:56:46,REAL,2887504176,484,2887504660,2905971887
2025-06-19 05:56:48,REAL,2887504660,486,2887505146,2905972373
2025-06-19 05:56:50,FAKE,2887505146,244,2887505390,2905972862
2025-06-19 05:56:52,REAL,2887505390,539,2887505929,2905973401
2025-06-19 05:56:54,FAKE,2887505929,241,2887506170,2905973891
2025-06-19 05:56:56,REAL,2887506170,485,2887506655,2905974376
2025-06-19 05:56:58,REAL,2887506655,486,2887507141,2905974862
2025-06-19 05:57:00,FAKE,2887507141,243,2887507384,2905975349
2025-06-19 05:57:02,REAL,2887507384,487,2887507871,2905975836
2025-06-19 05:57:04,REAL,2887507871,488,2887508359,2905976324
2025-06-19 05:57:06,FAKE,2887508359,243,2887508602,2905976808
2025-06-19 05:57:08,REAL,2887508602,486,2887509088,2905977294
2025-06-19 05:57:10,REAL,2887509088,548,2887509636,2905977842
2025-06-19 05:57:12,FAKE,2887509636,244,2887509880,2905978333
2025-06-19 05:57:14,REAL,2887509880,486,2887510366,2905978819
2025-06-19 05:57:16,REAL,2887510366,490,2887510856,2905979309
2025-06-19 05:57:18,REAL,2887510856,476,2887511332,2905979785
2025-06-19 05:57:20,REAL,2887511332,484,2887511816,2905980269
2025-06-19 05:57:22,FAKE,2887511816,241,2887512057,2905980745
2025-06-19 05:57:24,REAL,2887512057,480,2887512537,2905981225
2025-06-19 05:57:26,REAL,2887512537,483,2887513020,2905981708
2025-06-19 05:57:28,REAL,2887513020,489,2887513509,2905982197
2025-06-19 05:57:30,FAKE,2887513509,238,2887513747,2905982743
2025-06-19 05:57:32,FAKE,2887513747,238,2887513985,2905983228
2025-06-19 05:57:34,FAKE,2887513985,243,2887514228,2905983706
2025-06-19 05:57:36,REAL,2887514228,488,2887514716,2905984194
2025-06-19 05:57:38,FAKE,2887514716,241,2887514957,2905984674
2025-06-19 05:57:40,REAL,2887514957,489,2887515446,2905985163
2025-06-19 05:57:42,REAL,2887515446,481,2887515927,2905985644
2025-06-19 05:57:44,REAL,2887515927,493,2887516420,2905986137
2025-06-19 05:57:46,REAL,2887516420,481,2887516901,2905986618
2025-06-19 05:57:48,REAL,2887516901,484,2887517385,2905987102
2025-06-19 05:57:50,REAL,2887517385,480,2887517865,2905987582
2025-06-19 05:57:52,REAL,2887517865,541,2887518406,2905988123
2025-06-19 05:57:54,REAL,2887518406,484,2887518890,2905988607
2025-06-19 05:57:56,REAL,2887518890,482,2887519372,2905989089
2025-06-19 05:57:58,FAKE,2887519372,238,2887519610,2905989569
2025-06-19 05:58:00,REAL,2887519610,490,2887520100,2905990059
2025-06-19 05:58:02,FAKE,2887520100,244,2887520344,2905990541
2025-06-19 05:58:04,REAL,2887520344,489,2887520833,2905991030
2025-06-19 05:58:06,REAL,2887520833,544,2887521377,2905991574
2025-06-19 05:58:08,REAL,2887521377,491,2887521868,2905992065
2025-06-19 05:58:10,REAL,2887521868,479,2887522347,2905992544
2025-06-19 05:58:12,FAKE,2887522347,241,2887522588,2905993035
2025-06-19 05:58:14,REAL,2887522588,489,2887523077,2905993524
2025-06-19 05:58:16,FAKE,2887523077,241,2887523318,2906000082
2025-06-19 05:58:18,REAL,2887523318,11103,2887534421,2906011185
2025-06-19 05:58:20,REAL,2887534421,10250,2887544671,2906021435
2025-06-19 05:58:22,REAL,2887544671,10318,2887554989,2906031753
2025-06-19 05:58:24,REAL,2887554989,10245,2887565234,2906041998
2025-06-19 05:58:26,FAKE,2887565234,243,2887565477,2906052250
2025-06-19 05:58:28,REAL,2887565477,10306,2887575783,2906062556
2025-06-19 05:58:30,REAL,2887575783,9651,2887585434,2906072207
2025-06-19 05:58:32,FAKE,2887585434,238,2887585672,2906072688
2025-06-19 05:58:34,FAKE,2887585672,243,2887585915,2906073173
2025-06-19 05:58:36,REAL,2887585915,486,2887586401,2906073659
2025-06-19 05:58:38,REAL,2887586401,484,2887586885,2906074143
2025-06-19 05:58:40,REAL,2887586885,485,2887587370,2906074628
2025-06-19 05:58:42,REAL,2887587370,488,2887587858,2906075116
2025-06-19 05:58:44,REAL,2887587858,538,2887588396,2906075654
2025-06-19 05:58:46,REAL,2887588396,553,2887588949,2906076207
2025-06-19 05:58:48,REAL,2887588949,484,2887589433,2906076691
2025-06-19 05:58:50,FAKE,2887589433,243,2887589676,2906077233
2025-06-19 05:58:52,FAKE,2887589676,241,2887589917,2906077709
2025-06-19 05:58:54,REAL,2887589917,491,2887590408,2906078200
2025-06-19 05:58:56,REAL,2887590408,494,2887590902,2906078694
2025-06-19 05:58:58,REAL,2887590902,476,2887591378,2906079170
2025-06-19 05:59:00,REAL,2887591378,486,2887591864,2906079656
2025-06-19 05:59:02,FAKE,2887591864,244,2887592108,2906080146
2025-06-19 05:59:04,REAL,2887592108,489,2887592597,2906080635
2025-06-19 05:59:06,FAKE,2887592597,244,2887592841,2906081116
2025-06-19 05:59:08,REAL,2887592841,492,2887593333,2906081608
2025-06-19 05:59:10,REAL,2887593333,484,2887593817,2906082092
2025-06-19 05:59:12,REAL,2887593817,532,2887594349,2906082624
2025-06-19 05:59:14,REAL,2887594349,488,2887594837,2906083112
2025-06-19 05:59:16,REAL,2887594837,543,2887595380,2906083655
2025-06-19 05:59:18,REAL,2887595380,489,2887595869,2906084144
2025-06-19 05:59:20,REAL,2887595869,488,2887596357,2906084632
2025-06-19 05:59:22,REAL,2887596357,480,2887596837,2906085112
2025-06-19 05:59:24,REAL,2887596837,2413,2887599250,2906087525
2025-06-19 05:59:26,FAKE,2887599250,238,2887599488,2906102528
2025-06-19 05:59:28,REAL,2887599488,10247,2887609735,2906112775
2025-06-19 05:59:30,REAL,2887609735,10908,2887620643,2906123683
2025-06-19 05:59:32,FAKE,2887620643,241,2887620884,2906133344
2025-06-19 05:59:34,REAL,2887620884,10315,2887631199,2906143659
2025-06-19 05:59:36,FAKE,2887631199,238,2887631437,2906153903
2025-06-19 05:59:38,REAL,2887631437,10253,2887641690,2906164156
2025-06-19 05:59:40,FAKE,2887641690,238,2887641928,2906167748
2025-06-19 05:59:42,FAKE,2887641928,244,2887642172,2906168225
2025-06-19 05:59:44,FAKE,2887642172,238,2887642410,2906168718
2025-06-19 05:59:46,REAL,2887642410,8684,2887651094,2906177402
2025-06-19 05:59:48,REAL,2887651094,10782,2887661876,2906188184
2025-06-19 05:59:50,FAKE,2887661876,241,2887662117,2906198507
2025-06-19 05:59:52,FAKE,2887662117,241,2887662358,2906208765
2025-06-19 05:59:54,FAKE,2887662358,238,2887662596,2906219016
2025-06-19 05:59:56,FAKE,2887662596,238,2887662834,2906229322
2025-06-19 05:59:58,REAL,2887662834,10314,2887673148,2906239636
2025-06-19 06:00:00,REAL,2887673148,8131,2887681279,2906247767
2025-06-19 06:00:02,REAL,2887681279,478,2887681757,2906248245
2025-06-19 06:00:04,REAL,2887681757,478,2887682235,2906248723
2025-06-19 06:00:06,FAKE,2887682235,241,2887682476,2906249205
2025-06-19 06:00:08,REAL,2887682476,476,2887682952,2906249681
2025-06-19 06:00:10,REAL,2887682952,479,2887683431,2906250160
2025-06-19 06:00:12,FAKE,2887683431,244,2887683675,2906250639
2025-06-19 06:00:14,REAL,2887683675,486,2887684161,2906251125
2025-06-19 06:00:16,FAKE,2887684161,238,2887684399,2906251665
2025-06-19 06:00:18,REAL,2887684399,540,2887684939,2906252205
2025-06-19 06:00:20,REAL,2887684939,237,2887685176,2906252442
2025-06-19 06:00:22,REAL,2887685176,481,2887685657,2906252923
2025-06-19 06:00:24,REAL,2887685657,489,2887686146,2906253412
2025-06-19 06:00:26,FAKE,2887686146,238,2887686384,2906253892
2025-06-19 06:00:28,FAKE,2887686384,238,2887686622,2906254371
2025-06-19 06:00:30,FAKE,2887686622,243,2887686865,2906254856
2025-06-19 06:00:32,REAL,2887686865,486,2887687351,2906255342
2025-06-19 06:00:34,FAKE,2887687351,243,2887687594,2906255829
2025-06-19 06:00:36,REAL,2887687594,490,2887688084,2906256319
2025-06-19 06:00:38,REAL,2887688084,484,2887688568,2906256803
2025-06-19 06:00:40,REAL,2887688568,538,2887689106,2906257341
2025-06-19 06:00:42,REAL,2887689106,487,2887689593,2906257828
2025-06-19 06:00:44,REAL,2887689593,485,2887690078,2906258313
2025-06-19 06:00:46,FAKE,2887690078,241,2887690319,2906258796
2025-06-19 06:00:48,REAL,2887690319,540,2887690859,2906259336
2025-06-19 06:00:50,REAL,2887690859,10657,2887701516,2906269993
2025-06-19 06:00:52,REAL,2887701516,10726,2887712242,2906280719
2025-06-19 06:00:54,FAKE,2887712242,241,2887712483,2906290967
2025-06-19 06:00:56,FAKE,2887712483,244,2887712727,2906301221
2025-06-19 06:00:58,REAL,2887712727,10249,2887722976,2906311470
2025-06-19 06:01:00,REAL,2887722976,10316,2887733292,2906321786
2025-06-19 06:01:02,REAL,2887733292,10298,2887743590,2906332084
2025-06-19 06:01:04,FAKE,2887743590,238,2887743828,2906338977
2025-06-19 06:01:06,REAL,2887743828,486,2887744314,2906339463
2025-06-19 06:01:08,REAL,2887744314,478,2887744792,2906339941
2025-06-19 06:01:10,REAL,2887744792,486,2887745278,2906340427
2025-06-19 06:01:12,REAL,2887745278,484,2887745762,2906340911
2025-06-19 06:01:14,REAL,2887745762,478,2887746240,2906341389
2025-06-19 06:01:16,REAL,2887746240,482,2887746722,2906341871
2025-06-19 06:01:18,FAKE,2887746722,244,2887746966,2906342412
2025-06-19 06:01:20,FAKE,2887746966,244,2887747210,2906342898
2025-06-19 06:01:22,REAL,2887747210,10656,2887757866,2906353554
2025-06-19 06:01:24,REAL,2887757866,10440,2887768306,2906363994
2025-06-19 06:01:26,FAKE,2887768306,243,2887768549,2906374246
2025-06-19 06:01:28,FAKE,2887768549,244,2887768793,2906384503
2025-06-19 06:01:30,FAKE,2887768793,238,2887769031,2906394756
2025-06-19 06:01:32,REAL,2887769031,10250,2887779281,2906405006
2025-06-19 06:01:34,REAL,2887779281,10249,2887789530,2906415255
2025-06-19 06:01:36,FAKE,2887789530,244,2887789774,2906421548
2025-06-19 06:01:38,REAL,2887789774,483,2887790257,2906422031
2025-06-19 06:01:40,REAL,2887790257,491,2887790748,2906422522
2025-06-19 06:01:42,REAL,2887790748,483,2887791231,2906423005
2025-06-19 06:01:44,FAKE,2887791231,241,2887791472,2906423550
2025-06-19 06:01:46,REAL,2887791472,482,2887791954,2906424032
2025-06-19 06:01:48,FAKE,2887791954,238,2887792192,2906424508
2025-06-19 06:01:50,REAL,2887792192,475,2887792667,2906424983
2025-06-19 06:01:52,REAL,2887792667,541,2887793208,2906425524
2025-06-19 06:01:54,REAL,2887793208,478,2887793686,2906426002
2025-06-19 06:01:56,REAL,2887793686,481,2887794167,2906426483
2025-06-19 06:01:58,REAL,2887794167,483,2887794650,2906426966
2025-06-19 06:02:00,REAL,2887794650,485,2887795135,2906427451
2025-06-19 06:02:02,REAL,2887795135,482,2887795617,2906427933
2025-06-19 06:02:04,FAKE,2887795617,238,2887795855,2906428421
2025-06-19 06:02:06,REAL,2887795855,537,2887796392,2906428958
2025-06-19 06:02:08,FAKE,2887796392,238,2887796630,2906429434
2025-06-19 06:02:10,REAL,2887796630,487,2887797117,2906429921
2025-06-19 06:02:12,REAL,2887797117,491,2887797608,2906430412
2025-06-19 06:02:14,FAKE,2887797608,238,2887797846,2906437968
2025-06-19 06:02:16,REAL,2887797846,13223,2887811069,2906451191
2025-06-19 06:02:18,FAKE,2887811069,244,2887811313,2906461448
2025-06-19 06:02:20,REAL,2887811313,10250,2887821563,2906471698
2025-06-19 06:02:22,FAKE,2887821563,238,2887821801,2906482016
2025-06-19 06:02:24,FAKE,2887821801,243,2887822044,2906492270
2025-06-19 06:02:26,REAL,2887822044,10307,2887832351,2906502577
2025-06-19 06:02:28,REAL,2887832351,10182,2887842533,2906512759
2025-06-19 06:02:30,REAL,2887842533,479,2887843012,2906513238
2025-06-19 06:02:32,FAKE,2887843012,243,2887843255,2906513725
2025-06-19 06:02:34,REAL,2887843255,485,2887843740,2906514210
2025-06-19 06:02:36,FAKE,2887843740,238,2887843978,2906514685
2025-06-19 06:02:38,REAL,2887843978,478,2887844456,2906515163
2025-06-19 06:02:40,REAL,2887844456,492,2887844948,2906515655
2025-06-19 06:02:42,REAL,2887844948,483,2887845431,2906516138
2025-06-19 06:02:44,REAL,2887845431,544,2887845975,2906516682
2025-06-19 06:02:46,REAL,2887845975,7489,2887853464,2906524171
2025-06-19 06:02:48,REAL,2887853464,10842,2887864306,2906535013
2025-06-19 06:02:50,FAKE,2887864306,243,2887864549,2906545274
2025-06-19 06:02:52,REAL,2887864549,10243,2887874792,2906555517
2025-06-19 06:02:54,REAL,2887874792,10255,2887885047,2906565772
2025-06-19 06:02:56,REAL,2887885047,10253,2887895300,2906576025
2025-06-19 06:02:58,REAL,2887895300,10244,2887905544,2906586269
2025-06-19 06:03:00,REAL,2887905544,9596,2887915140,2906595865
2025-06-19 06:03:02,FAKE,2887915140,243,2887915383,2906596349
2025-06-19 06:03:04,FAKE,2887915383,241,2887915624,2906596824
2025-06-19 06:03:06,REAL,2887915624,478,2887916102,2906597302
2025-06-19 06:03:08,REAL,2887916102,490,2887916592,2906597792
2025-06-19 06:03:10,REAL,2887916592,492,2887917084,2906598284
2025-06-19 06:03:12,FAKE,2887917084,243,2887917327,2906598765
2025-06-19 06:03:14,REAL,2887917327,481,2887917808,2906599246
2025-06-19 06:03:16,FAKE,2887917808,244,2887918052,2906599783
2025-06-19 06:03:18,REAL,2887918052,479,2887918531,2906600262
2025-06-19 06:03:20,REAL,2887918531,489,2887919020,2906600751
2025-06-19 06:03:22,REAL,2887919020,491,2887919511,2906601242
2025-06-19 06:03:24,FAKE,2887919511,243,2887919754,2906601720
2025-06-19 06:03:26,FAKE,2887919754,241,2887919995,2906602211
2025-06-19 06:03:28,REAL,2887919995,486,2887920481,2906602697
2025-06-19 06:03:30,FAKE,2887920481,244,2887920725,2906603178
2025-06-19 06:03:32,FAKE,2887920725,238,2887920963,2906603660
2025-06-19 06:03:34,REAL,2887920963,477,2887921440,2906604137
2025-06-19 06:03:36,FAKE,2887921440,238,2887921678,2906604617
2025-06-19 06:03:38,FAKE,2887921678,241,2887921919,2906605156
2025-06-19 06:03:40,REAL,2887921919,477,2887922396,2906605633
2025-06-19 06:03:42,REAL,2887922396,479,2887922875,2906606112
2025-06-19 06:03:44,FAKE,2887922875,243,2887923118,2906606599
2025-06-19 06:03:46,REAL,2887923118,485,2887923603,2906607084
2025-06-19 06:03:48,REAL,2887923603,486,2887924089,2906607570
2025-06-19 06:03:50,FAKE,2887924089,238,2887924327,2906608046
2025-06-19 06:03:52,REAL,2887924327,484,2887924811,2906608530
2025-06-19 06:03:54,REAL,2887924811,2469,2887927280,2906610999
2025-06-19 06:03:56,FAKE,2887927280,244,2887927524,2906622375
2025-06-19 06:03:58,REAL,2887927524,10253,2887937777,2906632628
2025-06-19 06:04:00,FAKE,2887937777,241,2887938018,2906642950
2025-06-19 06:04:02,REAL,2887938018,10974,2887948992,2906653924
2025-06-19 06:04:04,REAL,2887948992,9530,2887958522,2906663454
2025-06-19 06:04:06,REAL,2887958522,10313,2887968835,2906673767
2025-06-19 06:04:08,REAL,2887968835,10257,2887979092,2906684024
2025-06-19 06:04:10,REAL,2887979092,3517,2887982609,2906687541
2025-06-19 06:04:12,FAKE,2887982609,243,2887982852,2906688020
2025-06-19 06:04:14,REAL,2887982852,479,2887983331,2906688499
2025-06-19 06:04:16,FAKE,2887983331,238,2887983569,2906688983
2025-06-19 06:04:18,REAL,2887983569,475,2887984044,2906689458
2025-06-19 06:04:20,FAKE,2887984044,244,2887984288,2906689947
2025-06-19 06:04:22,REAL,2887984288,487,2887984775,2906690434
2025-06-19 06:04:24,FAKE,2887984775,241,2887985016,2906690918
2025-06-19 06:04:26,REAL,2887985016,3263,2887988279,2906694181
2025-06-19 06:04:28,REAL,2887988279,11293,2887999572,2906705474
2025-06-19 06:04:30,FAKE,2887999572,241,2887999813,2906715727
2025-06-19 06:04:32,REAL,2887999813,10251,2888010064,2906725978
2025-06-19 06:04:34,REAL,2888010064,10321,2888020385,2906736299
2025-06-19 06:04:36,REAL,2888020385,10251,2888030636,2906746550
2025-06-19 06:04:38,REAL,2888030636,10247,2888040883,2906756797
2025-06-19 06:04:40,REAL,2888040883,10310,2888051193,2906767107
2025-06-19 06:04:42,REAL,2888051193,2860,2888054053,2906769967
2025-06-19 06:04:44,FAKE,2888054053,238,2888054291,2906770459
2025-06-19 06:04:46,REAL,2888054291,487,2888054778,2906770946
2025-06-19 06:04:48,REAL,2888054778,489,2888055267,2906771435
2025-06-19 06:04:50,REAL,2888055267,487,2888055754,2906771922
2025-06-19 06:04:52,FAKE,2888055754,241,2888055995,2906772401
2025-06-19 06:04:54,REAL,2888055995,483,2888056478,2906772884
2025-06-19 06:04:56,REAL,2888056478,483,2888056961,2906773367
2025-06-19 06:04:58,REAL,2888056961,4253,2888061214,2906777620
2025-06-19 06:05:00,FAKE,2888061214,241,2888061455,2906789065
2025-06-19 06:05:02,REAL,2888061455,10254,2888071709,2906799319
2025-06-19 06:05:04,REAL,2888071709,10259,2888081968,2906809578
2025-06-19 06:05:06,FAKE,2888081968,243,2888082211,2906819838
2025-06-19 06:05:08,REAL,2888082211,10320,2888092531,2906830158
2025-06-19 06:05:10,REAL,2888092531,10249,2888102780,2906840407
2025-06-19 06:05:12,REAL,2888102780,10250,2888113030,2906850657
2025-06-19 06:05:14,FAKE,2888113030,238,2888113268,2906852924
2025-06-19 06:05:16,REAL,2888113268,479,2888113747,2906853403
2025-06-19 06:05:18,FAKE,2888113747,241,2888113988,2906853887
2025-06-19 06:05:20,REAL,2888113988,533,2888114521,2906854420
2025-06-19 06:05:22,REAL,2888114521,481,2888115002,2906854901
2025-06-19 06:05:24,REAL,2888115002,483,2888115485,2906855384
2025-06-19 06:05:26,REAL,2888115485,479,2888115964,2906855863
2025-06-19 06:05:28,REAL,2888115964,482,2888116446,2906856345
2025-06-19 06:05:30,REAL,2888116446,4594,2888121040,2906860939
2025-06-19 06:05:32,REAL,2888121040,11639,2888132679,2906872578
2025-06-19 06:05:34,REAL,2888132679,10387,2888143066,2906882965
2025-06-19 06:05:36,REAL,2888143066,10194,2888153260,2906893159
2025-06-19 06:05:38,FAKE,2888153260,243,2888153503,2906903406
2025-06-19 06:05:40,FAKE,2888153503,241,2888153744,2906913659
2025-06-19 06:05:42,REAL,2888153744,10249,2888163993,2906923908
2025-06-19 06:05:44,REAL,2888163993,10325,2888174318,2906934233
2025-06-19 06:05:46,REAL,2888174318,1678,2888175996,2906935911
2025-06-19 06:05:48,REAL,2888175996,487,2888176483,2906936398
2025-06-19 06:05:50,REAL,2888176483,477,2888176960,2906936875
2025-06-19 06:05:52,FAKE,2888176960,243,2888177203,2906937363
2025-06-19 06:05:54,FAKE,2888177203,243,2888177446,2906937842
2025-06-19 06:05:56,REAL,2888177446,487,2888177933,2906938329
2025-06-19 06:05:58,REAL,2888177933,486,2888178419,2906938815
2025-06-19 06:06:00,REAL,2888178419,486,2888178905,2906939301
2025-06-19 06:06:02,REAL,2888178905,482,2888179387,2906939783
2025-06-19 06:06:04,FAKE,2888179387,243,2888179630,2906940270
2025-06-19 06:06:06,REAL,2888179630,484,2888180114,2906940754
2025-06-19 06:06:08,FAKE,2888180114,244,2888180358,2906941246
2025-06-19 06:06:10,FAKE,2888180358,238,2888180596,2906941777
2025-06-19 06:06:12,REAL,2888180596,490,2888181086,2906942267
2025-06-19 06:06:14,REAL,2888181086,485,2888181571,2906942752
2025-06-19 06:06:16,REAL,2888181571,535,2888182106,2906943287
2025-06-19 06:06:18,REAL,2888182106,486,2888182592,2906943773
2025-06-19 06:06:20,REAL,2888182592,476,2888183068,2906944249
2025-06-19 06:06:22,REAL,2888183068,484,2888183552,2906944733
2025-06-19 06:06:24,REAL,2888183552,479,2888184031,2906945212
2025-06-19 06:06:26,REAL,2888184031,490,2888184521,2906945702
2025-06-19 06:06:28,FAKE,2888184521,243,2888184764,2906946190
2025-06-19 06:06:30,FAKE,2888184764,243,2888185007,2906946675
2025-06-19 06:06:32,REAL,2888185007,485,2888185492,2906947160
2025-06-19 06:06:34,REAL,2888185492,6234,2888191726,2906953394
2025-06-19 06:06:36,REAL,2888191726,10908,2888202634,2906964302
2025-06-19 06:06:38,FAKE,2888202634,238,2888202872,2906974545
2025-06-19 06:06:40,FAKE,2888202872,241,2888203113,2906984859
2025-06-19 06:06:42,REAL,2888203113,10258,2888213371,2906995117
2025-06-19 06:06:44,REAL,2888213371,10250,2888223621,2907005367
2025-06-19 06:06:46,REAL,2888223621,10312,2888233933,2907015679
2025-06-19 06:06:48,FAKE,2888233933,243,2888234176,2907025873
2025-06-19 06:06:50,FAKE,2888234176,238,2888234414,2907026359
2025-06-19 06:06:52,FAKE,2888234414,243,2888234657,2907026844
2025-06-19 06:06:54,REAL,2888234657,485,2888235142,2907027329
2025-06-19 06:06:56,FAKE,2888235142,243,2888235385,2907027819
2025-06-19 06:06:58,FAKE,2888235385,244,2888235629,2907028299
2025-06-19 06:07:00,REAL,2888235629,545,2888236174,2907028844
2025-06-19 06:07:02,REAL,2888236174,481,2888236655,2907029325
2025-06-19 06:07:04,FAKE,2888236655,244,2888236899,2907029803
2025-06-19 06:07:06,FAKE,2888236899,241,2888237140,2907038355
2025-06-19 06:07:08,REAL,2888237140,12753,2888249893,2907051108
2025-06-19 06:07:10,REAL,2888249893,10247,2888260140,2907061355
2025-06-19 06:07:12,REAL,2888260140,10260,2888270400,2907071615
2025-06-19 06:07:14,REAL,2888270400,10244,2888280644,2907081859
2025-06-19 06:07:16,REAL,2888280644,10315,2888290959,2907092174
2025-06-19 06:07:18,FAKE,2888290959,238,2888291197,2907102436
2025-06-19 06:07:20,FAKE,2888291197,241,2888291438,2907111961
2025-06-19 06:07:22,REAL,2888291438,482,2888291920,2907112443
2025-06-19 06:07:24,REAL,2888291920,489,2888292409,2907112932
2025-06-19 06:07:26,REAL,2888292409,481,2888292890,2907113413
2025-06-19 06:07:28,FAKE,2888292890,243,2888293133,2907113899
2025-06-19 06:07:30,REAL,2888293133,481,2888293614,2907114380
2025-06-19 06:07:32,FAKE,2888293614,243,2888293857,2907114863
2025-06-19 06:07:34,REAL,2888293857,478,2888294335,2907115341
2025-06-19 06:07:36,REAL,2888294335,482,2888294817,2907115823
2025-06-19 06:07:38,REAL,2888294817,7681,2888302498,2907123504
2025-06-19 06:07:40,REAL,2888302498,11044,2888313542,2907134548
2025-06-19 06:07:42,REAL,2888313542,10311,2888323853,2907144859
2025-06-19 06:07:44,REAL,2888323853,10253,2888334106,2907155112
2025-06-19 06:07:46,REAL,2888334106,10253,2888344359,2907165365
2025-06-19 06:07:48,REAL,2888344359,10257,2888354616,2907175622
2025-06-19 06:07:50,FAKE,2888354616,238,2888354854,2907185942
2025-06-19 06:07:52,FAKE,2888354854,244,2888355098,2907194931
2025-06-19 06:07:54,REAL,2888355098,485,2888355583,2907195416
2025-06-19 06:07:56,FAKE,2888355583,238,2888355821,2907195900
2025-06-19 06:07:58,FAKE,2888355821,241,2888356062,2907196379
2025-06-19 06:08:00,REAL,2888356062,480,2888356542,2907196859
2025-06-19 06:08:02,FAKE,2888356542,244,2888356786,2907197343
2025-06-19 06:08:04,REAL,2888356786,482,2888357268,2907197825
2025-06-19 06:08:06,REAL,2888357268,487,2888357755,2907198312
2025-06-19 06:08:08,REAL,2888357755,481,2888358236,2907198793
2025-06-19 06:08:10,REAL,2888358236,476,2888358712,2907199269
2025-06-19 06:08:12,REAL,2888358712,484,2888359196,2907199753
2025-06-19 06:08:14,FAKE,2888359196,238,2888359434,2907202290
2025-06-19 06:08:16,REAL,2888359434,11972,2888371406,2907214262
2025-06-19 06:08:18,FAKE,2888371406,244,2888371650,2907224515
2025-06-19 06:08:20,REAL,2888371650,10257,2888381907,2907234772
2025-06-19 06:08:22,REAL,2888381907,10312,2888392219,2907245084
2025-06-19 06:08:24,FAKE,2888392219,244,2888392463,2907255331
2025-06-19 06:08:26,FAKE,2888392463,238,2888392701,2907265584
2025-06-19 06:08:28,FAKE,2888392701,243,2888392944,2907275836
2025-06-19 06:08:30,REAL,2888392944,3529,2888396473,2907279365
2025-06-19 06:08:32,FAKE,2888396473,241,2888396714,2907279851
2025-06-19 06:08:34,FAKE,2888396714,238,2888396952,2907280335
2025-06-19 06:08:36,REAL,2888396952,481,2888397433,2907280816
2025-06-19 06:08:38,FAKE,2888397433,243,2888397676,2907281297
2025-06-19 06:08:40,REAL,2888397676,484,2888398160,2907281781
2025-06-19 06:08:42,FAKE,2888398160,238,2888398398,2907282316
2025-06-19 06:08:44,FAKE,2888398398,238,2888398636,2907282800
2025-06-19 06:08:46,REAL,2888398636,488,2888399124,2907283288
2025-06-19 06:08:48,REAL,2888399124,492,2888399616,2907283780
2025-06-19 06:08:50,REAL,2888399616,481,2888400097,2907284261
2025-06-19 06:08:52,REAL,2888400097,479,2888400576,2907284740
2025-06-19 06:08:54,REAL,2888400576,490,2888401066,2907285230
2025-06-19 06:08:56,FAKE,2888401066,244,2888401310,2907285720
2025-06-19 06:08:58,REAL,2888401310,482,2888401792,2907286202
2025-06-19 06:09:00,FAKE,2888401792,243,2888402035,2907286681
2025-06-19 06:09:02,REAL,2888402035,544,2888402579,2907287225
2025-06-19 06:09:04,FAKE,2888402579,244,2888402823,2907287702
2025-06-19 06:09:06,FAKE,2888402823,241,2888403064,2907288182
2025-06-19 06:09:08,REAL,2888403064,482,2888403546,2907288664
2025-06-19 06:09:10,REAL,2888403546,477,2888404023,2907289141
2025-06-19 06:09:12,REAL,2888404023,485,2888404508,2907289626
2025-06-19 06:09:14,REAL,2888404508,481,2888404989,2907290107
2025-06-19 06:09:16,FAKE,2888404989,243,2888405232,2907290586
2025-06-19 06:09:18,FAKE,2888405232,241,2888405473,2907291064
2025-06-19 06:09:20,FAKE,2888405473,238,2888405711,2907291551
2025-06-19 06:09:22,REAL,2888405711,482,2888406193,2907292033
2025-06-19 06:09:24,REAL,2888406193,487,2888406680,2907292520
2025-06-19 06:09:26,REAL,2888406680,491,2888407171,2907293011
2025-06-19 06:09:28,REAL,2888407171,482,2888407653,2907293493
2025-06-19 06:09:30,REAL,2888407653,539,2888408192,2907294032
2025-06-19 06:09:32,REAL,2888408192,485,2888408677,2907294517
2025-06-19 06:09:34,REAL,2888408677,536,2888409213,2907295053
2025-06-19 06:09:36,REAL,2888409213,478,2888409691,2907295531
2025-06-19 06:09:38,REAL,2888409691,479,2888410170,2907296010
2025-06-19 06:09:40,FAKE,2888410170,243,2888410413,2907296499
2025-06-19 06:09:42,REAL,2888410413,490,2888410903,2907296989
2025-06-19 06:09:44,REAL,2888410903,4323,2888415226,2907301312
2025-06-19 06:09:46,FAKE,2888415226,241,2888415467,2907312435
2025-06-19 06:09:48,FAKE,2888415467,241,2888415708,2907322745
2025-06-19 06:09:50,FAKE,2888415708,243,2888415951,2907332996
2025-06-19 06:09:52,REAL,2888415951,10248,2888426199,2907343244
2025-06-19 06:09:54,REAL,2888426199,10248,2888436447,2907353492
2025-06-19 06:09:56,REAL,2888436447,10320,2888446767,2907363812
2025-06-19 06:09:58,REAL,2888446767,10255,2888457022,2907374067
2025-06-19 06:10:00,REAL,2888457022,2006,2888459028,2907376073
2025-06-19 06:10:02,FAKE,2888459028,241,2888459269,2907376558
2025-06-19 06:10:04,REAL,2888459269,490,2888459759,2907377048
2025-06-19 06:10:06,FAKE,2888459759,238,2888459997,2907377533
2025-06-19 06:10:08,REAL,2888459997,481,2888460478,2907378014
2025-06-19 06:10:10,FAKE,2888460478,238,2888460716,2907378496
2025-06-19 06:10:12,REAL,2888460716,531,2888461247,2907379027
2025-06-19 06:10:14,REAL,2888461247,481,2888461728,2907379508
2025-06-19 06:10:16,FAKE,2888461728,243,2888461971,2907379993
2025-06-19 06:10:18,REAL,2888461971,487,2888462458,2907380480
2025-06-19 06:10:20,REAL,2888462458,483,2888462941,2907380963
2025-06-19 06:10:22,FAKE,2888462941,244,2888463185,2907381437
2025-06-19 06:10:24,REAL,2888463185,534,2888463719,2907381971
2025-06-19 06:10:26,REAL,2888463719,481,2888464200,2907382452
2025-06-19 06:10:28,REAL,2888464200,479,2888464679,2907382931
2025-06-19 06:10:30,FAKE,2888464679,241,2888464920,2907383417
2025-06-19 06:10:32,FAKE,2888464920,238,2888465158,2907383901
2025-06-19 06:10:34,REAL,2888465158,480,2888465638,2907384381
2025-06-19 06:10:36,REAL,2888465638,477,2888466115,2907384858
2025-06-19 06:10:38,REAL,2888466115,484,2888466599,2907385342
2025-06-19 06:10:40,FAKE,2888466599,238,2888466837,2907385882
2025-06-19 06:10:42,REAL,2888466837,482,2888467319,2907386364
2025-06-19 06:10:44,REAL,2888467319,491,2888467810,2907386855
2025-06-19 06:10:46,FAKE,2888467810,241,2888468051,2907387339
2025-06-19 06:10:48,FAKE,2888468051,244,2888468295,2907387830
2025-06-19 06:10:50,REAL,2888468295,481,2888468776,2907388311
2025-06-19 06:10:52,REAL,2888468776,484,2888469260,2907388795
2025-06-19 06:10:54,REAL,2888469260,478,2888469738,2907389273
2025-06-19 06:10:56,REAL,2888469738,485,2888470223,2907389758
2025-06-19 06:10:58,REAL,2888470223,6034,2888476257,2907395792
2025-06-19 06:11:00,REAL,2888476257,10910,2888487167,2907406702
2025-06-19 06:11:02,FAKE,2888487167,241,2888487408,2907416948
2025-06-19 06:11:04,REAL,2888487408,10313,2888497721,2907427261
2025-06-19 06:11:06,REAL,2888497721,10257,2888507978,2907437518
2025-06-19 06:11:08,FAKE,2888507978,243,2888508221,2907447775
2025-06-19 06:11:10,REAL,2888508221,10252,2888518473,2907458027
2025-06-19 06:11:12,REAL,2888518473,10249,2888528722,2907468276
2025-06-19 06:11:14,REAL,2888528722,873,2888529595,2907469149
2025-06-19 06:11:16,REAL,2888529595,542,2888530137,2907469691
2025-06-19 06:11:18,REAL,2888530137,493,2888530630,2907470184
2025-06-19 06:11:20,FAKE,2888530630,238,2888530868,2907470667
2025-06-19 06:11:22,REAL,2888530868,487,2888531355,2907471154
2025-06-19 06:11:24,FAKE,2888531355,241,2888531596,2907471631
2025-06-19 06:11:26,REAL,2888531596,543,2888532139,2907472174
2025-06-19 06:11:28,REAL,2888532139,483,2888532622,2907472657
2025-06-19 06:11:30,REAL,2888532622,491,2888533113,2907473148
2025-06-19 06:11:32,REAL,2888533113,482,2888533595,2907473630
2025-06-19 06:11:34,REAL,2888533595,481,2888534076,2907474111
2025-06-19 06:11:36,REAL,2888534076,487,2888534563,2907474598
2025-06-19 06:11:38,REAL,2888534563,491,2888535054,2907475089
2025-06-19 06:11:40,FAKE,2888535054,244,2888535298,2907475579
2025-06-19 06:11:42,FAKE,2888535298,241,2888535539,2907476060
2025-06-19 06:11:44,REAL,2888535539,483,2888536022,2907476543
2025-06-19 06:11:46,REAL,2888536022,492,2888536514,2907477035
2025-06-19 06:11:48,REAL,2888536514,482,2888536996,2907477517
2025-06-19 06:11:50,REAL,2888536996,492,2888537488,2907478009
2025-06-19 06:11:52,REAL,2888537488,491,2888537979,2907478500
2025-06-19 06:11:54,REAL,2888537979,533,2888538512,2907479033
2025-06-19 06:11:56,REAL,2888538512,484,2888538996,2907479517
2025-06-19 06:11:58,FAKE,2888538996,243,2888539239,2907480004
2025-06-19 06:12:00,REAL,2888539239,481,2888539720,2907480485
2025-06-19 06:12:02,FAKE,2888539720,244,2888539964,2907480970
2025-06-19 06:12:04,REAL,2888539964,490,2888540454,2907481460
2025-06-19 06:12:06,FAKE,2888540454,238,2888540692,2907481994
2025-06-19 06:12:08,REAL,2888540692,486,2888541178,2907482480
2025-06-19 06:12:10,REAL,2888541178,485,2888541663,2907482965
2025-06-19 06:12:12,REAL,2888541663,487,2888542150,2907483452
2025-06-19 06:12:14,REAL,2888542150,486,2888542636,2907483938
2025-06-19 06:12:16,FAKE,2888542636,244,2888542880,2907484416
2025-06-19 06:12:18,REAL,2888542880,492,2888543372,2907484908
2025-06-19 06:12:20,REAL,2888543372,478,2888543850,2907485386
2025-06-19 06:12:22,REAL,2888543850,538,2888544388,2907485924
2025-06-19 06:12:24,REAL,2888544388,485,2888544873,2907486409
2025-06-19 06:12:26,REAL,2888544873,488,2888545361,2907486897
2025-06-19 06:12:28,FAKE,2888545361,241,2888545602,2907487380
2025-06-19 06:12:30,REAL,2888545602,479,2888546081,2907487859
2025-06-19 06:12:32,REAL,2888546081,478,2888546559,2907488337
2025-06-19 06:12:34,REAL,2888546559,485,2888547044,2907488822
2025-06-19 06:12:36,REAL,2888547044,484,2888547528,2907489306
2025-06-19 06:12:38,FAKE,2888547528,244,2888547772,2907489784
2025-06-19 06:12:40,REAL,2888547772,482,2888548254,2907490266
2025-06-19 06:12:42,REAL,2888548254,480,2888548734,2907490746
2025-06-19 06:12:44,FAKE,2888548734,243,2888548977,2907491237
2025-06-19 06:12:46,REAL,2888548977,480,2888549457,2907491717
2025-06-19 06:12:48,REAL,2888549457,483,2888549940,2907492200
2025-06-19 06:12:50,REAL,2888549940,478,2888550418,2907492678
2025-06-19 06:12:52,REAL,2888550418,534,2888550952,2907493212
2025-06-19 06:12:54,FAKE,2888550952,238,2888551190,2907495811
2025-06-19 06:12:56,FAKE,2888551190,241,2888551431,2907507385
2025-06-19 06:12:58,REAL,2888551431,10304,2888561735,2907517689
2025-06-19 06:13:00,FAKE,2888561735,238,2888561973,2907527944
2025-06-19 06:13:02,REAL,2888561973,10314,2888572287,2907538258
2025-06-19 06:13:04,FAKE,2888572287,243,2888572530,2907548505
2025-06-19 06:13:06,FAKE,2888572530,243,2888572773,2907558749
2025-06-19 06:13:08,REAL,2888572773,10317,2888583090,2907569066
2025-06-19 06:13:10,FAKE,2888583090,243,2888583333,2907572588
2025-06-19 06:13:12,REAL,2888583333,479,2888583812,2907573067
2025-06-19 06:13:14,REAL,2888583812,482,2888584294,2907573549
2025-06-19 06:13:16,REAL,2888584294,476,2888584770,2907574025
2025-06-19 06:13:18,REAL,2888584770,484,2888585254,2907574509
2025-06-19 06:13:20,REAL,2888585254,479,2888585733,2907574988
2025-06-19 06:13:22,REAL,2888585733,589,2888586322,2907575577
2025-06-19 06:13:24,FAKE,2888586322,238,2888586560,2907576063
2025-06-19 06:13:26,REAL,2888586560,487,2888587047,2907576550
2025-06-19 06:13:28,FAKE,2888587047,241,2888587288,2907577032
2025-06-19 06:13:30,REAL,2888587288,484,2888587772,2907577516
2025-06-19 06:13:32,REAL,2888587772,480,2888588252,2907577996
2025-06-19 06:13:34,FAKE,2888588252,238,2888588490,2907578472
2025-06-19 06:13:36,REAL,2888588490,486,2888588976,2907578958
2025-06-19 06:13:38,REAL,2888588976,491,2888589467,2907579449
2025-06-19 06:13:40,REAL,2888589467,479,2888589946,2907579928
2025-06-19 06:13:42,FAKE,2888589946,241,2888590187,2907580416
2025-06-19 06:13:44,FAKE,2888590187,238,2888590425,2907580898
2025-06-19 06:13:46,REAL,2888590425,479,2888590904,2907581377
2025-06-19 06:13:48,REAL,2888590904,536,2888591440,2907581913
2025-06-19 06:13:50,REAL,2888591440,488,2888591928,2907582401
2025-06-19 06:13:52,REAL,2888591928,482,2888592410,2907582883
2025-06-19 06:13:54,REAL,2888592410,543,2888592953,2907583426
2025-06-19 06:13:56,FAKE,2888592953,241,2888593194,2907583907
2025-06-19 06:13:58,REAL,2888593194,483,2888593677,2907584390
2025-06-19 06:14:00,REAL,2888593677,488,2888594165,2907584878
2025-06-19 06:14:02,REAL,2888594165,478,2888594643,2907585356
2025-06-19 06:14:04,REAL,2888594643,481,2888595124,2907585837
2025-06-19 06:14:06,REAL,2888595124,481,2888595605,2907586318
2025-06-19 06:14:08,REAL,2888595605,483,2888596088,2907586801
2025-06-19 06:14:10,REAL,2888596088,487,2888596575,2907587288
2025-06-19 06:14:12,FAKE,2888596575,244,2888596819,2907587833
2025-06-19 06:14:14,REAL,2888596819,483,2888597302,2907588316
2025-06-19 06:14:16,REAL,2888597302,485,2888597787,2907588801
2025-06-19 06:14:18,REAL,2888597787,482,2888598269,2907589283
2025-06-19 06:14:20,REAL,2888598269,477,2888598746,2907589760
2025-06-19 06:14:22,FAKE,2888598746,244,2888598990,2907590243
2025-06-19 06:14:24,REAL,2888598990,481,2888599471,2907590724
2025-06-19 06:14:26,FAKE,2888599471,241,2888599712,2907591206
2025-06-19 06:14:28,FAKE,2888599712,243,2888599955,2907591753
2025-06-19 06:14:30,FAKE,2888599955,243,2888600198,2907604665
2025-06-19 06:14:32,REAL,2888600198,10979,2888611177,2907615644
2025-06-19 06:14:34,REAL,2888611177,10252,2888621429,2907625896
2025-06-19 06:14:36,REAL,2888621429,10251,2888631680,2907636147
2025-06-19 06:14:38,FAKE,2888631680,243,2888631923,2907646521
2025-06-19 06:14:40,REAL,2888631923,10244,2888642167,2907656765
2025-06-19 06:14:42,REAL,2888642167,10254,2888652421,2907667019
2025-06-19 06:14:44,FAKE,2888652421,238,2888652659,2907673910
2025-06-19 06:14:46,FAKE,2888652659,243,2888652902,2907674399
2025-06-19 06:14:48,REAL,2888652902,482,2888653384,2907674881
2025-06-19 06:14:50,REAL,2888653384,480,2888653864,2907675361
2025-06-19 06:14:52,REAL,2888653864,494,2888654358,2907675855
2025-06-19 06:14:54,REAL,2888654358,487,2888654845,2907676342
2025-06-19 06:14:56,REAL,2888654845,484,2888655329,2907676826
2025-06-19 06:14:58,FAKE,2888655329,244,2888655573,2907677312
2025-06-19 06:15:00,REAL,2888655573,543,2888656116,2907677855
2025-06-19 06:15:02,REAL,2888656116,14276,2888670392,2907692131
2025-06-19 06:15:04,FAKE,2888670392,243,2888670635,2907702575
2025-06-19 06:15:06,FAKE,2888670635,243,2888670878,2907712891
2025-06-19 06:15:08,REAL,2888670878,10254,2888681132,2907723145
2025-06-19 06:15:10,FAKE,2888681132,244,2888681376,2907733403
2025-06-19 06:15:12,REAL,2888681376,10252,2888691628,2907743655
2025-06-19 06:15:14,REAL,2888691628,10320,2888701948,2907753975
2025-06-19 06:15:16,REAL,2888701948,6227,2888708175,2907760202
2025-06-19 06:15:18,REAL,2888708175,478,2888708653,2907760680
2025-06-19 06:15:20,REAL,2888708653,491,2888709144,2907761171
2025-06-19 06:15:22,REAL,2888709144,488,2888709632,2907761659
2025-06-19 06:15:24,FAKE,2888709632,238,2888709870,2907762148
2025-06-19 06:15:26,REAL,2888709870,545,2888710415,2907762693
2025-06-19 06:15:28,REAL,2888710415,478,2888710893,2907763171
2025-06-19 06:15:30,REAL,2888710893,478,2888711371,2907763649
2025-06-19 06:15:32,REAL,2888711371,482,2888711853,2907764131
2025-06-19 06:15:34,REAL,2888711853,535,2888712388,2907764666
2025-06-19 06:15:36,FAKE,2888712388,241,2888712629,2907765143
2025-06-19 06:15:38,REAL,2888712629,484,2888713113,2907765627
2025-06-19 06:15:40,FAKE,2888713113,244,2888713357,2907766116
2025-06-19 06:15:42,FAKE,2888713357,238,2888713595,2907766600
2025-06-19 06:15:44,REAL,2888713595,480,2888714075,2907767080
2025-06-19 06:15:46,FAKE,2888714075,243,2888714318,2907767567
2025-06-19 06:15:48,REAL,2888714318,482,2888714800,2907768049
2025-06-19 06:15:50,FAKE,2888714800,244,2888715044,2907768531
2025-06-19 06:15:52,REAL,2888715044,538,2888715582,2907769069
2025-06-19 06:15:54,REAL,2888715582,7365,2888722947,2907776434
2025-06-19 06:15:56,FAKE,2888722947,241,2888723188,2907789788
2025-06-19 06:15:58,REAL,2888723188,10252,2888733440,2907800040
2025-06-19 06:16:00,REAL,2888733440,10321,2888743761,2907810361
2025-06-19 06:16:02,FAKE,2888743761,238,2888743999,2907820603
2025-06-19 06:16:04,REAL,2888743999,10247,2888754246,2907830850
2025-06-19 06:16:06,REAL,2888754246,10318,2888764564,2907841168
2025-06-19 06:16:08,FAKE,2888764564,244,2888764808,2907851345
2025-06-19 06:16:10,REAL,2888764808,489,2888765297,2907851834
2025-06-19 06:16:12,REAL,2888765297,484,2888765781,2907852318
2025-06-19 06:16:14,FAKE,2888765781,244,2888766025,2907852799
2025-06-19 06:16:16,REAL,2888766025,542,2888766567,2907853341
2025-06-19 06:16:18,REAL,2888766567,491,2888767058,2907853832
2025-06-19 06:16:20,REAL,2888767058,483,2888767541,2907854315
2025-06-19 06:16:22,REAL,2888767541,490,2888768031,2907854805
2025-06-19 06:16:24,REAL,2888768031,481,2888768512,2907855286
2025-06-19 06:16:26,REAL,2888768512,484,2888768996,2907855770
2025-06-19 06:16:28,FAKE,2888768996,244,2888769240,2907856309
2025-06-19 06:16:30,REAL,2888769240,491,2888769731,2907856800
2025-06-19 06:16:32,REAL,2888769731,483,2888770214,2907857283
2025-06-19 06:16:34,FAKE,2888770214,238,2888770452,2907857767
2025-06-19 06:16:36,REAL,2888770452,490,2888770942,2907858257
2025-06-19 06:16:38,REAL,2888770942,490,2888771432,2907858747
2025-06-19 06:16:40,FAKE,2888771432,244,2888771676,2907859286
2025-06-19 06:16:42,REAL,2888771676,480,2888772156,2907859766
2025-06-19 06:16:44,FAKE,2888772156,241,2888772397,2907860254
2025-06-19 06:16:46,FAKE,2888772397,241,2888772638,2907860740
2025-06-19 06:16:48,REAL,2888772638,483,2888773121,2907861223
2025-06-19 06:16:50,REAL,2888773121,481,2888773602,2907861704
2025-06-19 06:16:52,FAKE,2888773602,244,2888773846,2907862184
2025-06-19 06:16:54,FAKE,2888773846,244,2888774090,2907862663
2025-06-19 06:16:56,REAL,2888774090,492,2888774582,2907863155
2025-06-19 06:16:58,REAL,2888774582,7423,2888782005,2907870578
2025-06-19 06:17:00,REAL,2888782005,10716,2888792721,2907881294
2025-06-19 06:17:02,REAL,2888792721,10246,2888802967,2907891540
2025-06-19 06:17:04,FAKE,2888802967,238,2888803205,2907901845
2025-06-19 06:17:06,REAL,2888803205,10311,2888813516,2907912156
2025-06-19 06:17:08,REAL,2888813516,10255,2888823771,2907922411
2025-06-19 06:17:10,REAL,2888823771,10261,2888834032,2907932672
2025-06-19 06:17:12,REAL,2888834032,8691,2888842723,2907941363
2025-06-19 06:17:14,REAL,2888842723,488,2888843211,2907941851
2025-06-19 06:17:16,REAL,2888843211,491,2888843702,2907942342
2025-06-19 06:17:18,REAL,2888843702,477,2888844179,2907942819
2025-06-19 06:17:20,FAKE,2888844179,243,2888844422,2907943310
2025-06-19 06:17:22,REAL,2888844422,479,2888844901,2907943789
2025-06-19 06:17:24,FAKE,2888844901,241,2888845142,2907944268
2025-06-19 06:17:26,REAL,2888845142,489,2888845631,2907944757
2025-06-19 06:17:28,FAKE,2888845631,238,2888845869,2907945245
2025-06-19 06:17:30,REAL,2888845869,594,2888846463,2907945839
2025-06-19 06:17:32,REAL,2888846463,491,2888846954,2907946330
2025-06-19 06:17:34,REAL,2888846954,485,2888847439,2907946815
2025-06-19 06:17:36,REAL,2888847439,490,2888847929,2907947305
2025-06-19 06:17:38,REAL,2888847929,491,2888848420,2907947796
2025-06-19 06:17:40,REAL,2888848420,482,2888848902,2907948278
2025-06-19 06:17:42,REAL,2888848902,479,2888849381,2907948757
2025-06-19 06:17:44,FAKE,2888849381,243,2888849624,2907949247
2025-06-19 06:17:46,REAL,2888849624,481,2888850105,2907949728
2025-06-19 06:17:48,FAKE,2888850105,243,2888850348,2907950213
2025-06-19 06:17:50,REAL,2888850348,482,2888850830,2907950695
2025-06-19 06:17:52,REAL,2888850830,479,2888851309,2907951174
2025-06-19 06:17:54,REAL,2888851309,541,2888851850,2907951715
2025-06-19 06:17:56,REAL,2888851850,486,2888852336,2907952201
2025-06-19 06:17:58,REAL,2888852336,492,2888852828,2907952693
2025-06-19 06:18:00,FAKE,2888852828,241,2888853069,2907953173
2025-06-19 06:18:02,FAKE,2888853069,241,2888853310,2907962053
2025-06-19 06:18:04,REAL,2888853310,10582,2888863892,2907972635
2025-06-19 06:18:06,FAKE,2888863892,238,2888864130,2907982881
2025-06-19 06:18:08,REAL,2888864130,10317,2888874447,2907993198
2025-06-19 06:18:10,FAKE,2888874447,244,2888874691,2908003448
2025-06-19 06:18:12,REAL,2888874691,10254,2888884945,2908013702
2025-06-19 06:18:14,FAKE,2888884945,243,2888885188,2908023958
2025-06-19 06:18:16,REAL,2888885188,7678,2888892866,2908031636
2025-06-19 06:18:18,FAKE,2888892866,243,2888893109,2908032173
2025-06-19 06:18:20,REAL,2888893109,481,2888893590,2908032654
2025-06-19 06:18:22,REAL,2888893590,485,2888894075,2908033139
2025-06-19 06:18:24,REAL,2888894075,490,2888894565,2908033629
2025-06-19 06:18:26,REAL,2888894565,488,2888895053,2908034117
2025-06-19 06:18:28,REAL,2888895053,476,2888895529,2908034593
2025-06-19 06:18:30,REAL,2888895529,483,2888896012,2908035076
2025-06-19 06:18:32,REAL,2888896012,481,2888896493,2908035557
2025-06-19 06:18:34,FAKE,2888896493,244,2888896737,2908036098
2025-06-19 06:18:36,REAL,2888896737,487,2888897224,2908036585
2025-06-19 06:18:38,REAL,2888897224,735,2888897959,2908037320
2025-06-19 06:18:40,FAKE,2888897959,243,2888898202,2908037564
2025-06-19 06:18:42,FAKE,2888898202,238,2888898440,2908038097
2025-06-19 06:18:44,REAL,2888898440,477,2888898917,2908038574
2025-06-19 06:18:46,REAL,2888898917,485,2888899402,2908039059
2025-06-19 06:18:48,FAKE,2888899402,244,2888899646,2908039546
2025-06-19 06:18:50,REAL,2888899646,481,2888900127,2908040027
2025-06-19 06:18:52,REAL,2888900127,480,2888900607,2908040507
2025-06-19 06:18:54,REAL,2888900607,479,2888901086,2908040986
2025-06-19 06:18:56,FAKE,2888901086,241,2888901327,2908041468
2025-06-19 06:18:58,REAL,2888901327,479,2888901806,2908041947
2025-06-19 06:19:00,FAKE,2888901806,238,2888902044,2908042435
2025-06-19 06:19:02,REAL,2888902044,481,2888902525,2908042916
2025-06-19 06:19:04,REAL,2888902525,478,2888903003,2908043394
2025-06-19 06:19:06,REAL,2888903003,493,2888903496,2908043887
2025-06-19 06:19:08,FAKE,2888903496,243,2888903739,2908044482
2025-06-19 06:19:10,FAKE,2888903739,243,2888903982,2908044965
2025-06-19 06:19:12,FAKE,2888903982,243,2888904225,2908045452
2025-06-19 06:19:14,REAL,2888904225,481,2888904706,2908045933
2025-06-19 06:19:16,FAKE,2888904706,241,2888904947,2908046412
2025-06-19 06:19:18,REAL,2888904947,480,2888905427,2908046892
2025-06-19 06:19:20,REAL,2888905427,479,2888905906,2908047371
2025-06-19 06:19:22,FAKE,2888905906,238,2888906144,2908058555
2025-06-19 06:19:24,REAL,2888906144,10255,2888916399,2908068810
2025-06-19 06:19:26,REAL,2888916399,10317,2888926716,2908079127
2025-06-19 06:19:28,REAL,2888926716,10251,2888936967,2908089378
2025-06-19 06:19:30,REAL,2888936967,10321,2888947288,2908099699
2025-06-19 06:19:32,REAL,2888947288,10301,2888957589,2908110000
2025-06-19 06:19:34,REAL,2888957589,10246,2888967835,2908120246
2025-06-19 06:19:36,REAL,2888967835,6093,2888973928,2908126339
2025-06-19 06:19:38,FAKE,2888973928,244,2888974172,2908126827
2025-06-19 06:19:40,REAL,2888974172,481,2888974653,2908127308
2025-06-19 06:19:42,REAL,2888974653,482,2888975135,2908127790
2025-06-19 06:19:44,FAKE,2888975135,243,2888975378,2908128276
2025-06-19 06:19:46,FAKE,2888975378,243,2888975621,2908128761
2025-06-19 06:19:48,FAKE,2888975621,243,2888975864,2908129245
2025-06-19 06:19:50,REAL,2888975864,486,2888976350,2908129731
2025-06-19 06:19:52,REAL,2888976350,487,2888976837,2908130218
2025-06-19 06:19:54,REAL,2888976837,485,2888977322,2908130703
2025-06-19 06:19:56,FAKE,2888977322,238,2888977560,2908131298
2025-06-19 06:19:58,FAKE,2888977560,241,2888977801,2908131781
2025-06-19 06:20:00,FAKE,2888977801,238,2888978039,2908132266
2025-06-19 06:20:02,FAKE,2888978039,243,2888978282,2908132759
2025-06-19 06:20:04,REAL,2888978282,486,2888978768,2908133245
2025-06-19 06:20:06,REAL,2888978768,488,2888979256,2908133733
2025-06-19 06:20:08,REAL,2888979256,490,2888979746,2908134223
2025-06-19 06:20:10,FAKE,2888979746,241,2888979987,2908134716
2025-06-19 06:20:12,REAL,2888979987,481,2888980468,2908135197
2025-06-19 06:20:14,REAL,2888980468,479,2888980947,2908135676
2025-06-19 06:20:16,FAKE,2888980947,244,2888981191,2908136160
2025-06-19 06:20:18,REAL,2888981191,481,2888981672,2908136641
2025-06-19 06:20:20,REAL,2888981672,488,2888982160,2908137129
2025-06-19 06:20:22,REAL,2888982160,532,2888982692,2908137661
2025-06-19 06:20:24,REAL,2888982692,486,2888983178,2908138147
2025-06-19 06:20:26,REAL,2888983178,484,2888983662,2908138631
2025-06-19 06:20:28,FAKE,2888983662,241,2888983903,2908139110
2025-06-19 06:20:30,REAL,2888983903,547,2888984450,2908139657
2025-06-19 06:20:32,REAL,2888984450,488,2888984938,2908140145
2025-06-19 06:20:34,REAL,2888984938,483,2888985421,2908140628
2025-06-19 06:20:36,REAL,2888985421,487,2888985908,2908141115
2025-06-19 06:20:38,REAL,2888985908,488,2888986396,2908141603
2025-06-19 06:20:40,REAL,2888986396,479,2888986875,2908142082
2025-06-19 06:20:42,REAL,2888986875,486,2888987361,2908142568
2025-06-19 06:20:44,FAKE,2888987361,238,2888987599,2908143051
2025-06-19 06:20:46,REAL,2888987599,483,2888988082,2908143534
2025-06-19 06:20:48,REAL,2888988082,539,2888988621,2908144073
2025-06-19 06:20:50,FAKE,2888988621,238,2888988859,2908144554
2025-06-19 06:20:52,REAL,2888988859,479,2888989338,2908145033
2025-06-19 06:20:54,FAKE,2888989338,241,2888989579,2908145517
2025-06-19 06:20:56,REAL,2888989579,488,2888990067,2908146005
2025-06-19 06:20:58,REAL,2888990067,482,2888990549,2908146487
2025-06-19 06:21:00,FAKE,2888990549,241,2888990790,2908146974
2025-06-19 06:21:02,REAL,2888990790,490,2888991280,2908147464
2025-06-19 06:21:04,REAL,2888991280,488,2888991768,2908147952
2025-06-19 06:21:06,REAL,2888991768,533,2888992301,2908148485
2025-06-19 06:21:08,REAL,2888992301,478,2888992779,2908148963
2025-06-19 06:21:10,FAKE,2888992779,241,2888993020,2908149452
2025-06-19 06:21:12,FAKE,2888993020,244,2888993264,2908149986
2025-06-19 06:21:14,REAL,2888993264,476,2888993740,2908150462
2025-06-19 06:21:16,REAL,2888993740,476,2888994216,2908150938
2025-06-19 06:21:18,REAL,2888994216,485,2888994701,2908151423
2025-06-19 06:21:20,FAKE,2888994701,244,2888994945,2908151911
2025-06-19 06:21:22,REAL,2888994945,477,2888995422,2908152388
2025-06-19 06:21:24,FAKE,2888995422,241,2888995663,2908152875
2025-06-19 06:21:26,REAL,2888995663,493,2888996156,2908153368
2025-06-19 06:21:28,REAL,2888996156,478,2888996634,2908153846
2025-06-19 06:21:30,REAL,2888996634,485,2888997119,2908154331
2025-06-19 06:21:32,FAKE,2888997119,243,2888997362,2908154814
2025-06-19 06:21:34,REAL,2888997362,480,2888997842,2908155294
2025-06-19 06:21:36,REAL,2888997842,538,2888998380,2908155832
2025-06-19 06:21:38,FAKE,2888998380,243,2888998623,2908158306
2025-06-19 06:21:40,REAL,2888998623,11042,2889009665,2908169348
2025-06-19 06:21:42,REAL,2889009665,10244,2889019909,2908179592
2025-06-19 06:21:44,FAKE,2889019909,243,2889020152,2908189916
2025-06-19 06:21:46,REAL,2889020152,10256,2889030408,2908200172
2025-06-19 06:21:48,REAL,2889030408,10251,2889040659,2908210423
2025-06-19 06:21:50,FAKE,2889040659,243,2889040902,2908220736
2025-06-19 06:21:52,REAL,2889040902,10246,2889051148,2908230982
2025-06-19 06:21:54,REAL,2889051148,3712,2889054860,2908234694
2025-06-19 06:21:56,REAL,2889054860,481,2889055341,2908235175
2025-06-19 06:21:58,FAKE,2889055341,243,2889055584,2908235660
2025-06-19 06:22:00,FAKE,2889055584,244,2889055828,2908236146
2025-06-19 06:22:02,REAL,2889055828,538,2889056366,2908236684
2025-06-19 06:22:04,REAL,2889056366,485,2889056851,2908237169
2025-06-19 06:22:06,REAL,2889056851,494,2889057345,2908237663
2025-06-19 06:22:08,REAL,2889057345,490,2889057835,2908238153
2025-06-19 06:22:10,REAL,2889057835,483,2889058318,2908238636
2025-06-19 06:22:12,REAL,2889058318,539,2889058857,2908239175
2025-06-19 06:22:14,REAL,2889058857,482,2889059339,2908239657
2025-06-19 06:22:16,REAL,2889059339,488,2889059827,2908240145
2025-06-19 06:22:18,REAL,2889059827,488,2889060315,2908240633
2025-06-19 06:22:20,REAL,2889060315,482,2889060797,2908241115
2025-06-19 06:22:22,FAKE,2889060797,241,2889061038,2908241597
2025-06-19 06:22:24,REAL,2889061038,485,2889061523,2908242082
2025-06-19 06:22:26,REAL,2889061523,548,2889062071,2908242630
2025-06-19 06:22:28,REAL,2889062071,479,2889062550,2908243109
2025-06-19 06:22:30,FAKE,2889062550,238,2889062788,2908243592
2025-06-19 06:22:32,REAL,2889062788,11254,2889074042,2908254846
2025-06-19 06:22:34,REAL,2889074042,11573,2889085615,2908266419
2025-06-19 06:22:36,REAL,2889085615,10261,2889095876,2908276680
2025-06-19 06:22:38,REAL,2889095876,10248,2889106124,2908286928
2025-06-19 06:22:40,REAL,2889106124,10319,2889116443,2908297247
2025-06-19 06:22:42,FAKE,2889116443,238,2889116681,2908307506
2025-06-19 06:22:44,FAKE,2889116681,243,2889116924,2908317763
2025-06-19 06:22:46,FAKE,2889116924,243,2889117167,2908325313
2025-06-19 06:22:48,REAL,2889117167,485,2889117652,2908325798
2025-06-19 06:22:50,FAKE,2889117652,243,2889117895,2908326342
2025-06-19 06:22:52,REAL,2889117895,487,2889118382,2908326829
2025-06-19 06:22:54,REAL,2889118382,486,2889118868,2908327315
2025-06-19 06:22:56,REAL,2889118868,476,2889119344,2908327791
2025-06-19 06:22:58,REAL,2889119344,481,2889119825,2908328272
2025-06-19 06:23:00,REAL,2889119825,493,2889120318,2908328765
2025-06-19 06:23:02,REAL,2889120318,484,2889120802,2908329249
2025-06-19 06:23:04,REAL,2889120802,488,2889121290,2908329737
2025-06-19 06:23:06,REAL,2889121290,543,2889121833,2908330280
2025-06-19 06:23:08,REAL,2889121833,481,2889122314,2908330761
2025-06-19 06:23:10,REAL,2889122314,479,2889122793,2908331240
2025-06-19 06:23:12,REAL,2889122793,483,2889123276,2908331723
2025-06-19 06:23:14,REAL,2889123276,484,2889123760,2908332207
2025-06-19 06:23:16,REAL,2889123760,487,2889124247,2908332694
2025-06-19 06:23:18,REAL,2889124247,491,2889124738,2908333185
2025-06-19 06:23:20,FAKE,2889124738,241,2889124979,2908333674
2025-06-19 06:23:22,FAKE,2889124979,241,2889125220,2908334159
2025-06-19 06:23:24,REAL,2889125220,482,2889125702,2908334641
2025-06-19 06:23:26,REAL,2889125702,486,2889126188,2908335127
2025-06-19 06:23:28,REAL,2889126188,481,2889126669,2908335608
2025-06-19 06:23:30,FAKE,2889126669,243,2889126912,2908336093
2025-06-19 06:23:32,REAL,2889126912,491,2889127403,2908336584
2025-06-19 06:23:34,REAL,2889127403,482,2889127885,2908337066
2025-06-19 06:23:36,REAL,2889127885,476,2889128361,2908337542
2025-06-19 06:23:38,FAKE,2889128361,243,2889128604,2908338085
2025-06-19 06:23:40,FAKE,2889128604,241,2889128845,2908338629
2025-06-19 06:23:42,FAKE,2889128845,241,2889129086,2908339113
2025-06-19 06:23:44,REAL,2889129086,492,2889129578,2908339605
2025-06-19 06:23:46,REAL,2889129578,487,2889130065,2908340092
2025-06-19 06:23:48,FAKE,2889130065,243,2889130308,2908340573
2025-06-19 06:23:50,REAL,2889130308,486,2889130794,2908341059
2025-06-19 06:23:52,REAL,2889130794,484,2889131278,2908341543
2025-06-19 06:23:54,REAL,2889131278,482,2889131760,2908342025
2025-06-19 06:23:56,REAL,2889131760,479,2889132239,2908342504
2025-06-19 06:23:58,FAKE,2889132239,241,2889132480,2908342981
2025-06-19 06:24:00,REAL,2889132480,478,2889132958,2908343459
2025-06-19 06:24:02,REAL,2889132958,491,2889133449,2908343950
2025-06-19 06:24:04,REAL,2889133449,488,2889133937,2908344438
2025-06-19 06:24:06,REAL,2889133937,486,2889134423,2908344924
2025-06-19 06:24:08,FAKE,2889134423,244,2889134667,2908345403
2025-06-19 06:24:10,REAL,2889134667,481,2889135148,2908345884
2025-06-19 06:24:12,REAL,2889135148,491,2889135639,2908346375
2025-06-19 06:24:14,REAL,2889135639,484,2889136123,2908346859
2025-06-19 06:24:16,REAL,2889136123,481,2889136604,2908347340
2025-06-19 06:24:18,REAL,2889136604,541,2889137145,2908347881
2025-06-19 06:24:20,FAKE,2889137145,241,2889137386,2908348357
2025-06-19 06:24:22,REAL,2889137386,485,2889137871,2908348842
2025-06-19 06:24:24,FAKE,2889137871,244,2889138115,2908349373
2025-06-19 06:24:26,REAL,2889138115,475,2889138590,2908349848
2025-06-19 06:24:28,REAL,2889138590,488,2889139078,2908350336
2025-06-19 06:24:30,FAKE,2889139078,241,2889139319,2908350820
2025-06-19 06:24:32,REAL,2889139319,475,2889139794,2908351295
2025-06-19 06:24:34,REAL,2889139794,15205,2889154999,2908366500
2025-06-19 06:24:36,REAL,2889154999,10242,2889165241,2908376742
2025-06-19 06:24:38,REAL,2889165241,10320,2889175561,2908387062
2025-06-19 06:24:40,REAL,2889175561,10252,2889185813,2908397314
2025-06-19 06:24:42,REAL,2889185813,10251,2889196064,2908407565
2025-06-19 06:24:44,REAL,2889196064,10245,2889206309,2908417810
2025-06-19 06:24:46,REAL,2889206309,10316,2889216625,2908428126
2025-06-19 06:24:48,REAL,2889216625,5305,2889221930,2908433431
2025-06-19 06:24:50,REAL,2889221930,491,2889222421,2908433922
2025-06-19 06:24:52,REAL,2889222421,478,2889222899,2908434400
2025-06-19 06:24:54,FAKE,2889222899,244,2889223143,2908434883
2025-06-19 06:24:56,REAL,2889223143,476,2889223619,2908435359
2025-06-19 06:24:58,REAL,2889223619,482,2889224101,2908435841
2025-06-19 06:25:00,FAKE,2889224101,244,2889224345,2908436323
2025-06-19 06:25:02,REAL,2889224345,480,2889224825,2908436803
2025-06-19 06:25:04,REAL,2889224825,1086,2889225911,2908437889
2025-06-19 06:25:06,REAL,2889225911,12037,2889237948,2908449926
2025-06-19 06:25:08,REAL,2889237948,10248,2889248196,2908460174
2025-06-19 06:25:10,FAKE,2889248196,243,2889248439,2908470431
2025-06-19 06:25:12,FAKE,2889248439,244,2889248683,2908480741
2025-06-19 06:25:14,FAKE,2889248683,241,2889248924,2908491058
2025-06-19 06:25:16,FAKE,2889248924,243,2889249167,2908501302
2025-06-19 06:25:18,REAL,2889249167,10249,2889259416,2908511551
2025-06-19 06:25:20,REAL,2889259416,4701,2889264117,2908516252
2025-06-19 06:25:22,FAKE,2889264117,241,2889264358,2908516738
2025-06-19 06:25:24,FAKE,2889264358,243,2889264601,2908517229
2025-06-19 06:25:26,REAL,2889264601,8939,2889273540,2908526168
2025-06-19 06:25:28,FAKE,2889273540,243,2889273783,2908538935
2025-06-19 06:25:30,REAL,2889273783,10252,2889284035,2908549187
2025-06-19 06:25:32,REAL,2889284035,10254,2889294289,2908559441
2025-06-19 06:25:34,REAL,2889294289,10250,2889304539,2908569691
2025-06-19 06:25:36,FAKE,2889304539,244,2889304783,2908579951
2025-06-19 06:25:38,FAKE,2889304783,241,2889305024,2908590275
2025-06-19 06:25:40,REAL,2889305024,9195,2889314219,2908599470
2025-06-19 06:25:42,REAL,2889314219,479,2889314698,2908599949
2025-06-19 06:25:44,REAL,2889314698,487,2889315185,2908600436
2025-06-19 06:25:46,REAL,2889315185,492,2889315677,2908600928
2025-06-19 06:25:48,REAL,2889315677,488,2889316165,2908601416
2025-06-19 06:25:50,FAKE,2889316165,243,2889316408,2908601900
2025-06-19 06:25:52,REAL,2889316408,484,2889316892,2908602384
2025-06-19 06:25:54,FAKE,2889316892,244,2889317136,2908602870
2025-06-19 06:25:56,REAL,2889317136,484,2889317620,2908603354
2025-06-19 06:25:58,FAKE,2889317620,241,2889317861,2908611836
2025-06-19 06:26:00,REAL,2889317861,10650,2889328511,2908622486
2025-06-19 06:26:02,FAKE,2889328511,238,2889328749,2908632740
2025-06-19 06:26:04,REAL,2889328749,10252,2889339001,2908642992
2025-06-19 06:26:06,REAL,2889339001,10250,2889349251,2908653242
2025-06-19 06:26:08,FAKE,2889349251,244,2889349495,2908663566
2025-06-19 06:26:10,FAKE,2889349495,241,2889349736,2908673818
2025-06-19 06:26:12,REAL,2889349736,8610,2889358346,2908682428
2025-06-19 06:26:14,REAL,2889358346,481,2889358827,2908682909
2025-06-19 06:26:16,FAKE,2889358827,243,2889359070,2908683399
2025-06-19 06:26:18,REAL,2889359070,477,2889359547,2908683876
2025-06-19 06:26:20,REAL,2889359547,478,2889360025,2908684354
2025-06-19 06:26:22,REAL,2889360025,485,2889360510,2908684839
2025-06-19 06:26:24,FAKE,2889360510,241,2889360751,2908685324
2025-06-19 06:26:26,FAKE,2889360751,241,2889360992,2908685810
2025-06-19 06:26:28,REAL,2889360992,483,2889361475,2908686293
2025-06-19 06:26:30,FAKE,2889361475,241,2889361716,2908695301
2025-06-19 06:26:32,FAKE,2889361716,244,2889361960,2908705816
2025-06-19 06:26:34,FAKE,2889361960,241,2889362201,2908716065
2025-06-19 06:26:36,FAKE,2889362201,238,2889362439,2908726317
2025-06-19 06:26:38,FAKE,2889362439,238,2889362677,2908736633
2025-06-19 06:26:40,REAL,2889362677,10250,2889372927,2908746883
2025-06-19 06:26:42,FAKE,2889372927,244,2889373171,2908757136
2025-06-19 06:26:44,REAL,2889373171,8001,2889381172,2908765137
2025-06-19 06:26:46,REAL,2889381172,542,2889381714,2908765679
2025-06-19 06:26:48,REAL,2889381714,492,2889382206,2908766171
2025-06-19 06:26:50,REAL,2889382206,481,2889382687,2908766652
2025-06-19 06:26:52,FAKE,2889382687,241,2889382928,2908767142
2025-06-19 06:26:54,FAKE,2889382928,241,2889383169,2908767635
2025-06-19 06:26:56,REAL,2889383169,481,2889383650,2908768116
2025-06-19 06:26:58,REAL,2889383650,481,2889384131,2908768597
2025-06-19 06:27:00,FAKE,2889384131,238,2889384369,2908769085
2025-06-19 06:27:02,REAL,2889384369,9528,2889393897,2908778613
2025-06-19 06:27:04,REAL,2889393897,10385,2889404282,2908788998
2025-06-19 06:27:06,FAKE,2889404282,243,2889404525,2908799252
2025-06-19 06:27:08,REAL,2889404525,10261,2889414786,2908809513
2025-06-19 06:27:10,FAKE,2889414786,238,2889415024,2908819763
2025-06-19 06:27:12,FAKE,2889415024,241,2889415265,2908830087
2025-06-19 06:27:14,REAL,2889415265,10252,2889425517,2908840339
2025-06-19 06:27:16,FAKE,2889425517,238,2889425755,2908847692
2025-06-19 06:27:18,FAKE,2889425755,241,2889425996,2908848186
2025-06-19 06:27:20,REAL,2889425996,485,2889426481,2908848671
2025-06-19 06:27:22,FAKE,2889426481,243,2889426724,2908849150
2025-06-19 06:27:24,REAL,2889426724,484,2889427208,2908849634
2025-06-19 06:27:26,REAL,2889427208,476,2889427684,2908850110
2025-06-19 06:27:28,REAL,2889427684,494,2889428178,2908850604
2025-06-19 06:27:30,REAL,2889428178,488,2889428666,2908851092
2025-06-19 06:27:32,REAL,2889428666,548,2889429214,2908851640
2025-06-19 06:27:34,FAKE,2889429214,244,2889429458,2908862164
2025-06-19 06:27:36,REAL,2889429458,10516,2889439974,2908872680
2025-06-19 06:27:38,REAL,2889439974,10247,2889450221,2908882927
2025-06-19 06:27:40,FAKE,2889450221,243,2889450464,2908893182
2025-06-19 06:27:42,REAL,2889450464,10257,2889460721,2908903439
2025-06-19 06:27:44,REAL,2889460721,10250,2889470971,2908913689
2025-06-19 06:27:46,FAKE,2889470971,238,2889471209,2908924013
2025-06-19 06:27:48,REAL,2889471209,6753,2889477962,2908930766
2025-06-19 06:27:50,REAL,2889477962,488,2889478450,2908931254
2025-06-19 06:27:52,REAL,2889478450,488,2889478938,2908931742
2025-06-19 06:27:54,REAL,2889478938,5442,2889484380,2908937184
2025-06-19 06:27:56,REAL,2889484380,12230,2889496610,2908949414
2025-06-19 06:27:58,REAL,2889496610,10253,2889506863,2908959667
2025-06-19 06:28:00,FAKE,2889506863,243,2889507106,2908969923
2025-06-19 06:28:02,REAL,2889507106,10250,2889517356,2908980173
2025-06-19 06:28:04,REAL,2889517356,10318,2889527674,2908990491
2025-06-19 06:28:06,REAL,2889527674,10250,2889537924,2909000741
2025-06-19 06:28:08,REAL,2889537924,10249,2889548173,2909010990
2025-06-19 06:28:10,REAL,2889548173,1671,2889549844,2909012661
2025-06-19 06:28:12,FAKE,2889549844,238,2889550082,2909013148
2025-06-19 06:28:14,FAKE,2889550082,244,2889550326,2909013628
2025-06-19 06:28:16,REAL,2889550326,478,2889550804,2909014106
2025-06-19 06:28:18,REAL,2889550804,490,2889551294,2909014596
2025-06-19 06:28:20,REAL,2889551294,539,2889551833,2909015135
2025-06-19 06:28:22,REAL,2889551833,479,2889552312,2909015614
2025-06-19 06:28:24,REAL,2889552312,489,2889552801,2909016103
2025-06-19 06:28:26,REAL,2889552801,480,2889553281,2909016583
2025-06-19 06:28:28,FAKE,2889553281,238,2889553519,2909017067
2025-06-19 06:28:30,FAKE,2889553519,244,2889553763,2909017545
2025-06-19 06:28:32,REAL,2889553763,492,2889554255,2909018037
2025-06-19 06:28:34,REAL,2889554255,533,2889554788,2909018570
2025-06-19 06:28:36,FAKE,2889554788,238,2889555026,2909019050
2025-06-19 06:28:38,REAL,2889555026,479,2889555505,2909019529
2025-06-19 06:28:40,REAL,2889555505,484,2889555989,2909020013
2025-06-19 06:28:42,REAL,2889555989,492,2889556481,2909020505
2025-06-19 06:28:44,FAKE,2889556481,243,2889556724,2909020980
2025-06-19 06:28:46,REAL,2889556724,486,2889557210,2909021466
2025-06-19 06:28:48,REAL,2889557210,484,2889557694,2909021950
2025-06-19 06:28:50,REAL,2889557694,479,2889558173,2909022429
2025-06-19 06:28:52,REAL,2889558173,544,2889558717,2909022973
2025-06-19 06:28:54,FAKE,2889558717,241,2889558958,2909023461
2025-06-19 06:28:56,REAL,2889558958,483,2889559441,2909023944
2025-06-19 06:28:58,REAL,2889559441,6304,2889565745,2909030248
2025-06-19 06:29:00,REAL,2889565745,11367,2889577112,2909041615
2025-06-19 06:29:02,REAL,2889577112,10250,2889587362,2909051865
2025-06-19 06:29:04,FAKE,2889587362,241,2889587603,2909062111
2025-06-19 06:29:06,REAL,2889587603,10316,2889597919,2909072427
2025-06-19 06:29:08,REAL,2889597919,10250,2889608169,2909082677
2025-06-19 06:29:10,REAL,2889608169,10316,2889618485,2909092993
2025-06-19 06:29:12,REAL,2889618485,10195,2889628680,2909103188
2025-06-19 06:29:14,FAKE,2889628680,241,2889628921,2909103670
2025-06-19 06:29:16,REAL,2889628921,483,2889629404,2909104153
2025-06-19 06:29:18,REAL,2889629404,484,2889629888,2909104637
2025-06-19 06:29:20,REAL,2889629888,541,2889630429,2909105178
2025-06-19 06:29:22,FAKE,2889630429,244,2889630673,2909105664
2025-06-19 06:29:24,REAL,2889630673,489,2889631162,2909106153
2025-06-19 06:29:26,REAL,2889631162,542,2889631704,2909106695
2025-06-19 06:29:28,FAKE,2889631704,244,2889631948,2909107178
2025-06-19 06:29:30,REAL,2889631948,480,2889632428,2909107658
2025-06-19 06:29:32,FAKE,2889632428,241,2889632669,2909108140
2025-06-19 06:29:34,FAKE,2889632669,238,2889632907,2909108630
2025-06-19 06:29:36,REAL,2889632907,489,2889633396,2909109119
2025-06-19 06:29:38,REAL,2889633396,483,2889633879,2909109602
2025-06-19 06:29:40,REAL,2889633879,489,2889634368,2909110091
2025-06-19 06:29:42,REAL,2889634368,488,2889634856,2909110579
2025-06-19 06:29:44,REAL,2889634856,530,2889635386,2909111109
2025-06-19 06:29:46,REAL,2889635386,481,2889635867,2909111590
2025-06-19 06:29:48,REAL,2889635867,480,2889636347,2909112070
2025-06-19 06:29:50,REAL,2889636347,490,2889636837,2909112560
2025-06-19 06:29:52,REAL,2889636837,482,2889637319,2909113042
2025-06-19 06:29:54,REAL,2889637319,484,2889637803,2909113526
2025-06-19 06:29:56,REAL,2889637803,483,2889638286,2909114009
2025-06-19 06:29:58,FAKE,2889638286,243,2889638529,2909114548
2025-06-19 06:30:00,REAL,2889638529,491,2889639020,2909115039
2025-06-19 06:30:02,FAKE,2889639020,241,2889639261,2909115525
2025-06-19 06:30:04,REAL,2889639261,492,2889639753,2909116017
2025-06-19 06:30:06,FAKE,2889639753,243,2889639996,2909116500
2025-06-19 06:30:08,FAKE,2889639996,238,2889640234,2909117044
2025-06-19 06:30:10,FAKE,2889640234,243,2889640477,2909117528
2025-06-19 06:30:12,REAL,2889640477,481,2889640958,2909118009
2025-06-19 06:30:14,REAL,2889640958,485,2889641443,2909118494
2025-06-19 06:30:16,REAL,2889641443,489,2889641932,2909118983
2025-06-19 06:30:18,FAKE,2889641932,238,2889642170,2909119467
2025-06-19 06:30:20,FAKE,2889642170,243,2889642413,2909119952
2025-06-19 06:30:22,REAL,2889642413,9467,2889651880,2909129419
2025-06-19 06:30:24,FAKE,2889651880,244,2889652124,2909140265
2025-06-19 06:30:26,FAKE,2889652124,241,2889652365,2909150588
2025-06-19 06:30:28,REAL,2889652365,10259,2889662624,2909160847
2025-06-19 06:30:30,REAL,2889662624,10302,2889672926,2909171149
2025-06-19 06:30:32,REAL,2889672926,10262,2889683188,2909181411
2025-06-19 06:30:34,FAKE,2889683188,241,2889683429,2909191732
2025-06-19 06:30:36,REAL,2889683429,8863,2889692292,2909200595
2025-06-19 06:30:38,REAL,2889692292,484,2889692776,2909201079
2025-06-19 06:30:40,FAKE,2889692776,241,2889693017,2909201556
2025-06-19 06:30:42,REAL,2889693017,2398,2889695415,2909203954
2025-06-19 06:30:44,REAL,2889695415,11172,2889706587,2909215126
2025-06-19 06:30:46,REAL,2889706587,10248,2889716835,2909225374
2025-06-19 06:30:48,REAL,2889716835,10253,2889727088,2909235627
2025-06-19 06:30:50,REAL,2889727088,10250,2889737338,2909245877
2025-06-19 06:30:52,REAL,2889737338,10251,2889747589,2909256128
2025-06-19 06:30:54,REAL,2889747589,10251,2889757840,2909266379
2025-06-19 06:30:56,FAKE,2889757840,238,2889758078,2909276636
2025-06-19 06:30:58,REAL,2889758078,3717,2889761795,2909280353
2025-06-19 06:31:00,REAL,2889761795,481,2889762276,2909280834
2025-06-19 06:31:02,FAKE,2889762276,238,2889762514,2909281317
2025-06-19 06:31:04,REAL,2889762514,601,2889763115,2909281918
2025-06-19 06:31:06,REAL,2889763115,487,2889763602,2909282405
2025-06-19 06:31:08,FAKE,2889763602,241,2889763843,2909282886
2025-06-19 06:31:10,REAL,2889763843,487,2889764330,2909283373
2025-06-19 06:31:12,REAL,2889764330,484,2889764814,2909283857
2025-06-19 06:31:14,REAL,2889764814,491,2889765305,2909284348
2025-06-19 06:31:16,FAKE,2889765305,241,2889765546,2909284825
2025-06-19 06:31:18,REAL,2889765546,480,2889766026,2909285305
2025-06-19 06:31:20,REAL,2889766026,9135,2889775161,2909294440
2025-06-19 06:31:22,FAKE,2889775161,241,2889775402,2909305016
2025-06-19 06:31:24,REAL,2889775402,10309,2889785711,2909315325
2025-06-19 06:31:26,REAL,2889785711,10261,2889795972,2909325586
2025-06-19 06:31:28,REAL,2889795972,10261,2889806233,2909335847
2025-06-19 06:31:30,FAKE,2889806233,243,2889806476,2909346102
2025-06-19 06:31:32,FAKE,2889806476,244,2889806720,2909356415
2025-06-19 06:31:34,FAKE,2889806720,243,2889806963,2909364418
2025-06-19 06:31:36,REAL,2889806963,483,2889807446,2909364901
2025-06-19 06:31:38,REAL,2889807446,542,2889807988,2909365443
2025-06-19 06:31:40,REAL,2889807988,486,2889808474,2909365929
2025-06-19 06:31:42,FAKE,2889808474,241,2889808715,2909366469
2025-06-19 06:31:44,FAKE,2889808715,243,2889808958,2909366959
2025-06-19 06:31:46,REAL,2889808958,489,2889809447,2909367448
2025-06-19 06:31:48,FAKE,2889809447,238,2889809685,2909367940
2025-06-19 06:31:50,REAL,2889809685,484,2889810169,2909368424
2025-06-19 06:31:52,FAKE,2889810169,244,2889810413,2909377958
2025-06-19 06:31:54,FAKE,2889810413,241,2889810654,2909388408
2025-06-19 06:31:56,REAL,2889810654,10313,2889820967,2909398721
2025-06-19 06:31:58,REAL,2889820967,10258,2889831225,2909408979
2025-06-19 06:32:00,REAL,2889831225,10255,2889841480,2909419234
2025-06-19 06:32:02,REAL,2889841480,10318,2889851798,2909429552
2025-06-19 06:32:04,REAL,2889851798,10247,2889862045,2909439799
2025-06-19 06:32:06,REAL,2889862045,7475,2889869520,2909447274
2025-06-19 06:32:08,REAL,2889869520,488,2889870008,2909447762
2025-06-19 06:32:10,REAL,2889870008,542,2889870550,2909448304
2025-06-19 06:32:12,REAL,2889870550,492,2889871042,2909448796
2025-06-19 06:32:14,REAL,2889871042,533,2889871575,2909449329
2025-06-19 06:32:16,REAL,2889871575,491,2889872066,2909449820
2025-06-19 06:32:18,FAKE,2889872066,241,2889872307,2909450300
2025-06-19 06:32:20,REAL,2889872307,488,2889872795,2909450788
2025-06-19 06:32:22,REAL,2889872795,485,2889873280,2909451273
2025-06-19 06:32:24,FAKE,2889873280,244,2889873524,2909451764
2025-06-19 06:32:26,REAL,2889873524,483,2889874007,2909452247
2025-06-19 06:32:28,REAL,2889874007,481,2889874488,2909452728
2025-06-19 06:32:30,REAL,2889874488,477,2889874965,2909453205
2025-06-19 06:32:32,FAKE,2889874965,244,2889875209,2909453688
2025-06-19 06:32:34,REAL,2889875209,483,2889875692,2909454171
2025-06-19 06:32:36,REAL,2889875692,479,2889876171,2909454650
2025-06-19 06:32:38,REAL,2889876171,535,2889876706,2909455185
2025-06-19 06:32:40,REAL,2889876706,541,2889877247,2909455726
2025-06-19 06:32:42,REAL,2889877247,486,2889877733,2909456212
2025-06-19 06:32:44,FAKE,2889877733,238,2889877971,2909456702
2025-06-19 06:32:46,REAL,2889877971,481,2889878452,2909457183
2025-06-19 06:32:48,REAL,2889878452,483,2889878935,2909457666
2025-06-19 06:32:50,REAL,2889878935,488,2889879423,2909458154
2025-06-19 06:32:52,REAL,2889879423,481,2889879904,2909458635
2025-06-19 06:32:54,REAL,2889879904,483,2889880387,2909459118
2025-06-19 06:32:56,REAL,2889880387,10920,2889891307,2909470038
2025-06-19 06:32:58,REAL,2889891307,10322,2889901629,2909480360
2025-06-19 06:33:00,REAL,2889901629,10316,2889911945,2909490676
2025-06-19 06:33:02,FAKE,2889911945,244,2889912189,2909500926
2025-06-19 06:33:04,REAL,2889912189,10310,2889922499,2909511236
2025-06-19 06:33:06,REAL,2889922499,10249,2889932748,2909521485
2025-06-19 06:33:08,REAL,2889932748,10315,2889943063,2909531800
2025-06-19 06:33:10,REAL,2889943063,6222,2889949285,2909538022
2025-06-19 06:33:12,REAL,2889949285,475,2889949760,2909538497
2025-06-19 06:33:14,REAL,2889949760,547,2889950307,2909539044
2025-06-19 06:33:16,FAKE,2889950307,238,2889950545,2909539532
2025-06-19 06:33:18,REAL,2889950545,541,2889951086,2909540073
2025-06-19 06:33:20,FAKE,2889951086,238,2889951324,2909540563
2025-06-19 06:33:22,REAL,2889951324,479,2889951803,2909541042
2025-06-19 06:33:24,REAL,2889951803,484,2889952287,2909541526
2025-06-19 06:33:26,FAKE,2889952287,238,2889952525,2909542013
2025-06-19 06:33:28,REAL,2889952525,481,2889953006,2909542494
2025-06-19 06:33:30,REAL,2889953006,487,2889953493,2909542981
2025-06-19 06:33:32,REAL,2889953493,480,2889953973,2909543461
2025-06-19 06:33:34,FAKE,2889953973,243,2889954216,2909543945
2025-06-19 06:33:36,REAL,2889954216,488,2889954704,2909544433
2025-06-19 06:33:38,FAKE,2889954704,238,2889954942,2909544915
2025-06-19 06:33:40,REAL,2889954942,487,2889955429,2909545402
2025-06-19 06:33:42,REAL,2889955429,595,2889956024,2909545997
2025-06-19 06:33:44,REAL,2889956024,479,2889956503,2909546476
2025-06-19 06:33:46,FAKE,2889956503,244,2889956747,2909546961
2025-06-19 06:33:48,REAL,2889956747,483,2889957230,2909547444
2025-06-19 06:33:50,FAKE,2889957230,238,2889957468,2909547931
2025-06-19 06:33:52,FAKE,2889957468,238,2889957706,2909548170
2025-06-19 06:33:54,REAL,2889957706,484,2889958190,2909548654
2025-06-19 06:33:56,FAKE,2889958190,241,2889958431,2909549132
2025-06-19 06:33:58,REAL,2889958431,481,2889958912,2909549613
2025-06-19 06:34:00,REAL,2889958912,479,2889959391,2909550092
2025-06-19 06:34:02,FAKE,2889959391,238,2889959629,2909550584
2025-06-19 06:34:04,REAL,2889959629,480,2889960109,2909551064
2025-06-19 06:34:06,REAL,2889960109,483,2889960592,2909551547
2025-06-19 06:34:08,REAL,2889960592,479,2889961071,2909552026
2025-06-19 06:34:10,REAL,2889961071,544,2889961615,2909552570
2025-06-19 06:34:12,REAL,2889961615,487,2889962102,2909553057
2025-06-19 06:34:14,REAL,2889962102,486,2889962588,2909553543
2025-06-19 06:34:16,REAL,2889962588,484,2889963072,2909554027
2025-06-19 06:34:18,REAL,2889963072,486,2889963558,2909554513
2025-06-19 06:34:20,FAKE,2889963558,243,2889963801,2909554999
2025-06-19 06:34:22,FAKE,2889963801,241,2889964042,2909555488
2025-06-19 06:34:24,FAKE,2889964042,238,2889964280,2909555976
2025-06-19 06:34:26,REAL,2889964280,486,2889964766,2909556462
2025-06-19 06:34:28,REAL,2889964766,485,2889965251,2909556947
2025-06-19 06:34:30,REAL,2889965251,541,2889965792,2909557488
2025-06-19 06:34:32,REAL,2889965792,481,2889966273,2909557969
2025-06-19 06:34:34,REAL,2889966273,483,2889966756,2909558452
2025-06-19 06:34:36,FAKE,2889966756,244,2889967000,2909558926
2025-06-19 06:34:38,REAL,2889967000,543,2889967543,2909559469
2025-06-19 06:34:40,REAL,2889967543,476,2889968019,2909559945
2025-06-19 06:34:42,FAKE,2889968019,243,2889968262,2909560432
2025-06-19 06:34:44,FAKE,2889968262,243,2889968505,2909560921
2025-06-19 06:34:46,FAKE,2889968505,243,2889968748,2909563127
2025-06-19 06:34:48,FAKE,2889968748,243,2889968991,2909575151
2025-06-19 06:34:50,REAL,2889968991,10246,2889979237,2909585397
2025-06-19 06:34:52,FAKE,2889979237,238,2889979475,2909595722
2025-06-19 06:34:54,REAL,2889979475,10246,2889989721,2909605968
2025-06-19 06:34:56,REAL,2889989721,10244,2889999965,2909616212
2025-06-19 06:34:58,REAL,2889999965,10257,2890010222,2909626469
2025-06-19 06:35:00,REAL,2890010222,10320,2890020542,2909636789
2025-06-19 06:35:02,REAL,2890020542,3991,2890024533,2909640780
2025-06-19 06:35:04,REAL,2890024533,488,2890025021,2909641268
2025-06-19 06:35:06,REAL,2890025021,534,2890025555,2909641802
2025-06-19 06:35:08,REAL,2890025555,482,2890026037,2909642284
2025-06-19 06:35:10,REAL,2890026037,481,2890026518,2909642765
2025-06-19 06:35:12,REAL,2890026518,489,2890027007,2909643254
2025-06-19 06:35:14,FAKE,2890027007,243,2890027250,2909643734
2025-06-19 06:35:16,REAL,2890027250,481,2890027731,2909644215
2025-06-19 06:35:18,FAKE,2890027731,243,2890027974,2909646892
2025-06-19 06:35:20,REAL,2890027974,11652,2890039626,2909658544
2025-06-19 06:35:22,REAL,2890039626,10248,2890049874,2909668792
2025-06-19 06:35:24,FAKE,2890049874,241,2890050115,2909679104
2025-06-19 06:35:26,REAL,2890050115,10247,2890060362,2909689351
2025-06-19 06:35:28,REAL,2890060362,10250,2890070612,2909699601
2025-06-19 06:35:30,FAKE,2890070612,241,2890070853,2909709855
2025-06-19 06:35:32,REAL,2890070853,10302,2890081155,2909720157
2025-06-19 06:35:34,FAKE,2890081155,238,2890081393,2909723542
2025-06-19 06:35:36,REAL,2890081393,474,2890081867,2909724016
2025-06-19 06:35:38,REAL,2890081867,478,2890082345,2909724494
2025-06-19 06:35:40,FAKE,2890082345,238,2890082583,2909724978
2025-06-19 06:35:42,REAL,2890082583,480,2890083063,2909725458
2025-06-19 06:35:44,REAL,2890083063,479,2890083542,2909725937
2025-06-19 06:35:46,REAL,2890083542,490,2890084032,2909726427
2025-06-19 06:35:48,REAL,2890084032,490,2890084522,2909726917
2025-06-19 06:35:50,FAKE,2890084522,244,2890084766,2909727403
2025-06-19 06:35:52,REAL,2890084766,481,2890085247,2909727884
2025-06-19 06:35:54,FAKE,2890085247,243,2890085490,2909728368
2025-06-19 06:35:56,REAL,2890085490,481,2890085971,2909728849
2025-06-19 06:35:58,REAL,2890085971,489,2890086460,2909729338
2025-06-19 06:36:00,REAL,2890086460,476,2890086936,2909729814
2025-06-19 06:36:02,FAKE,2890086936,244,2890087180,2909730347
2025-06-19 06:36:04,REAL,2890087180,484,2890087664,2909730831
2025-06-19 06:36:06,REAL,2890087664,537,2890088201,2909731368
2025-06-19 06:36:08,REAL,2890088201,483,2890088684,2909731851
2025-06-19 06:36:10,FAKE,2890088684,238,2890088922,2909732331
2025-06-19 06:36:12,FAKE,2890088922,244,2890089166,2909743716
2025-06-19 06:36:14,REAL,2890089166,10458,2890099624,2909754174
2025-06-19 06:36:16,FAKE,2890099624,241,2890099865,2909764491
2025-06-19 06:36:18,REAL,2890099865,10258,2890110123,2909774749
2025-06-19 06:36:20,REAL,2890110123,10316,2890120439,2909785065
2025-06-19 06:36:22,REAL,2890120439,10243,2890130682,2909795308
2025-06-19 06:36:24,REAL,2890130682,10251,2890140933,2909805559
2025-06-19 06:36:26,REAL,2890140933,7355,2890148288,2909812914
2025-06-19 06:36:28,REAL,2890148288,477,2890148765,2909813391
2025-06-19 06:36:30,REAL,2890148765,545,2890149310,2909813936
2025-06-19 06:36:32,REAL,2890149310,5240,2890154550,2909819176
2025-06-19 06:36:34,REAL,2890154550,11720,2890166270,2909830896
2025-06-19 06:36:36,REAL,2890166270,10257,2890176527,2909841153
2025-06-19 06:36:38,FAKE,2890176527,238,2890176765,2909851402
2025-06-19 06:36:40,FAKE,2890176765,238,2890177003,2909861656
2025-06-19 06:36:42,REAL,2890177003,10245,2890187248,2909871901
2025-06-19 06:36:44,FAKE,2890187248,241,2890187489,2909882213
2025-06-19 06:36:46,FAKE,2890187489,241,2890187730,2909892463
2025-06-19 06:36:48,FAKE,2890187730,241,2890187971,2909894534
2025-06-19 06:36:50,REAL,2890187971,490,2890188461,2909895024
2025-06-19 06:36:52,REAL,2890188461,481,2890188942,2909895505
2025-06-19 06:36:54,REAL,2890188942,488,2890189430,2909895993
2025-06-19 06:36:56,REAL,2890189430,546,2890189976,2909896539
2025-06-19 06:36:58,FAKE,2890189976,238,2890190214,2909897022
2025-06-19 06:37:00,REAL,2890190214,483,2890190697,2909897505
2025-06-19 06:37:02,REAL,2890190697,475,2890191172,2909897980
2025-06-19 06:37:04,REAL,2890191172,5769,2890196941,2909903749
2025-06-19 06:37:06,FAKE,2890196941,241,2890197182,2909914466
2025-06-19 06:37:08,REAL,2890197182,10244,2890207426,2909924710
2025-06-19 06:37:10,REAL,2890207426,10255,2890217681,2909934965
2025-06-19 06:37:12,FAKE,2890217681,241,2890217922,2909945285
2025-06-19 06:37:14,FAKE,2890217922,244,2890218166,2909955542
2025-06-19 06:37:16,REAL,2890218166,10246,2890228412,2909965788
2025-06-19 06:37:18,FAKE,2890228412,238,2890228650,2909976042
2025-06-19 06:37:20,REAL,2890228650,1467,2890230117,2909977509
2025-06-19 06:37:22,REAL,2890230117,482,2890230599,2909977991
2025-06-19 06:37:24,REAL,2890230599,489,2890231088,2909978480
2025-06-19 06:37:26,FAKE,2890231088,243,2890231331,2909979025
2025-06-19 06:37:28,FAKE,2890231331,238,2890231569,2909979502
2025-06-19 06:37:30,FAKE,2890231569,244,2890231813,2909979982
2025-06-19 06:37:32,REAL,2890231813,480,2890232293,2909980462
2025-06-19 06:37:34,REAL,2890232293,486,2890232779,2909980948
2025-06-19 06:37:36,FAKE,2890232779,241,2890233020,2909986918
2025-06-19 06:37:38,REAL,2890233020,11375,2890244395,2909998293
2025-06-19 06:37:40,FAKE,2890244395,241,2890244636,2910008544
2025-06-19 06:37:42,FAKE,2890244636,238,2890244874,2910018871
2025-06-19 06:37:44,FAKE,2890244874,244,2890245118,2910029131
2025-06-19 06:37:46,FAKE,2890245118,238,2890245356,2910039388
2025-06-19 06:37:48,REAL,2890245356,10253,2890255609,2910049641
2025-06-19 06:37:50,REAL,2890255609,10262,2890265871,2910059903
2025-06-19 06:37:52,REAL,2890265871,811,2890266682,2910060714
2025-06-19 06:37:54,REAL,2890266682,543,2890267225,2910061257
2025-06-19 06:37:56,REAL,2890267225,486,2890267711,2910061743
2025-06-19 06:37:58,REAL,2890267711,478,2890268189,2910062221
2025-06-19 06:38:00,FAKE,2890268189,244,2890268433,2910062713
2025-06-19 06:38:02,REAL,2890268433,490,2890268923,2910063203
2025-06-19 06:38:04,FAKE,2890268923,243,2890269166,2910063688
2025-06-19 06:38:06,REAL,2890269166,479,2890269645,2910064167
2025-06-19 06:38:08,REAL,2890269645,6696,2890276341,2910070863
2025-06-19 06:38:10,REAL,2890276341,10778,2890287119,2910081641
2025-06-19 06:38:12,REAL,2890287119,10250,2890297369,2910091891
2025-06-19 06:38:14,REAL,2890297369,10249,2890307618,2910102140
2025-06-19 06:38:16,REAL,2890307618,11175,2890318793,2910113315
2025-06-19 06:38:18,REAL,2890318793,9328,2890328121,2910122643
2025-06-19 06:38:20,FAKE,2890328121,244,2890328365,2910132905
2025-06-19 06:38:22,REAL,2890328365,9931,2890338296,2910142836
2025-06-19 06:38:24,REAL,2890338296,492,2890338788,2910143328
2025-06-19 06:38:26,REAL,2890338788,538,2890339326,2910143866
2025-06-19 06:38:28,REAL,2890339326,477,2890339803,2910144343
2025-06-19 06:38:30,REAL,2890339803,487,2890340290,2910144830
2025-06-19 06:38:32,FAKE,2890340290,241,2890340531,2910145307
2025-06-19 06:38:34,REAL,2890340531,477,2890341008,2910145784
2025-06-19 06:38:36,REAL,2890341008,485,2890341493,2910146269
2025-06-19 06:38:38,REAL,2890341493,485,2890341978,2910146754
2025-06-19 06:38:40,REAL,2890341978,483,2890342461,2910147237
2025-06-19 06:38:42,REAL,2890342461,479,2890342940,2910147716
2025-06-19 06:38:44,FAKE,2890342940,238,2890343178,2910148201
2025-06-19 06:38:46,FAKE,2890343178,244,2890343422,2910148686
2025-06-19 06:38:48,FAKE,2890343422,238,2890343660,2910149166
2025-06-19 06:38:50,FAKE,2890343660,244,2890343904,2910149648
2025-06-19 06:38:52,FAKE,2890343904,241,2890344145,2910150135
2025-06-19 06:38:54,REAL,2890344145,487,2890344632,2910150622
2025-06-19 06:38:56,FAKE,2890344632,241,2890344873,2910151171
2025-06-19 06:38:58,FAKE,2890344873,244,2890345117,2910151649
2025-06-19 06:39:00,REAL,2890345117,483,2890345600,2910152132
2025-06-19 06:39:02,REAL,2890345600,540,2890346140,2910152672
2025-06-19 06:39:04,REAL,2890346140,480,2890346620,2910153152
2025-06-19 06:39:06,REAL,2890346620,481,2890347101,2910153633
2025-06-19 06:39:08,REAL,2890347101,492,2890347593,2910154125
2025-06-19 06:39:10,REAL,2890347593,479,2890348072,2910154604
2025-06-19 06:39:12,REAL,2890348072,485,2890348557,2910155089
2025-06-19 06:39:14,REAL,2890348557,485,2890349042,2910155574
2025-06-19 06:39:16,REAL,2890349042,491,2890349533,2910156065
2025-06-19 06:39:18,REAL,2890349533,480,2890350013,2910156545
2025-06-19 06:39:20,REAL,2890350013,486,2890350499,2910157031
2025-06-19 06:39:22,FAKE,2890350499,241,2890350740,2910157511
2025-06-19 06:39:24,FAKE,2890350740,238,2890350978,2910157996
2025-06-19 06:39:26,REAL,2890350978,485,2890351463,2910158481
2025-06-19 06:39:28,FAKE,2890351463,238,2890351701,2910158962
2025-06-19 06:39:30,REAL,2890351701,483,2890352184,2910159445
2025-06-19 06:39:32,REAL,2890352184,491,2890352675,2910159936
2025-06-19 06:39:34,REAL,2890352675,492,2890353167,2910160428
2025-06-19 06:39:36,FAKE,2890353167,244,2890353411,2910160964
2025-06-19 06:39:38,FAKE,2890353411,243,2890353654,2910161445
2025-06-19 06:39:40,REAL,2890353654,482,2890354136,2910161927
2025-06-19 06:39:42,REAL,2890354136,476,2890354612,2910162403
2025-06-19 06:39:44,FAKE,2890354612,243,2890354855,2910162887
2025-06-19 06:39:46,FAKE,2890354855,241,2890355096,2910163428
2025-06-19 06:39:48,FAKE,2890355096,243,2890355339,2910166354
2025-06-19 06:39:50,REAL,2890355339,14620,2890369959,2910180974
2025-06-19 06:39:52,REAL,2890369959,10246,2890380205,2910191220
2025-06-19 06:39:54,REAL,2890380205,10255,2890390460,2910201475
2025-06-19 06:39:56,REAL,2890390460,10255,2890400715,2910211730
2025-06-19 06:39:58,REAL,2890400715,10245,2890410960,2910221975
2025-06-19 06:40:00,FAKE,2890410960,238,2890411198,2910232219
2025-06-19 06:40:02,REAL,2890411198,10247,2890421445,2910242466
2025-06-19 06:40:04,REAL,2890421445,3118,2890424563,2910245584
2025-06-19 06:40:06,REAL,2890424563,486,2890425049,2910246070
2025-06-19 06:40:08,FAKE,2890425049,244,2890425293,2910246556
2025-06-19 06:40:10,FAKE,2890425293,238,2890425531,2910247097
2025-06-19 06:40:12,REAL,2890425531,486,2890426017,2910247583
2025-06-19 06:40:14,REAL,2890426017,482,2890426499,2910248065
2025-06-19 06:40:16,REAL,2890426499,487,2890426986,2910248552
2025-06-19 06:40:18,FAKE,2890426986,244,2890427230,2910249098
2025-06-19 06:40:20,FAKE,2890427230,244,2890427474,2910249581
2025-06-19 06:40:22,FAKE,2890427474,238,2890427712,2910250069
2025-06-19 06:40:24,FAKE,2890427712,241,2890427953,2910250548
2025-06-19 06:40:26,FAKE,2890427953,244,2890428197,2910251030
2025-06-19 06:40:28,REAL,2890428197,486,2890428683,2910251516
2025-06-19 06:40:30,REAL,2890428683,491,2890429174,2910252007
2025-06-19 06:40:32,REAL,2890429174,481,2890429655,2910252488
2025-06-19 06:40:34,FAKE,2890429655,238,2890429893,2910252973
2025-06-19 06:40:36,REAL,2890429893,484,2890430377,2910253457
2025-06-19 06:40:38,FAKE,2890430377,243,2890430620,2910253943
2025-06-19 06:40:40,FAKE,2890430620,238,2890430858,2910254429
2025-06-19 06:40:42,FAKE,2890430858,241,2890431099,2910254913
2025-06-19 06:40:44,REAL,2890431099,485,2890431584,2910255398
2025-06-19 06:40:46,FAKE,2890431584,241,2890431825,2910255992
2025-06-19 06:40:48,REAL,2890431825,480,2890432305,2910256472
2025-06-19 06:40:50,REAL,2890432305,489,2890432794,2910256961
2025-06-19 06:40:52,FAKE,2890432794,244,2890433038,2910262010
2025-06-19 06:40:54,REAL,2890433038,11299,2890444337,2910273309
2025-06-19 06:40:56,REAL,2890444337,10323,2890454660,2910283632
2025-06-19 06:40:58,REAL,2890454660,10249,2890464909,2910293881
2025-06-19 06:41:00,REAL,2890464909,10251,2890475160,2910304132
2025-06-19 06:41:02,REAL,2890475160,10313,2890485473,2910314445
2025-06-19 06:41:04,FAKE,2890485473,243,2890485716,2910324698
2025-06-19 06:41:06,FAKE,2890485716,238,2890485954,2910335009
2025-06-19 06:41:08,REAL,2890485954,1869,2890487823,2910336878
2025-06-19 06:41:10,REAL,2890487823,487,2890488310,2910337365
2025-06-19 06:41:12,REAL,2890488310,483,2890488793,2910337848
2025-06-19 06:41:14,REAL,2890488793,484,2890489277,2910338332
2025-06-19 06:41:16,REAL,2890489277,476,2890489753,2910338808
2025-06-19 06:41:18,FAKE,2890489753,238,2890489991,2910339293
2025-06-19 06:41:20,REAL,2890489991,537,2890490528,2910339830
2025-06-19 06:41:22,REAL,2890490528,545,2890491073,2910340375
2025-06-19 06:41:24,REAL,2890491073,487,2890491560,2910340862
2025-06-19 06:41:26,REAL,2890491560,483,2890492043,2910341345
2025-06-19 06:41:28,REAL,2890492043,485,2890492528,2910341830
2025-06-19 06:41:30,REAL,2890492528,486,2890493014,2910342316
2025-06-19 06:41:32,REAL,2890493014,491,2890493505,2910342807
2025-06-19 06:41:34,REAL,2890493505,483,2890493988,2910343290
2025-06-19 06:41:36,FAKE,2890493988,244,2890494232,2910343768
2025-06-19 06:41:38,FAKE,2890494232,241,2890494473,2910344248
2025-06-19 06:41:40,FAKE,2890494473,238,2890494711,2910344731
2025-06-19 06:41:42,FAKE,2890494711,238,2890494949,2910345209
2025-06-19 06:41:44,REAL,2890494949,493,2890495442,2910345702
2025-06-19 06:41:46,REAL,2890495442,487,2890495929,2910346189
2025-06-19 06:41:48,REAL,2890495929,488,2890496417,2910346677
2025-06-19 06:41:50,REAL,2890496417,536,2890496953,2910347213
2025-06-19 06:41:52,REAL,2890496953,481,2890497434,2910347694
2025-06-19 06:41:54,REAL,2890497434,481,2890497915,2910348175
2025-06-19 06:41:56,REAL,2890497915,5963,2890503878,2910354138
2025-06-19 06:41:58,REAL,2890503878,11113,2890514991,2910365251
2025-06-19 06:42:00,REAL,2890514991,10319,2890525310,2910375570
2025-06-19 06:42:02,REAL,2890525310,10255,2890535565,2910385825
2025-06-19 06:42:04,REAL,2890535565,10251,2890545816,2910396076
2025-06-19 06:42:06,REAL,2890545816,10318,2890556134,2910406394
2025-06-19 06:42:08,REAL,2890556134,10249,2890566383,2910416643
2025-06-19 06:42:10,REAL,2890566383,10255,2890576638,2910426898
2025-06-19 06:42:12,REAL,2890576638,613,2890577251,2910427511
2025-06-19 06:42:14,REAL,2890577251,486,2890577737,2910427997
2025-06-19 06:42:16,REAL,2890577737,489,2890578226,2910428486
2025-06-19 06:42:18,FAKE,2890578226,241,2890578467,2910428971
2025-06-19 06:42:20,FAKE,2890578467,238,2890578705,2910429449
2025-06-19 06:42:22,REAL,2890578705,485,2890579190,2910429934
2025-06-19 06:42:24,FAKE,2890579190,244,2890579434,2910430468
2025-06-19 06:42:26,REAL,2890579434,490,2890579924,2910430958
2025-06-19 06:42:28,REAL,2890579924,6430,2890586354,2910437388
2025-06-19 06:42:30,REAL,2890586354,10903,2890597257,2910448291
2025-06-19 06:42:32,REAL,2890597257,10326,2890607583,2910458617
2025-06-19 06:42:34,REAL,2890607583,10249,2890617832,2910468866
2025-06-19 06:42:36,REAL,2890617832,10253,2890628085,2910479119
2025-06-19 06:42:38,FAKE,2890628085,241,2890628326,2910489445
2025-06-19 06:42:40,REAL,2890628326,10255,2890638581,2910499700
2025-06-19 06:42:42,REAL,2890638581,9787,2890648368,2910509487
2025-06-19 06:42:44,FAKE,2890648368,244,2890648612,2910509973
2025-06-19 06:42:46,FAKE,2890648612,244,2890648856,2910510464
2025-06-19 06:42:48,REAL,2890648856,479,2890649335,2910510943
2025-06-19 06:42:50,REAL,2890649335,482,2890649817,2910511425
2025-06-19 06:42:52,FAKE,2890649817,238,2890650055,2910511904
2025-06-19 06:42:54,REAL,2890650055,475,2890650530,2910512379
2025-06-19 06:42:56,FAKE,2890650530,238,2890650768,2910512913
2025-06-19 06:42:58,FAKE,2890650768,241,2890651009,2910513393
2025-06-19 06:43:00,FAKE,2890651009,238,2890651247,2910520744
2025-06-19 06:43:02,FAKE,2890651247,244,2890651491,2910531806
2025-06-19 06:43:04,REAL,2890651491,10307,2890661798,2910542113
2025-06-19 06:43:06,REAL,2890661798,10314,2890672112,2910552427
2025-06-19 06:43:08,REAL,2890672112,10257,2890682369,2910562684
2025-06-19 06:43:10,FAKE,2890682369,244,2890682613,2910572942
2025-06-19 06:43:12,FAKE,2890682613,241,2890682854,2910583189
2025-06-19 06:43:14,REAL,2890682854,9198,2890692052,2910592387
2025-06-19 06:43:16,REAL,2890692052,480,2890692532,2910592867
2025-06-19 06:43:18,REAL,2890692532,489,2890693021,2910593356
2025-06-19 06:43:20,REAL,2890693021,482,2890693503,2910593838
2025-06-19 06:43:22,REAL,2890693503,483,2890693986,2910594321
2025-06-19 06:43:24,REAL,2890693986,480,2890694466,2910594801
2025-06-19 06:43:26,REAL,2890694466,483,2890694949,2910595284
2025-06-19 06:43:28,REAL,2890694949,544,2890695493,2910595828
2025-06-19 06:43:30,REAL,2890695493,483,2890695976,2910596311
2025-06-19 06:43:32,FAKE,2890695976,241,2890696217,2910596789
2025-06-19 06:43:34,REAL,2890696217,481,2890696698,2910597270
2025-06-19 06:43:36,FAKE,2890696698,243,2890696941,2910597746
2025-06-19 06:43:38,REAL,2890696941,489,2890697430,2910598235
2025-06-19 06:43:40,REAL,2890697430,534,2890697964,2910598769
2025-06-19 06:43:42,REAL,2890697964,486,2890698450,2910599255
2025-06-19 06:43:44,REAL,2890698450,493,2890698943,2910599748
2025-06-19 06:43:46,REAL,2890698943,480,2890699423,2910600228
2025-06-19 06:43:48,FAKE,2890699423,243,2890699666,2910600705
2025-06-19 06:43:50,REAL,2890699666,481,2890700147,2910601186
2025-06-19 06:43:52,REAL,2890700147,487,2890700634,2910601673
2025-06-19 06:43:54,FAKE,2890700634,241,2890700875,2910602157
2025-06-19 06:43:56,FAKE,2890700875,243,2890701118,2910602645
2025-06-19 06:43:58,FAKE,2890701118,238,2890701356,2910603184
2025-06-19 06:44:00,FAKE,2890701356,244,2890701600,2910603669
2025-06-19 06:44:02,REAL,2890701600,491,2890702091,2910604160
2025-06-19 06:44:04,REAL,2890702091,474,2890702565,2910604634
2025-06-19 06:44:06,FAKE,2890702565,241,2890702806,2910605124
2025-06-19 06:44:08,REAL,2890702806,541,2890703347,2910605665
2025-06-19 06:44:10,FAKE,2890703347,244,2890703591,2910606152
2025-06-19 06:44:12,REAL,2890703591,489,2890704080,2910606641
2025-06-19 06:44:14,REAL,2890704080,8944,2890713024,2910615585
2025-06-19 06:44:16,FAKE,2890713024,238,2890713262,2910626232
2025-06-19 06:44:18,REAL,2890713262,10250,2890723512,2910636482
2025-06-19 06:44:20,FAKE,2890723512,241,2890723753,2910646735
2025-06-19 06:44:22,REAL,2890723753,10255,2890734008,2910656990
2025-06-19 06:44:24,FAKE,2890734008,241,2890734249,2910667308
2025-06-19 06:44:26,REAL,2890734249,10245,2890744494,2910677553
2025-06-19 06:44:28,REAL,2890744494,7946,2890752440,2910685499
2025-06-19 06:44:30,REAL,2890752440,480,2890752920,2910685979
2025-06-19 06:44:32,REAL,2890752920,489,2890753409,2910686468
2025-06-19 06:44:34,REAL,2890753409,483,2890753892,2910686951
2025-06-19 06:44:36,FAKE,2890753892,243,2890754135,2910687439
2025-06-19 06:44:38,FAKE,2890754135,244,2890754379,2910687976
2025-06-19 06:44:40,REAL,2890754379,482,2890754861,2910688458
2025-06-19 06:44:42,REAL,2890754861,483,2890755344,2910688941
2025-06-19 06:44:44,REAL,2890755344,539,2890755883,2910689480
2025-06-19 06:44:46,REAL,2890755883,489,2890756372,2910689969
2025-06-19 06:44:48,REAL,2890756372,480,2890756852,2910690449
2025-06-19 06:44:50,FAKE,2890756852,244,2890757096,2910690931
2025-06-19 06:44:52,REAL,2890757096,488,2890757584,2910691419
2025-06-19 06:44:54,FAKE,2890757584,244,2890757828,2910691903
2025-06-19 06:44:56,FAKE,2890757828,238,2890758066,2910692391
2025-06-19 06:44:58,REAL,2890758066,487,2890758553,2910692878
2025-06-19 06:45:00,REAL,2890758553,480,2890759033,2910693358
2025-06-19 06:45:02,REAL,2890759033,486,2890759519,2910693844
2025-06-19 06:45:04,REAL,2890759519,483,2890760002,2910694327
2025-06-19 06:45:06,FAKE,2890760002,244,2890760246,2910694818
2025-06-19 06:45:08,REAL,2890760246,538,2890760784,2910695356
2025-06-19 06:45:10,REAL,2890760784,486,2890761270,2910695842
2025-06-19 06:45:12,FAKE,2890761270,244,2890761514,2910696328
2025-06-19 06:45:14,FAKE,2890761514,238,2890761752,2910696813
2025-06-19 06:45:16,REAL,2890761752,549,2890762301,2910697362
2025-06-19 06:45:18,REAL,2890762301,485,2890762786,2910697847
2025-06-19 06:45:20,REAL,2890762786,485,2890763271,2910698332
2025-06-19 06:45:22,FAKE,2890763271,241,2890763512,2910698808
2025-06-19 06:45:24,REAL,2890763512,491,2890764003,2910699299
2025-06-19 06:45:26,FAKE,2890764003,243,2890764246,2910699790
2025-06-19 06:45:28,FAKE,2890764246,244,2890764490,2910712232
2025-06-19 06:45:30,FAKE,2890764490,243,2890764733,2910723012
2025-06-19 06:45:32,FAKE,2890764733,238,2890764971,2910733263
2025-06-19 06:45:34,FAKE,2890764971,243,2890765214,2910743580
2025-06-19 06:45:36,REAL,2890765214,10316,2890775530,2910753896
2025-06-19 06:45:38,FAKE,2890775530,243,2890775773,2910764142
2025-06-19 06:45:40,REAL,2890775773,10319,2890786092,2910774461
2025-06-19 06:45:42,FAKE,2890786092,241,2890786333,2910781274
2025-06-19 06:45:44,REAL,2890786333,484,2890786817,2910781758
2025-06-19 06:45:46,REAL,2890786817,481,2890787298,2910782239
2025-06-19 06:45:48,REAL,2890787298,483,2890787781,2910782722
2025-06-19 06:45:50,REAL,2890787781,484,2890788265,2910783206
2025-06-19 06:45:52,FAKE,2890788265,241,2890788506,2910783686
2025-06-19 06:45:54,FAKE,2890788506,243,2890788749,2910784176
2025-06-19 06:45:56,REAL,2890788749,485,2890789234,2910784661
2025-06-19 06:45:58,FAKE,2890789234,238,2890789472,2910785206
2025-06-19 06:46:00,REAL,2890789472,492,2890789964,2910785698
2025-06-19 06:46:02,FAKE,2890789964,244,2890790208,2910786184
2025-06-19 06:46:04,REAL,2890790208,487,2890790695,2910786671
2025-06-19 06:46:06,FAKE,2890790695,244,2890790939,2910787218
2025-06-19 06:46:08,REAL,2890790939,479,2890791418,2910787697
2025-06-19 06:46:10,REAL,2890791418,486,2890791904,2910788183
2025-06-19 06:46:12,FAKE,2890791904,243,2890792147,2910788670
2025-06-19 06:46:14,REAL,2890792147,483,2890792630,2910789153
2025-06-19 06:46:16,FAKE,2890792630,243,2890792873,2910789635
2025-06-19 06:46:18,REAL,2890792873,489,2890793362,2910790124
2025-06-19 06:46:20,REAL,2890793362,488,2890793850,2910790612
2025-06-19 06:46:22,REAL,2890793850,478,2890794328,2910791090
2025-06-19 06:46:24,REAL,2890794328,475,2890794803,2910791565
2025-06-19 06:46:26,REAL,2890794803,483,2890795286,2910792048
2025-06-19 06:46:28,REAL,2890795286,543,2890795829,2910792591
2025-06-19 06:46:30,FAKE,2890795829,238,2890796067,2910793083
2025-06-19 06:46:32,REAL,2890796067,489,2890796556,2910793572
2025-06-19 06:46:34,REAL,2890796556,481,2890797037,2910794053
2025-06-19 06:46:36,FAKE,2890797037,244,2890797281,2910794592
2025-06-19 06:46:38,REAL,2890797281,481,2890797762,2910795073
2025-06-19 06:46:40,REAL,2890797762,478,2890798240,2910795551
2025-06-19 06:46:42,REAL,2890798240,482,2890798722,2910796033
2025-06-19 06:46:44,REAL,2890798722,477,2890799199,2910796510
2025-06-19 06:46:46,REAL,2890799199,482,2890799681,2910796992
2025-06-19 06:46:48,REAL,2890799681,16262,2890815943,2910813254
2025-06-19 06:46:50,FAKE,2890815943,243,2890816186,2910823565
2025-06-19 06:46:52,FAKE,2890816186,243,2890816429,2910833824
2025-06-19 06:46:54,REAL,2890816429,10251,2890826680,2910844075
2025-06-19 06:46:56,REAL,2890826680,10253,2890836933,2910854328
2025-06-19 06:46:58,REAL,2890836933,10321,2890847254,2910864649
2025-06-19 06:47:00,FAKE,2890847254,244,2890847498,2910874900
2025-06-19 06:47:02,REAL,2890847498,5243,2890852741,2910880143
2025-06-19 06:47:04,FAKE,2890852741,241,2890852982,2910880629
2025-06-19 06:47:06,FAKE,2890852982,238,2890853220,2910881165
2025-06-19 06:47:08,FAKE,2890853220,241,2890853461,2910881645
2025-06-19 06:47:10,FAKE,2890853461,241,2890853702,2910882134
2025-06-19 06:47:12,REAL,2890853702,487,2890854189,2910882621
2025-06-19 06:47:14,REAL,2890854189,479,2890854668,2910883100
2025-06-19 06:47:16,FAKE,2890854668,241,2890854909,2910883579
2025-06-19 06:47:18,FAKE,2890854909,241,2890855150,2910884926
2025-06-19 06:47:20,FAKE,2890855150,244,2890855394,2910897288
2025-06-19 06:47:22,REAL,2890855394,10054,2890865448,2910907342
2025-06-19 06:47:24,REAL,2890865448,10256,2890875704,2910917598
2025-06-19 06:47:26,REAL,2890875704,10247,2890885951,2910927845
2025-06-19 06:47:28,REAL,2890885951,10318,2890896269,2910938163
2025-06-19 06:47:30,REAL,2890896269,10251,2890906520,2910948414
2025-06-19 06:47:32,REAL,2890906520,10246,2890916766,2910958660
2025-06-19 06:47:34,REAL,2890916766,4705,2890921471,2910963365
2025-06-19 06:47:36,REAL,2890921471,484,2890921955,2910963849
2025-06-19 06:47:38,REAL,2890921955,476,2890922431,2910964325
2025-06-19 06:47:40,REAL,2890922431,484,2890922915,2910964809
2025-06-19 06:47:42,REAL,2890922915,481,2890923396,2910965290
2025-06-19 06:47:44,FAKE,2890923396,244,2890923640,2910965780
2025-06-19 06:47:46,FAKE,2890923640,241,2890923881,2910966266
2025-06-19 06:47:48,FAKE,2890923881,241,2890924122,2910966807
2025-06-19 06:47:50,REAL,2890924122,487,2890924609,2910967294
2025-06-19 06:47:52,REAL,2890924609,485,2890925094,2910967779
2025-06-19 06:47:54,REAL,2890925094,486,2890925580,2910968265
2025-06-19 06:47:56,REAL,2890925580,475,2890926055,2910968740
2025-06-19 06:47:58,FAKE,2890926055,244,2890926299,2910969218
2025-06-19 06:48:00,REAL,2890926299,2082,2890928381,2910971300
2025-06-19 06:48:02,REAL,2890928381,12369,2890940750,2910983669
2025-06-19 06:48:04,FAKE,2890940750,238,2890940988,2910993981
2025-06-19 06:48:06,REAL,2890940988,10313,2890951301,2911004294
2025-06-19 06:48:08,FAKE,2890951301,243,2890951544,2911014548
2025-06-19 06:48:10,REAL,2890951544,10326,2890961870,2911024874
2025-06-19 06:48:12,REAL,2890961870,10254,2890972124,2911035128
2025-06-19 06:48:14,FAKE,2890972124,241,2890972365,2911045451
2025-06-19 06:48:16,FAKE,2890972365,238,2890972603,2911049502
2025-06-19 06:48:18,FAKE,2890972603,238,2890972841,2911049980
2025-06-19 06:48:20,REAL,2890972841,482,2890973323,2911050462
2025-06-19 06:48:22,REAL,2890973323,486,2890973809,2911050948
2025-06-19 06:48:24,REAL,2890973809,487,2890974296,2911051435
2025-06-19 06:48:26,FAKE,2890974296,238,2890974534,2911051912
2025-06-19 06:48:28,FAKE,2890974534,241,2890974775,2911052398
2025-06-19 06:48:30,FAKE,2890974775,238,2890975013,2911052941
2025-06-19 06:48:32,REAL,2890975013,2941,2890977954,2911055882
2025-06-19 06:48:34,REAL,2890977954,11445,2890989399,2911067327
2025-06-19 06:48:36,REAL,2890989399,10253,2890999652,2911077580
2025-06-19 06:48:38,REAL,2890999652,10318,2891009970,2911087898
2025-06-19 06:48:40,REAL,2891009970,10253,2891020223,2911098151
2025-06-19 06:48:42,REAL,2891020223,10318,2891030541,2911108469
2025-06-19 06:48:44,FAKE,2891030541,244,2891030785,2911118714
2025-06-19 06:48:46,FAKE,2891030785,243,2891031028,2911128966
2025-06-19 06:48:48,REAL,2891031028,3452,2891034480,2911132418
2025-06-19 06:48:50,REAL,2891034480,536,2891035016,2911132954
2025-06-19 06:48:52,REAL,2891035016,489,2891035505,2911133443
2025-06-19 06:48:54,FAKE,2891035505,241,2891035746,2911133921
2025-06-19 06:48:56,REAL,2891035746,483,2891036229,2911134404
2025-06-19 06:48:58,FAKE,2891036229,241,2891036470,2911134895
2025-06-19 06:49:00,REAL,2891036470,489,2891036959,2911135384
2025-06-19 06:49:02,REAL,2891036959,487,2891037446,2911135871
2025-06-19 06:49:04,REAL,2891037446,548,2891037994,2911136419
2025-06-19 06:49:06,REAL,2891037994,477,2891038471,2911136896
2025-06-19 06:49:08,REAL,2891038471,492,2891038963,2911137388
2025-06-19 06:49:10,REAL,2891038963,492,2891039455,2911137880
2025-06-19 06:49:12,FAKE,2891039455,238,2891039693,2911138360
2025-06-19 06:49:14,FAKE,2891039693,241,2891039934,2911138846
2025-06-19 06:49:16,REAL,2891039934,477,2891040411,2911139323
2025-06-19 06:49:18,FAKE,2891040411,238,2891040649,2911139801
2025-06-19 06:49:20,REAL,2891040649,478,2891041127,2911140279
2025-06-19 06:49:22,FAKE,2891041127,243,2891041370,2911140762
2025-06-19 06:49:24,FAKE,2891041370,244,2891041614,2911141246
2025-06-19 06:49:26,REAL,2891041614,12177,2891053791,2911153423
2025-06-19 06:49:28,FAKE,2891053791,244,2891054035,2911164662
2025-06-19 06:49:30,FAKE,2891054035,244,2891054279,2911174980
2025-06-19 06:49:32,FAKE,2891054279,241,2891054520,2911185166
2025-06-19 06:49:34,REAL,2891054520,10316,2891064836,2911195482
2025-06-19 06:49:36,FAKE,2891064836,243,2891065079,2911205742
2025-06-19 06:49:38,FAKE,2891065079,244,2891065323,2911216051
2025-06-19 06:49:40,REAL,2891065323,7349,2891072672,2911223400
2025-06-19 06:49:42,FAKE,2891072672,244,2891072916,2911223893
2025-06-19 06:49:44,REAL,2891072916,483,2891073399,2911224376
2025-06-19 06:49:46,REAL,2891073399,481,2891073880,2911224857
2025-06-19 06:49:48,REAL,2891073880,477,2891074357,2911225334
2025-06-19 06:49:50,FAKE,2891074357,238,2891074595,2911225821
2025-06-19 06:49:52,REAL,2891074595,487,2891075082,2911226308
2025-06-19 06:49:54,REAL,2891075082,544,2891075626,2911226852
2025-06-19 06:49:56,REAL,2891075626,491,2891076117,2911227343
2025-06-19 06:49:58,REAL,2891076117,481,2891076598,2911227824
2025-06-19 06:50:00,REAL,2891076598,485,2891077083,2911228309
2025-06-19 06:50:02,REAL,2891077083,490,2891077573,2911228799
2025-06-19 06:50:04,FAKE,2891077573,244,2891077817,2911229283
2025-06-19 06:50:06,REAL,2891077817,485,2891078302,2911229768
2025-06-19 06:50:08,FAKE,2891078302,241,2891078543,2911230245
2025-06-19 06:50:10,FAKE,2891078543,241,2891078784,2911230725
2025-06-19 06:50:12,REAL,2891078784,485,2891079269,2911231210
2025-06-19 06:50:14,REAL,2891079269,486,2891079755,2911231696
2025-06-19 06:50:16,FAKE,2891079755,243,2891079998,2911232183
2025-06-19 06:50:18,REAL,2891079998,487,2891080485,2911232670
2025-06-19 06:50:20,REAL,2891080485,480,2891080965,2911233150
2025-06-19 06:50:22,FAKE,2891080965,241,2891081206,2911233690
2025-06-19 06:50:24,REAL,2891081206,483,2891081689,2911234173
2025-06-19 06:50:26,REAL,2891081689,539,2891082228,2911234712
2025-06-19 06:50:28,FAKE,2891082228,241,2891082469,2911235194
2025-06-19 06:50:30,REAL,2891082469,477,2891082946,2911235671
2025-06-19 06:50:32,REAL,2891082946,482,2891083428,2911236153
2025-06-19 06:50:34,REAL,2891083428,485,2891083913,2911236638
2025-06-19 06:50:36,REAL,2891083913,486,2891084399,2911237124
2025-06-19 06:50:38,REAL,2891084399,244,2891084643,2911237368
2025-06-19 06:50:40,REAL,2891084643,479,2891085122,2911237847
2025-06-19 06:50:42,REAL,2891085122,482,2891085604,2911238329
2025-06-19 06:50:44,FAKE,2891085604,238,2891085842,2911238811
2025-06-19 06:50:46,REAL,2891085842,484,2891086326,2911239295
2025-06-19 06:50:48,REAL,2891086326,484,2891086810,2911239779
2025-06-19 06:50:50,REAL,2891086810,489,2891087299,2911240268
2025-06-19 06:50:52,REAL,2891087299,546,2891087845,2911240814
2025-06-19 06:50:54,REAL,2891087845,478,2891088323,2911241292
2025-06-19 06:50:56,REAL,2891088323,484,2891088807,2911241776
2025-06-19 06:50:58,REAL,2891088807,485,2891089292,2911242261
2025-06-19 06:51:00,FAKE,2891089292,238,2891089530,2911242750
2025-06-19 06:51:02,REAL,2891089530,480,2891090010,2911243230
2025-06-19 06:51:04,REAL,2891090010,477,2891090487,2911243707
2025-06-19 06:51:06,REAL,2891090487,482,2891090969,2911244189
2025-06-19 06:51:08,FAKE,2891090969,238,2891091207,2911244671
2025-06-19 06:51:10,REAL,2891091207,476,2891091683,2911245147
2025-06-19 06:51:12,FAKE,2891091683,243,2891091926,2911245691
2025-06-19 06:51:14,REAL,2891091926,483,2891092409,2911246174
2025-06-19 06:51:16,REAL,2891092409,491,2891092900,2911246665
2025-06-19 06:51:18,FAKE,2891092900,244,2891093144,2911247147
2025-06-19 06:51:20,REAL,2891093144,540,2891093684,2911247687
2025-06-19 06:51:22,REAL,2891093684,484,2891094168,2911248171
2025-06-19 06:51:24,FAKE,2891094168,238,2891094406,2911248650
2025-06-19 06:51:26,REAL,2891094406,487,2891094893,2911249137
2025-06-19 06:51:28,FAKE,2891094893,243,2891095136,2911249621
2025-06-19 06:51:30,REAL,2891095136,483,2891095619,2911250104
2025-06-19 06:51:32,REAL,2891095619,490,2891096109,2911250594
2025-06-19 06:51:34,REAL,2891096109,480,2891096589,2911251074
2025-06-19 06:51:36,FAKE,2891096589,241,2891096830,2911251558
2025-06-19 06:51:38,REAL,2891096830,480,2891097310,2911252038
2025-06-19 06:51:40,REAL,2891097310,488,2891097798,2911252526
2025-06-19 06:51:42,REAL,2891097798,477,2891098275,2911253003
2025-06-19 06:51:44,FAKE,2891098275,241,2891098516,2911253494
2025-06-19 06:51:46,FAKE,2891098516,243,2891098759,2911253979
2025-06-19 06:51:48,REAL,2891098759,532,2891099291,2911254511
2025-06-19 06:51:50,REAL,2891099291,482,2891099773,2911254993
2025-06-19 06:51:52,REAL,2891099773,478,2891100251,2911255471
2025-06-19 06:51:54,REAL,2891100251,7032,2891107283,2911262503
2025-06-19 06:51:56,REAL,2891107283,11257,2891118540,2911273760
2025-06-19 06:51:58,REAL,2891118540,10254,2891128794,2911284014
2025-06-19 06:52:00,REAL,2891128794,10310,2891139104,2911294324
2025-06-19 06:52:02,REAL,2891139104,10250,2891149354,2911304574
2025-06-19 06:52:04,FAKE,2891149354,244,2891149598,2911314890
2025-06-19 06:52:06,FAKE,2891149598,244,2891149842,2911325148
2025-06-19 06:52:08,FAKE,2891149842,243,2891150085,2911334737
2025-06-19 06:52:10,REAL,2891150085,484,2891150569,2911335221
2025-06-19 06:52:12,REAL,2891150569,484,2891151053,2911335705
2025-06-19 06:52:14,REAL,2891151053,484,2891151537,2911336189
2025-06-19 06:52:16,REAL,2891151537,490,2891152027,2911336679
2025-06-19 06:52:18,REAL,2891152027,483,2891152510,2911337162
2025-06-19 06:52:20,FAKE,2891152510,243,2891152753,2911337648
2025-06-19 06:52:22,FAKE,2891152753,243,2891152996,2911338195
2025-06-19 06:52:24,REAL,2891152996,484,2891153480,2911338679
2025-06-19 06:52:26,REAL,2891153480,482,2891153962,2911339161
2025-06-19 06:52:28,REAL,2891153962,486,2891154448,2911339647
2025-06-19 06:52:30,REAL,2891154448,479,2891154927,2911340126
2025-06-19 06:52:32,FAKE,2891154927,238,2891155165,2911340610
2025-06-19 06:52:34,REAL,2891155165,479,2891155644,2911341089
2025-06-19 06:52:36,REAL,2891155644,9273,2891164917,2911350362
2025-06-19 06:52:38,FAKE,2891164917,244,2891165161,2911362784
2025-06-19 06:52:40,REAL,2891165161,10262,2891175423,2911373046
2025-06-19 06:52:42,REAL,2891175423,10315,2891185738,2911383361
2025-06-19 06:52:44,REAL,2891185738,10253,2891195991,2911393614
2025-06-19 06:52:46,REAL,2891195991,10308,2891206299,2911403922
2025-06-19 06:52:48,REAL,2891206299,10322,2891216621,2911414244
2025-06-19 06:52:50,REAL,2891216621,9004,2891225625,2911423248
2025-06-19 06:52:52,REAL,2891225625,723,2891226348,2911423971
2025-06-19 06:52:54,REAL,2891226348,246,2891226594,2911424217
2025-06-19 06:52:56,FAKE,2891226594,241,2891226835,2911424696
2025-06-19 06:52:58,REAL,2891226835,488,2891227323,2911425184
2025-06-19 06:53:00,REAL,2891227323,487,2891227810,2911425671
2025-06-19 06:53:02,REAL,2891227810,491,2891228301,2911426162
2025-06-19 06:53:04,REAL,2891228301,542,2891228843,2911426704
2025-06-19 06:53:06,REAL,2891228843,489,2891229332,2911427193
2025-06-19 06:53:08,REAL,2891229332,477,2891229809,2911427670
2025-06-19 06:53:10,REAL,2891229809,488,2891230297,2911428158
2025-06-19 06:53:12,REAL,2891230297,482,2891230779,2911428640
2025-06-19 06:53:14,REAL,2891230779,479,2891231258,2911429119
2025-06-19 06:53:16,REAL,2891231258,483,2891231741,2911429602
2025-06-19 06:53:18,REAL,2891231741,484,2891232225,2911430086
2025-06-19 06:53:20,FAKE,2891232225,238,2891232463,2911430572
2025-06-19 06:53:22,REAL,2891232463,486,2891232949,2911431058
2025-06-19 06:53:24,REAL,2891232949,480,2891233429,2911431538
2025-06-19 06:53:26,REAL,2891233429,492,2891233921,2911432030
2025-06-19 06:53:28,REAL,2891233921,489,2891234410,2911432519
2025-06-19 06:53:30,FAKE,2891234410,238,2891234648,2911433012
2025-06-19 06:53:32,FAKE,2891234648,244,2891234892,2911433503
2025-06-19 06:53:34,REAL,2891234892,598,2891235490,2911434101
2025-06-19 06:53:36,REAL,2891235490,487,2891235977,2911434588
2025-06-19 06:53:38,REAL,2891235977,480,2891236457,2911435068
2025-06-19 06:53:40,REAL,2891236457,482,2891236939,2911435550
2025-06-19 06:53:42,REAL,2891236939,488,2891237427,2911436038
2025-06-19 06:53:44,REAL,2891237427,487,2891237914,2911436525
2025-06-19 06:53:46,FAKE,2891237914,244,2891238158,2911437007
2025-06-19 06:53:48,FAKE,2891238158,241,2891238399,2911437486
2025-06-19 06:53:50,REAL,2891238399,479,2891238878,2911437965
2025-06-19 06:53:52,REAL,2891238878,485,2891239363,2911438450
2025-06-19 06:53:54,FAKE,2891239363,243,2891239606,2911438935
2025-06-19 06:53:56,REAL,2891239606,489,2891240095,2911439424
2025-06-19 06:53:58,REAL,2891240095,487,2891240582,2911439911
2025-06-19 06:54:00,REAL,2891240582,486,2891241068,2911440397
2025-06-19 06:54:02,REAL,2891241068,539,2891241607,2911440936
2025-06-19 06:54:04,REAL,2891241607,491,2891242098,2911441427
2025-06-19 06:54:06,REAL,2891242098,492,2891242590,2911441919
2025-06-19 06:54:08,FAKE,2891242590,241,2891242831,2911442394
2025-06-19 06:54:10,FAKE,2891242831,243,2891243074,2911442876
2025-06-19 06:54:12,REAL,2891243074,12103,2891255177,2911454979
2025-06-19 06:54:14,REAL,2891255177,11106,2891266283,2911466085
2025-06-19 06:54:16,REAL,2891266283,10321,2891276604,2911476406
2025-06-19 06:54:18,FAKE,2891276604,243,2891276847,2911486661
2025-06-19 06:54:20,REAL,2891276847,10328,2891287175,2911496989
2025-06-19 06:54:22,REAL,2891287175,10252,2891297427,2911507241
2025-06-19 06:54:24,REAL,2891297427,10252,2891307679,2911517493
2025-06-19 06:54:26,REAL,2891307679,7151,2891314830,2911524644
2025-06-19 06:54:28,FAKE,2891314830,238,2891315068,2911525123
2025-06-19 06:54:30,REAL,2891315068,488,2891315556,2911525611
2025-06-19 06:54:32,REAL,2891315556,484,2891316040,2911526095
2025-06-19 06:54:34,FAKE,2891316040,243,2891316283,2911526585
2025-06-19 06:54:36,REAL,2891316283,489,2891316772,2911527074
2025-06-19 06:54:38,REAL,2891316772,482,2891317254,2911527556
2025-06-19 06:54:40,REAL,2891317254,486,2891317740,2911528042
2025-06-19 06:54:42,FAKE,2891317740,243,2891317983,2911528526
2025-06-19 06:54:44,REAL,2891317983,480,2891318463,2911529006
2025-06-19 06:54:46,REAL,2891318463,480,2891318943,2911529486
2025-06-19 06:54:48,REAL,2891318943,475,2891319418,2911529961
2025-06-19 06:54:50,FAKE,2891319418,238,2891319656,2911530439
2025-06-19 06:54:52,REAL,2891319656,539,2891320195,2911530978
2025-06-19 06:54:54,REAL,2891320195,483,2891320678,2911531461
2025-06-19 06:54:56,REAL,2891320678,535,2891321213,2911531996
2025-06-19 06:54:58,REAL,2891321213,477,2891321690,2911532473
2025-06-19 06:55:00,FAKE,2891321690,244,2891321934,2911532957
2025-06-19 06:55:02,REAL,2891321934,483,2891322417,2911533440
2025-06-19 06:55:04,REAL,2891322417,5179,2891327596,2911538619
2025-06-19 06:55:06,REAL,2891327596,11115,2891338711,2911549734
2025-06-19 06:55:08,REAL,2891338711,10254,2891348965,2911559988
2025-06-19 06:55:10,FAKE,2891348965,238,2891349203,2911570308
2025-06-19 06:55:12,REAL,2891349203,10250,2891359453,2911580558
2025-06-19 06:55:14,REAL,2891359453,10252,2891369705,2911590810
2025-06-19 06:55:16,REAL,2891369705,10248,2891379953,2911601058
2025-06-19 06:55:18,REAL,2891379953,10324,2891390277,2911611382
2025-06-19 06:55:20,REAL,2891390277,1215,2891391492,2911612597
2025-06-19 06:55:22,REAL,2891391492,477,2891391969,2911613074
2025-06-19 06:55:24,REAL,2891391969,479,2891392448,2911613553
2025-06-19 06:55:26,REAL,2891392448,477,2891392925,2911614030
2025-06-19 06:55:28,REAL,2891392925,483,2891393408,2911614513
2025-06-19 06:55:30,REAL,2891393408,6685,2891400093,2911621198
2025-06-19 06:55:32,REAL,2891400093,13224,2891413317,2911634422
2025-06-19 06:55:34,REAL,2891413317,10314,2891423631,2911644736
2025-06-19 06:55:36,REAL,2891423631,10253,2891433884,2911654989
2025-06-19 06:55:38,FAKE,2891433884,244,2891434128,2911665236
2025-06-19 06:55:40,REAL,2891434128,10250,2891444378,2911675486
2025-06-19 06:55:42,REAL,2891444378,10186,2891454564,2911685672
2025-06-19 06:55:44,FAKE,2891454564,238,2891454802,2911695932
2025-06-19 06:55:46,REAL,2891454802,1080,2891455882,2911697012
2025-06-19 06:55:48,REAL,2891455882,488,2891456370,2911697500
2025-06-19 06:55:50,FAKE,2891456370,238,2891456608,2911697990
2025-06-19 06:55:52,REAL,2891456608,487,2891457095,2911698477
2025-06-19 06:55:54,REAL,2891457095,485,2891457580,2911698962
2025-06-19 06:55:56,REAL,2891457580,486,2891458066,2911699448
2025-06-19 06:55:58,FAKE,2891458066,243,2891458309,2911699936
2025-06-19 06:56:00,FAKE,2891458309,241,2891458550,2911700426
2025-06-19 06:56:02,REAL,2891458550,7229,2891465779,2911707655
2025-06-19 06:56:04,REAL,2891465779,13164,2891478943,2911720819
2025-06-19 06:56:06,REAL,2891478943,10258,2891489201,2911731077
2025-06-19 06:56:08,REAL,2891489201,10249,2891499450,2911741326
2025-06-19 06:56:10,FAKE,2891499450,238,2891499688,2911751633
2025-06-19 06:56:12,REAL,2891499688,10319,2891510007,2911761952
2025-06-19 06:56:14,REAL,2891510007,10255,2891520262,2911772207
2025-06-19 06:56:16,REAL,2891520262,10179,2891530441,2911782386
2025-06-19 06:56:18,FAKE,2891530441,244,2891530685,2911782865
2025-06-19 06:56:20,FAKE,2891530685,238,2891530923,2911783350
2025-06-19 06:56:22,REAL,2891530923,488,2891531411,2911783838
2025-06-19 06:56:24,FAKE,2891531411,243,2891531654,2911784325
2025-06-19 06:56:26,REAL,2891531654,484,2891532138,2911784809
2025-06-19 06:56:28,REAL,2891532138,486,2891532624,2911785295
2025-06-19 06:56:30,REAL,2891532624,486,2891533110,2911785781
2025-06-19 06:56:32,REAL,2891533110,478,2891533588,2911786259
2025-06-19 06:56:34,FAKE,2891533588,244,2891533832,2911793225
2025-06-19 06:56:36,REAL,2891533832,10846,2891544678,2911804071
2025-06-19 06:56:38,REAL,2891544678,10322,2891555000,2911814393
2025-06-19 06:56:40,FAKE,2891555000,241,2891555241,2911824646
2025-06-19 06:56:42,REAL,2891555241,10314,2891565555,2911834960
2025-06-19 06:56:44,FAKE,2891565555,241,2891565796,2911845211
2025-06-19 06:56:46,FAKE,2891565796,244,2891566040,2911855460
2025-06-19 06:56:48,FAKE,2891566040,243,2891566283,2911865035
2025-06-19 06:56:50,REAL,2891566283,491,2891566774,2911865526
2025-06-19 06:56:52,REAL,2891566774,484,2891567258,2911866010
2025-06-19 06:56:54,REAL,2891567258,474,2891567732,2911866484
2025-06-19 06:56:56,FAKE,2891567732,243,2891567975,2911866968
2025-06-19 06:56:58,REAL,2891567975,482,2891568457,2911867450
2025-06-19 06:57:00,REAL,2891568457,479,2891568936,2911867929
2025-06-19 06:57:02,REAL,2891568936,483,2891569419,2911868412
2025-06-19 06:57:04,FAKE,2891569419,238,2891569657,2911868902
2025-06-19 06:57:06,REAL,2891569657,484,2891570141,2911869386
2025-06-19 06:57:08,REAL,2891570141,489,2891570630,2911869875
2025-06-19 06:57:10,REAL,2891570630,484,2891571114,2911870359
2025-06-19 06:57:12,REAL,2891571114,481,2891571595,2911870840
2025-06-19 06:57:14,REAL,2891571595,489,2891572084,2911871329
2025-06-19 06:57:16,REAL,2891572084,489,2891572573,2911871818
2025-06-19 06:57:18,REAL,2891572573,538,2891573111,2911872356
2025-06-19 06:57:20,FAKE,2891573111,241,2891573352,2911872840
2025-06-19 06:57:22,FAKE,2891573352,241,2891573593,2911873319
2025-06-19 06:57:24,REAL,2891573593,485,2891574078,2911873804
2025-06-19 06:57:26,REAL,2891574078,481,2891574559,2911874285
2025-06-19 06:57:28,REAL,2891574559,535,2891575094,2911874820
2025-06-19 06:57:30,REAL,2891575094,485,2891575579,2911875305
2025-06-19 06:57:32,REAL,2891575579,482,2891576061,2911875787
2025-06-19 06:57:34,REAL,2891576061,478,2891576539,2911876265
2025-06-19 06:57:36,FAKE,2891576539,238,2891576777,2911876739
2025-06-19 06:57:38,REAL,2891576777,10026,2891586803,2911886765
2025-06-19 06:57:40,FAKE,2891586803,241,2891587044,2911898738
2025-06-19 06:57:42,FAKE,2891587044,244,2891587288,2911909047
2025-06-19 06:57:44,FAKE,2891587288,241,2891587529,2911919298
2025-06-19 06:57:46,FAKE,2891587529,238,2891587767,2911929613
2025-06-19 06:57:48,REAL,2891587767,10251,2891598018,2911939864
2025-06-19 06:57:50,REAL,2891598018,10308,2891608326,2911950172
2025-06-19 06:57:52,FAKE,2891608326,241,2891608567,2911958442
2025-06-19 06:57:54,REAL,2891608567,480,2891609047,2911958922
2025-06-19 06:57:56,REAL,2891609047,491,2891609538,2911959413
2025-06-19 06:57:58,FAKE,2891609538,244,2891609782,2911959900
2025-06-19 06:58:00,FAKE,2891609782,241,2891610023,2911960380
2025-06-19 06:58:02,REAL,2891610023,476,2891610499,2911960856
2025-06-19 06:58:04,REAL,2891610499,481,2891610980,2911961337
2025-06-19 06:58:06,REAL,2891610980,534,2891611514,2911961871
2025-06-19 06:58:08,REAL,2891611514,492,2891612006,2911962363
2025-06-19 06:58:10,FAKE,2891612006,241,2891612247,2911962849
2025-06-19 06:58:12,FAKE,2891612247,241,2891612488,2911963339
2025-06-19 06:58:14,FAKE,2891612488,238,2891612726,2911966668
2025-06-19 06:58:16,REAL,2891612726,12109,2891624835,2911978777
2025-06-19 06:58:18,FAKE,2891624835,244,2891625079,2911989036
2025-06-19 06:58:20,REAL,2891625079,10251,2891635330,2911999287
2025-06-19 06:58:22,REAL,2891635330,10249,2891645579,2912009536
2025-06-19 06:58:24,FAKE,2891645579,238,2891645817,2912019780
2025-06-19 06:58:26,REAL,2891645817,10320,2891656137,2912030100
2025-06-19 06:58:28,REAL,2891656137,10253,2891666390,2912040353
2025-06-19 06:58:30,REAL,2891666390,2729,2891669119,2912043082
2025-06-19 06:58:32,REAL,2891669119,487,2891669606,2912043569
2025-06-19 06:58:34,REAL,2891669606,478,2891670084,2912044047
2025-06-19 06:58:36,REAL,2891670084,475,2891670559,2912044522
2025-06-19 06:58:38,REAL,2891670559,487,2891671046,2912045009
2025-06-19 06:58:40,REAL,2891671046,484,2891671530,2912045493
2025-06-19 06:58:42,REAL,2891671530,483,2891672013,2912045976
2025-06-19 06:58:44,FAKE,2891672013,244,2891672257,2912046460
2025-06-19 06:58:46,REAL,2891672257,481,2891672738,2912046941
2025-06-19 06:58:48,REAL,2891672738,474,2891673212,2912047415
2025-06-19 06:58:50,FAKE,2891673212,244,2891673456,2912047957
2025-06-19 06:58:52,FAKE,2891673456,241,2891673697,2912048440
2025-06-19 06:58:54,REAL,2891673697,483,2891674180,2912048923
2025-06-19 06:58:56,REAL,2891674180,474,2891674654,2912049397
2025-06-19 06:58:58,REAL,2891674654,549,2891675203,2912049946
2025-06-19 06:59:00,FAKE,2891675203,241,2891675444,2912050437
2025-06-19 06:59:02,REAL,2891675444,483,2891675927,2912050920
2025-06-19 06:59:04,REAL,2891675927,483,2891676410,2912051403
2025-06-19 06:59:06,FAKE,2891676410,244,2891676654,2912051892
2025-06-19 06:59:08,FAKE,2891676654,241,2891676895,2912062081
2025-06-19 06:59:10,REAL,2891676895,10456,2891687351,2912072537
2025-06-19 06:59:12,REAL,2891687351,10243,2891697594,2912082780
2025-06-19 06:59:14,FAKE,2891697594,243,2891697837,2912093029
2025-06-19 06:59:16,REAL,2891697837,10322,2891708159,2912103351
2025-06-19 06:59:18,FAKE,2891708159,238,2891708397,2912113602
2025-06-19 06:59:20,REAL,2891708397,10259,2891718656,2912123861
2025-06-19 06:59:22,REAL,2891718656,6693,2891725349,2912130554
2025-06-19 06:59:24,REAL,2891725349,480,2891725829,2912131034
2025-06-19 06:59:26,REAL,2891725829,487,2891726316,2912131521
2025-06-19 06:59:28,REAL,2891726316,481,2891726797,2912132002
2025-06-19 06:59:30,FAKE,2891726797,244,2891727041,2912132486
2025-06-19 06:59:32,REAL,2891727041,477,2891727518,2912132963
2025-06-19 06:59:34,REAL,2891727518,487,2891728005,2912133450
2025-06-19 06:59:36,FAKE,2891728005,238,2891728243,2912133982
2025-06-19 06:59:38,REAL,2891728243,488,2891728731,2912134470
2025-06-19 06:59:40,REAL,2891728731,14022,2891742753,2912148492
2025-06-19 06:59:42,FAKE,2891742753,241,2891742994,2912158810
2025-06-19 06:59:44,FAKE,2891742994,238,2891743232,2912169066
2025-06-19 06:59:46,REAL,2891743232,10252,2891753484,2912179318
2025-06-19 06:59:48,FAKE,2891753484,244,2891753728,2912189575
2025-06-19 06:59:50,REAL,2891753728,10261,2891763989,2912199836
2025-06-19 06:59:52,FAKE,2891763989,241,2891764230,2912210093
2025-06-19 06:59:54,REAL,2891764230,6029,2891770259,2912216122
2025-06-19 06:59:56,FAKE,2891770259,244,2891770503,2912216678
2025-06-19 06:59:58,REAL,2891770503,487,2891770990,2912217165
2025-06-19 07:00:00,FAKE,2891770990,241,2891771231,2912217649
2025-06-19 07:00:02,REAL,2891771231,493,2891771724,2912218142
2025-06-19 07:00:04,REAL,2891771724,490,2891772214,2912218632
2025-06-19 07:00:06,REAL,2891772214,486,2891772700,2912219118
2025-06-19 07:00:08,REAL,2891772700,539,2891773239,2912219657
2025-06-19 07:00:10,FAKE,2891773239,244,2891773483,2912220140
2025-06-19 07:00:12,FAKE,2891773483,244,2891773727,2912220622
2025-06-19 07:00:14,REAL,2891773727,482,2891774209,2912221104
2025-06-19 07:00:16,FAKE,2891774209,238,2891774447,2912221590
2025-06-19 07:00:18,REAL,2891774447,478,2891774925,2912222068
2025-06-19 07:00:20,REAL,2891774925,539,2891775464,2912222607
2025-06-19 07:00:22,REAL,2891775464,482,2891775946,2912223089
2025-06-19 07:00:24,REAL,2891775946,477,2891776423,2912223566
2025-06-19 07:00:26,FAKE,2891776423,243,2891776666,2912224060
2025-06-19 07:00:28,REAL,2891776666,480,2891777146,2912224540
2025-06-19 07:00:30,REAL,2891777146,480,2891777626,2912225020
2025-06-19 07:00:32,FAKE,2891777626,238,2891777864,2912225507
2025-06-19 07:00:34,REAL,2891777864,493,2891778357,2912226000
2025-06-19 07:00:36,REAL,2891778357,540,2891778897,2912226540
2025-06-19 07:00:38,REAL,2891778897,490,2891779387,2912227030
2025-06-19 07:00:40,FAKE,2891779387,243,2891779630,2912227515
2025-06-19 07:00:42,FAKE,2891779630,238,2891779868,2912228000
2025-06-19 07:00:44,REAL,2891779868,476,2891780344,2912228476
2025-06-19 07:00:46,REAL,2891780344,488,2891780832,2912228964
2025-06-19 07:00:48,REAL,2891780832,489,2891781321,2912229453
2025-06-19 07:00:50,REAL,2891781321,484,2891781805,2912229937
2025-06-19 07:00:52,FAKE,2891781805,244,2891782049,2912230428
2025-06-19 07:00:54,REAL,2891782049,478,2891782527,2912230906
2025-06-19 07:00:56,FAKE,2891782527,241,2891782768,2912231389
2025-06-19 07:00:58,REAL,2891782768,480,2891783248,2912231869
2025-06-19 07:01:00,REAL,2891783248,483,2891783731,2912232352
2025-06-19 07:01:02,REAL,2891783731,491,2891784222,2912232843
2025-06-19 07:01:04,REAL,2891784222,480,2891784702,2912233323
2025-06-19 07:01:06,FAKE,2891784702,241,2891784943,2912233918
2025-06-19 07:01:08,FAKE,2891784943,238,2891785181,2912234402
2025-06-19 07:01:10,FAKE,2891785181,243,2891785424,2912234879
2025-06-19 07:01:12,REAL,2891785424,491,2891785915,2912235370
2025-06-19 07:01:14,FAKE,2891785915,241,2891786156,2912235857
2025-06-19 07:01:16,REAL,2891786156,489,2891786645,2912236346
2025-06-19 07:01:18,REAL,2891786645,482,2891787127,2912236828
2025-06-19 07:01:20,REAL,2891787127,8157,2891795284,2912244985
2025-06-19 07:01:22,REAL,2891795284,10840,2891806124,2912255825
2025-06-19 07:01:24,REAL,2891806124,10320,2891816444,2912266145
2025-06-19 07:01:26,REAL,2891816444,10245,2891826689,2912276390
2025-06-19 07:01:28,FAKE,2891826689,243,2891826932,2912286639
2025-06-19 07:01:30,REAL,2891826932,10326,2891837258,2912296965
2025-06-19 07:01:32,REAL,2891837258,10248,2891847506,2912307213
2025-06-19 07:01:34,REAL,2891847506,9004,2891856510,2912316217
2025-06-19 07:01:36,FAKE,2891856510,244,2891856754,2912316694
2025-06-19 07:01:38,REAL,2891856754,481,2891857235,2912317175
2025-06-19 07:01:40,REAL,2891857235,474,2891857709,2912317649
2025-06-19 07:01:42,REAL,2891857709,483,2891858192,2912318132
2025-06-19 07:01:44,REAL,2891858192,483,2891858675,2912318615
2025-06-19 07:01:46,REAL,2891858675,479,2891859154,2912319094
2025-06-19 07:01:48,FAKE,2891859154,244,2891859398,2912319630
2025-06-19 07:01:50,REAL,2891859398,533,2891859931,2912320163
2025-06-19 07:01:52,REAL,2891859931,8215,2891868146,2912328378
2025-06-19 07:01:54,REAL,2891868146,10715,2891878861,2912339093
2025-06-19 07:01:56,FAKE,2891878861,238,2891879099,2912349346
2025-06-19 07:01:58,REAL,2891879099,10245,2891889344,2912359591
2025-06-19 07:02:00,FAKE,2891889344,243,2891889587,2912369906
2025-06-19 07:02:02,REAL,2891889587,10252,2891899839,2912380158
2025-06-19 07:02:04,REAL,2891899839,10251,2891910090,2912390409
2025-06-19 07:02:06,FAKE,2891910090,244,2891910334,2912398809
2025-06-19 07:02:08,REAL,2891910334,477,2891910811,2912399286
2025-06-19 07:02:10,REAL,2891910811,485,2891911296,2912399771
2025-06-19 07:02:12,REAL,2891911296,490,2891911786,2912400261
2025-06-19 07:02:14,REAL,2891911786,476,2891912262,2912400737
2025-06-19 07:02:16,REAL,2891912262,487,2891912749,2912401224
2025-06-19 07:02:18,FAKE,2891912749,241,2891912990,2912401763
2025-06-19 07:02:20,REAL,2891912990,483,2891913473,2912402246
2025-06-19 07:02:22,REAL,2891913473,479,2891913952,2912402725
2025-06-19 07:02:24,FAKE,2891913952,244,2891914196,2912403207
2025-06-19 07:02:26,REAL,2891914196,489,2891914685,2912403696
2025-06-19 07:02:28,REAL,2891914685,488,2891915173,2912404184
2025-06-19 07:02:30,REAL,2891915173,487,2891915660,2912404671
2025-06-19 07:02:32,REAL,2891915660,476,2891916136,2912405147
2025-06-19 07:02:34,REAL,2891916136,485,2891916621,2912405632
2025-06-19 07:02:36,FAKE,2891916621,243,2891916864,2912406169
2025-06-19 07:02:38,REAL,2891916864,486,2891917350,2912406655
2025-06-19 07:02:40,REAL,2891917350,484,2891917834,2912407139
2025-06-19 07:02:42,REAL,2891917834,485,2891918319,2912407624
2025-06-19 07:02:44,REAL,2891918319,487,2891918806,2912408111
2025-06-19 07:02:46,REAL,2891918806,486,2891919292,2912408597
2025-06-19 07:02:48,REAL,2891919292,543,2891919835,2912409140
2025-06-19 07:02:50,FAKE,2891919835,241,2891920076,2912409618
2025-06-19 07:02:52,REAL,2891920076,491,2891920567,2912410109
2025-06-19 07:02:54,REAL,2891920567,494,2891921061,2912410603
2025-06-19 07:02:56,REAL,2891921061,9730,2891930791,2912420333
2025-06-19 07:02:58,FAKE,2891930791,241,2891931032,2912430782
2025-06-19 07:03:00,FAKE,2891931032,238,2891931270,2912441034
2025-06-19 07:03:02,FAKE,2891931270,238,2891931508,2912451285
2025-06-19 07:03:04,REAL,2891931508,10321,2891941829,2912461606
2025-06-19 07:03:06,REAL,2891941829,10254,2891952083,2912471860
2025-06-19 07:03:08,REAL,2891952083,10259,2891962342,2912482119
2025-06-19 07:03:10,FAKE,2891962342,238,2891962580,2912489273
2025-06-19 07:03:12,REAL,2891962580,493,2891963073,2912489766
2025-06-19 07:03:14,FAKE,2891963073,243,2891963316,2912490242
2025-06-19 07:03:16,REAL,2891963316,486,2891963802,2912490728
2025-06-19 07:03:18,REAL,2891963802,484,2891964286,2912491212
2025-06-19 07:03:20,REAL,2891964286,537,2891964823,2912491749
2025-06-19 07:03:22,FAKE,2891964823,243,2891965066,2912492296
2025-06-19 07:03:24,REAL,2891965066,484,2891965550,2912492780
2025-06-19 07:03:26,FAKE,2891965550,238,2891965788,2912493258
2025-06-19 07:03:28,REAL,2891965788,10715,2891976503,2912503973
2025-06-19 07:03:30,FAKE,2891976503,241,2891976744,2912514349
2025-06-19 07:03:32,FAKE,2891976744,244,2891976988,2912524666
2025-06-19 07:03:34,FAKE,2891976988,241,2891977229,2912534911
2025-06-19 07:03:36,FAKE,2891977229,238,2891977467,2912545232
2025-06-19 07:03:38,REAL,2891977467,10254,2891987721,2912555486
2025-06-19 07:03:40,REAL,2891987721,10315,2891998036,2912565801
2025-06-19 07:03:42,REAL,2891998036,6494,2892004530,2912572295
2025-06-19 07:03:44,REAL,2892004530,487,2892005017,2912572782
2025-06-19 07:03:46,REAL,2892005017,485,2892005502,2912573267
2025-06-19 07:03:48,REAL,2892005502,487,2892005989,2912573754
2025-06-19 07:03:50,FAKE,2892005989,238,2892006227,2912574241
2025-06-19 07:03:52,FAKE,2892006227,244,2892006471,2912574729
2025-06-19 07:03:54,FAKE,2892006471,241,2892006712,2912575270
2025-06-19 07:03:56,FAKE,2892006712,243,2892006955,2912575747
2025-06-19 07:03:58,FAKE,2892006955,243,2892007198,2912576229
2025-06-19 07:04:00,FAKE,2892007198,238,2892007436,2912576714
2025-06-19 07:04:02,REAL,2892007436,485,2892007921,2912577199
2025-06-19 07:04:04,FAKE,2892007921,244,2892008165,2912577687
2025-06-19 07:04:06,REAL,2892008165,540,2892008705,2912578227
2025-06-19 07:04:08,FAKE,2892008705,238,2892008943,2912578703
2025-06-19 07:04:10,FAKE,2892008943,243,2892009186,2912579186
2025-06-19 07:04:12,REAL,2892009186,478,2892009664,2912579664
2025-06-19 07:04:14,FAKE,2892009664,238,2892009902,2912580149
2025-06-19 07:04:16,REAL,2892009902,489,2892010391,2912580638
2025-06-19 07:04:18,REAL,2892010391,475,2892010866,2912581113
2025-06-19 07:04:20,REAL,2892010866,485,2892011351,2912581598
2025-06-19 07:04:22,REAL,2892011351,485,2892011836,2912582083
2025-06-19 07:04:24,REAL,2892011836,546,2892012382,2912582629
2025-06-19 07:04:26,REAL,2892012382,485,2892012867,2912583114
2025-06-19 07:04:28,FAKE,2892012867,244,2892013111,2912583595
2025-06-19 07:04:30,REAL,2892013111,476,2892013587,2912584071
2025-06-19 07:04:32,FAKE,2892013587,241,2892013828,2912584559
2025-06-19 07:04:34,REAL,2892013828,479,2892014307,2912585038
2025-06-19 07:04:36,FAKE,2892014307,241,2892014548,2912585518
2025-06-19 07:04:38,FAKE,2892014548,238,2892014786,2912585998
2025-06-19 07:04:40,FAKE,2892014786,238,2892015024,2912586476
2025-06-19 07:04:42,REAL,2892015024,486,2892015510,2912586962
2025-06-19 07:04:44,REAL,2892015510,484,2892015994,2912587446
2025-06-19 07:04:46,REAL,2892015994,488,2892016482,2912587934
2025-06-19 07:04:48,FAKE,2892016482,238,2892016720,2912588476
2025-06-19 07:04:50,REAL,2892016720,480,2892017200,2912588956
2025-06-19 07:04:52,REAL,2892017200,543,2892017743,2912589499
2025-06-19 07:04:54,REAL,2892017743,480,2892018223,2912589979
2025-06-19 07:04:56,FAKE,2892018223,238,2892018461,2912590460
2025-06-19 07:04:58,REAL,2892018461,485,2892018946,2912590945
2025-06-19 07:05:00,FAKE,2892018946,238,2892019184,2912591427
2025-06-19 07:05:02,FAKE,2892019184,244,2892019428,2912591916
2025-06-19 07:05:04,REAL,2892019428,485,2892019913,2912592401
2025-06-19 07:05:06,REAL,2892019913,485,2892020398,2912592886
2025-06-19 07:05:08,REAL,2892020398,487,2892020885,2912593373
2025-06-19 07:05:10,FAKE,2892020885,243,2892021128,2912593851
2025-06-19 07:05:12,REAL,2892021128,482,2892021610,2912594333
2025-06-19 07:05:14,FAKE,2892021610,244,2892021854,2912594812
2025-06-19 07:05:16,FAKE,2892021854,241,2892022095,2912595299
2025-06-19 07:05:18,FAKE,2892022095,243,2892022338,2912602324
2025-06-19 07:05:20,FAKE,2892022338,241,2892022579,2912613298
2025-06-19 07:05:22,REAL,2892022579,10254,2892032833,2912623552
2025-06-19 07:05:24,REAL,2892032833,10251,2892043084,2912633803
2025-06-19 07:05:26,FAKE,2892043084,244,2892043328,2912644121
2025-06-19 07:05:28,REAL,2892043328,10255,2892053583,2912654376
2025-06-19 07:05:30,REAL,2892053583,10256,2892063839,2912664632
2025-06-19 07:05:32,REAL,2892063839,9650,2892073489,2912674282
2025-06-19 07:05:34,REAL,2892073489,483,2892073972,2912674765
2025-06-19 07:05:36,REAL,2892073972,478,2892074450,2912675243
2025-06-19 07:05:38,FAKE,2892074450,241,2892074691,2912675728
2025-06-19 07:05:40,REAL,2892074691,481,2892075172,2912676209
2025-06-19 07:05:42,REAL,2892075172,480,2892075652,2912676689
2025-06-19 07:05:44,REAL,2892075652,475,2892076127,2912677164
2025-06-19 07:05:46,FAKE,2892076127,238,2892076365,2912677710
2025-06-19 07:05:48,REAL,2892076365,488,2892076853,2912678198
2025-06-19 07:05:50,REAL,2892076853,475,2892077328,2912678673
2025-06-19 07:05:52,FAKE,2892077328,238,2892077566,2912679156
2025-06-19 07:05:54,REAL,2892077566,2010,2892079576,2912681166
2025-06-19 07:05:56,REAL,2892079576,11640,2892091216,2912692806
2025-06-19 07:05:58,REAL,2892091216,10244,2892101460,2912703050
2025-06-19 07:06:00,FAKE,2892101460,243,2892101703,2912713368
2025-06-19 07:06:02,REAL,2892101703,10256,2892111959,2912723624
2025-06-19 07:06:04,REAL,2892111959,10253,2892122212,2912733877
2025-06-19 07:06:06,FAKE,2892122212,238,2892122450,2912744131
2025-06-19 07:06:08,REAL,2892122450,10313,2892132763,2912754444
2025-06-19 07:06:10,REAL,2892132763,3979,2892136742,2912758423
2025-06-19 07:06:12,REAL,2892136742,491,2892137233,2912758914
2025-06-19 07:06:14,REAL,2892137233,547,2892137780,2912759461
2025-06-19 07:06:16,REAL,2892137780,474,2892138254,2912759935
2025-06-19 07:06:18,REAL,2892138254,483,2892138737,2912760418
2025-06-19 07:06:20,REAL,2892138737,487,2892139224,2912760905
2025-06-19 07:06:22,FAKE,2892139224,241,2892139465,2912761394
2025-06-19 07:06:24,REAL,2892139465,533,2892139998,2912761927
2025-06-19 07:06:26,FAKE,2892139998,241,2892140239,2912764724
2025-06-19 07:06:28,REAL,2892140239,11577,2892151816,2912776301
2025-06-19 07:06:30,REAL,2892151816,10316,2892162132,2912786617
2025-06-19 07:06:32,REAL,2892162132,10310,2892172442,2912796927
2025-06-19 07:06:34,REAL,2892172442,10251,2892182693,2912807178
2025-06-19 07:06:36,REAL,2892182693,10322,2892193015,2912817500
2025-06-19 07:06:38,REAL,2892193015,10246,2892203261,2912827746
2025-06-19 07:06:40,REAL,2892203261,10318,2892213579,2912838064
2025-06-19 07:06:42,FAKE,2892213579,241,2892213820,2912841457
2025-06-19 07:06:44,FAKE,2892213820,238,2892214058,2912841936
2025-06-19 07:06:46,FAKE,2892214058,244,2892214302,2912842414
2025-06-19 07:06:48,FAKE,2892214302,243,2892214545,2912842903
2025-06-19 07:06:50,REAL,2892214545,488,2892215033,2912843391
2025-06-19 07:06:52,REAL,2892215033,486,2892215519,2912843877
2025-06-19 07:06:54,FAKE,2892215519,241,2892215760,2912844363
2025-06-19 07:06:56,FAKE,2892215760,238,2892215998,2912844907
2025-06-19 07:06:58,FAKE,2892215998,238,2892216236,2912845441
2025-06-19 07:07:00,REAL,2892216236,489,2892216725,2912845930
2025-06-19 07:07:02,REAL,2892216725,489,2892217214,2912846419
2025-06-19 07:07:04,REAL,2892217214,483,2892217697,2912846902
2025-06-19 07:07:06,REAL,2892217697,482,2892218179,2912847384
2025-06-19 07:07:08,REAL,2892218179,488,2892218667,2912847872
2025-06-19 07:07:10,REAL,2892218667,486,2892219153,2912848358
2025-06-19 07:07:12,REAL,2892219153,487,2892219640,2912848845
2025-06-19 07:07:14,REAL,2892219640,478,2892220118,2912849323
2025-06-19 07:07:16,FAKE,2892220118,238,2892220356,2912849806
2025-06-19 07:07:18,REAL,2892220356,484,2892220840,2912850290
2025-06-19 07:07:20,REAL,2892220840,9260,2892230100,2912859550
2025-06-19 07:07:22,REAL,2892230100,10206,2892240306,2912869756
2025-06-19 07:07:24,REAL,2892240306,10316,2892250622,2912880072
2025-06-19 07:07:26,FAKE,2892250622,244,2892250866,2912890325
2025-06-19 07:07:28,REAL,2892250866,10248,2892261114,2912900573
2025-06-19 07:07:30,FAKE,2892261114,241,2892261355,2912910891
2025-06-19 07:07:32,REAL,2892261355,10252,2892271607,2912921143
2025-06-19 07:07:34,FAKE,2892271607,241,2892271848,2912928483
2025-06-19 07:07:36,FAKE,2892271848,244,2892272092,2912928958
2025-06-19 07:07:38,REAL,2892272092,486,2892272578,2912929444
2025-06-19 07:07:40,FAKE,2892272578,241,2892272819,2912929923
2025-06-19 07:07:42,REAL,2892272819,542,2892273361,2912930465
2025-06-19 07:07:44,REAL,2892273361,486,2892273847,2912930951
2025-06-19 07:07:46,REAL,2892273847,477,2892274324,2912931428
2025-06-19 07:07:48,REAL,2892274324,488,2892274812,2912931916
2025-06-19 07:07:50,REAL,2892274812,547,2892275359,2912932463
2025-06-19 07:07:52,REAL,2892275359,482,2892275841,2912932945
2025-06-19 07:07:54,REAL,2892275841,482,2892276323,2912933427
2025-06-19 07:07:56,REAL,2892276323,483,2892276806,2912933910
2025-06-19 07:07:58,FAKE,2892276806,244,2892277050,2912934398
2025-06-19 07:08:00,FAKE,2892277050,244,2892277294,2912934887
2025-06-19 07:08:02,REAL,2892277294,485,2892277779,2912935372
2025-06-19 07:08:04,FAKE,2892277779,238,2892278017,2912935846
2025-06-19 07:08:06,FAKE,2892278017,241,2892278258,2912936324
2025-06-19 07:08:08,FAKE,2892278258,244,2892278502,2912936806
2025-06-19 07:08:10,REAL,2892278502,483,2892278985,2912937289
2025-06-19 07:08:12,FAKE,2892278985,238,2892279223,2912942407
2025-06-19 07:08:14,REAL,2892279223,11182,2892290405,2912953589
2025-06-19 07:08:16,REAL,2892290405,10253,2892300658,2912963842
2025-06-19 07:08:18,REAL,2892300658,10309,2892310967,2912974151
2025-06-19 07:08:20,REAL,2892310967,10319,2892321286,2912984470
2025-06-19 07:08:22,FAKE,2892321286,241,2892321527,2912994724
2025-06-19 07:08:24,FAKE,2892321527,241,2892321768,2913005028
2025-06-19 07:08:26,REAL,2892321768,10250,2892332018,2913015278
2025-06-19 07:08:28,FAKE,2892332018,243,2892332261,2913016749
2025-06-19 07:08:30,FAKE,2892332261,238,2892332499,2913017235
2025-06-19 07:08:32,REAL,2892332499,478,2892332977,2913017713
2025-06-19 07:08:34,REAL,2892332977,14168,2892347145,2913031881
2025-06-19 07:08:36,REAL,2892347145,10318,2892357463,2913042199
2025-06-19 07:08:38,FAKE,2892357463,238,2892357701,2913052449
2025-06-19 07:08:40,REAL,2892357701,10324,2892368025,2913062773
2025-06-19 07:08:42,FAKE,2892368025,243,2892368268,2913073022
2025-06-19 07:08:44,REAL,2892368268,10253,2892378521,2913083275
2025-06-19 07:08:46,REAL,2892378521,10246,2892388767,2913093521
2025-06-19 07:08:48,REAL,2892388767,5963,2892394730,2913099484
2025-06-19 07:08:50,REAL,2892394730,485,2892395215,2913099969
2025-06-19 07:08:52,FAKE,2892395215,238,2892395453,2913100451
2025-06-19 07:08:54,FAKE,2892395453,243,2892395696,2913100944
2025-06-19 07:08:56,REAL,2892395696,483,2892396179,2913101427
2025-06-19 07:08:58,REAL,2892396179,491,2892396670,2913101918
2025-06-19 07:09:00,REAL,2892396670,479,2892397149,2913102397
2025-06-19 07:09:02,REAL,2892397149,542,2892397691,2913102939
2025-06-19 07:09:04,FAKE,2892397691,244,2892397935,2913103419
2025-06-19 07:09:06,REAL,2892397935,491,2892398426,2913103910
2025-06-19 07:09:08,REAL,2892398426,530,2892398956,2913104440
2025-06-19 07:09:10,FAKE,2892398956,238,2892399194,2913104917
2025-06-19 07:09:12,FAKE,2892399194,238,2892399432,2913105408
2025-06-19 07:09:14,REAL,2892399432,486,2892399918,2913105894
2025-06-19 07:09:16,FAKE,2892399918,241,2892400159,2913106370
2025-06-19 07:09:18,FAKE,2892400159,238,2892400397,2913106854
2025-06-19 07:09:20,REAL,2892400397,474,2892400871,2913107328
2025-06-19 07:09:22,REAL,2892400871,478,2892401349,2913107806
2025-06-19 07:09:24,REAL,2892401349,485,2892401834,2913108291
2025-06-19 07:09:26,REAL,2892401834,484,2892402318,2913108775
2025-06-19 07:09:28,REAL,2892402318,482,2892402800,2913109257
2025-06-19 07:09:30,FAKE,2892402800,244,2892403044,2913109738
2025-06-19 07:09:32,FAKE,2892403044,244,2892403288,2913110220
2025-06-19 07:09:34,REAL,2892403288,491,2892403779,2913110711
2025-06-19 07:09:36,FAKE,2892403779,243,2892404022,2913111798
2025-06-19 07:09:38,FAKE,2892404022,241,2892404263,2913126341
2025-06-19 07:09:40,FAKE,2892404263,244,2892404507,2913136657
2025-06-19 07:09:42,FAKE,2892404507,244,2892404751,2913146958
2025-06-19 07:09:44,FAKE,2892404751,243,2892404994,2913157275
2025-06-19 07:09:46,REAL,2892404994,10249,2892415243,2913167524
2025-06-19 07:09:48,REAL,2892415243,10257,2892425500,2913177781
2025-06-19 07:09:50,REAL,2892425500,10317,2892435817,2913188098
2025-06-19 07:09:52,REAL,2892435817,4704,2892440521,2913192802
2025-06-19 07:09:54,FAKE,2892440521,244,2892440765,2913193291
2025-06-19 07:09:56,REAL,2892440765,485,2892441250,2913193776
2025-06-19 07:09:58,REAL,2892441250,8216,2892449466,2913201992
2025-06-19 07:10:00,REAL,2892449466,12561,2892462027,2913214553
2025-06-19 07:10:02,REAL,2892462027,10253,2892472280,2913224806
2025-06-19 07:10:04,REAL,2892472280,10253,2892482533,2913235059
2025-06-19 07:10:06,REAL,2892482533,10256,2892492789,2913245315
2025-06-19 07:10:08,FAKE,2892492789,244,2892493033,2913255631
2025-06-19 07:10:10,REAL,2892493033,10251,2892503284,2913265882
2025-06-19 07:10:12,REAL,2892503284,9261,2892512545,2913275143
2025-06-19 07:10:14,REAL,2892512545,478,2892513023,2913275621
2025-06-19 07:10:16,REAL,2892513023,477,2892513500,2913276098
2025-06-19 07:10:18,REAL,2892513500,537,2892514037,2913276635
2025-06-19 07:10:20,FAKE,2892514037,238,2892514275,2913277119
2025-06-19 07:10:22,FAKE,2892514275,238,2892514513,2913277599
2025-06-19 07:10:24,REAL,2892514513,7561,2892522074,2913285160
2025-06-19 07:10:26,REAL,2892522074,10377,2892532451,2913295537
2025-06-19 07:10:28,FAKE,2892532451,244,2892532695,2913305782
2025-06-19 07:10:30,REAL,2892532695,10261,2892542956,2913316043
2025-06-19 07:10:32,FAKE,2892542956,238,2892543194,2913326293
2025-06-19 07:10:34,FAKE,2892543194,244,2892543438,2913336613
2025-06-19 07:10:36,REAL,2892543438,10183,2892553621,2913346796
2025-06-19 07:10:38,REAL,2892553621,9064,2892562685,2913355860
2025-06-19 07:10:40,FAKE,2892562685,243,2892562928,2913356351
2025-06-19 07:10:42,REAL,2892562928,480,2892563408,2913356831
2025-06-19 07:10:44,REAL,2892563408,482,2892563890,2913357313
2025-06-19 07:10:46,REAL,2892563890,483,2892564373,2913357796
2025-06-19 07:10:48,FAKE,2892564373,238,2892564611,2913358288
2025-06-19 07:10:50,REAL,2892564611,477,2892565088,2913358765
2025-06-19 07:10:52,REAL,2892565088,545,2892565633,2913359310
2025-06-19 07:10:54,FAKE,2892565633,243,2892565876,2913359798
2025-06-19 07:10:56,REAL,2892565876,482,2892566358,2913360280
2025-06-19 07:10:58,REAL,2892566358,482,2892566840,2913360762
2025-06-19 07:11:00,REAL,2892566840,545,2892567385,2913361307
2025-06-19 07:11:02,REAL,2892567385,486,2892567871,2913361793
2025-06-19 07:11:04,REAL,2892567871,488,2892568359,2913362281
2025-06-19 07:11:06,FAKE,2892568359,244,2892568603,2913362769
2025-06-19 07:11:08,REAL,2892568603,487,2892569090,2913363256
2025-06-19 07:11:10,FAKE,2892569090,244,2892569334,2913363739
2025-06-19 07:11:12,REAL,2892569334,481,2892569815,2913364220
2025-06-19 07:11:14,REAL,2892569815,491,2892570306,2913364711
2025-06-19 07:11:16,REAL,2892570306,484,2892570790,2913365195
2025-06-19 07:11:18,REAL,2892570790,488,2892571278,2913365683
2025-06-19 07:11:20,REAL,2892571278,479,2892571757,2913366162
2025-06-19 07:11:22,REAL,2892571757,489,2892572246,2913366651
2025-06-19 07:11:24,REAL,2892572246,490,2892572736,2913367141
2025-06-19 07:11:26,REAL,2892572736,534,2892573270,2913367675
2025-06-19 07:11:28,REAL,2892573270,491,2892573761,2913368166
2025-06-19 07:11:30,REAL,2892573761,485,2892574246,2913368651
2025-06-19 07:11:32,REAL,2892574246,482,2892574728,2913369133
2025-06-19 07:11:34,REAL,2892574728,489,2892575217,2913369622
2025-06-19 07:11:36,REAL,2892575217,545,2892575762,2913370167
2025-06-19 07:11:38,REAL,2892575762,483,2892576245,2913370650
2025-06-19 07:11:40,REAL,2892576245,483,2892576728,2913371133
2025-06-19 07:11:42,REAL,2892576728,484,2892577212,2913371617
2025-06-19 07:11:44,REAL,2892577212,475,2892577687,2913372092
2025-06-19 07:11:46,FAKE,2892577687,244,2892577931,2913372576
2025-06-19 07:11:48,FAKE,2892577931,243,2892578174,2913373062
2025-06-19 07:11:50,REAL,2892578174,483,2892578657,2913373545
2025-06-19 07:11:52,REAL,2892578657,482,2892579139,2913374027
2025-06-19 07:11:54,REAL,2892579139,480,2892579619,2913374507
2025-06-19 07:11:56,REAL,2892579619,478,2892580097,2913374985
2025-06-19 07:11:58,FAKE,2892580097,238,2892580335,2913375472
2025-06-19 07:12:00,REAL,2892580335,10257,2892590592,2913385729
2025-06-19 07:12:02,REAL,2892590592,9912,2892600504,2913395641
2025-06-19 07:12:04,FAKE,2892600504,241,2892600745,2913405902
2025-06-19 07:12:06,FAKE,2892600745,238,2892600983,2913416155
2025-06-19 07:12:08,FAKE,2892600983,244,2892601227,2913426410
2025-06-19 07:12:10,REAL,2892601227,10246,2892611473,2913436656
2025-06-19 07:12:12,FAKE,2892611473,241,2892611714,2913446970
2025-06-19 07:12:14,FAKE,2892611714,243,2892611957,2913454057
2025-06-19 07:12:16,REAL,2892611957,487,2892612444,2913454544
2025-06-19 07:12:18,REAL,2892612444,489,2892612933,2913455033
2025-06-19 07:12:20,REAL,2892612933,481,2892613414,2913455514
2025-06-19 07:12:22,REAL,2892613414,488,2892613902,2913456002
2025-06-19 07:12:24,FAKE,2892613902,244,2892614146,2913456478
2025-06-19 07:12:26,FAKE,2892614146,241,2892614387,2913456964
2025-06-19 07:12:28,REAL,2892614387,486,2892614873,2913457450
2025-06-19 07:12:30,REAL,2892614873,476,2892615349,2913457926
2025-06-19 07:12:32,FAKE,2892615349,243,2892615592,2913458420
2025-06-19 07:12:34,FAKE,2892615592,244,2892615836,2913458905
2025-06-19 07:12:36,REAL,2892615836,604,2892616440,2913459509
2025-06-19 07:12:38,REAL,2892616440,490,2892616930,2913459999
2025-06-19 07:12:40,REAL,2892616930,488,2892617418,2913460487
2025-06-19 07:12:42,REAL,2892617418,485,2892617903,2913460972
2025-06-19 07:12:44,REAL,2892617903,483,2892618386,2913461455
2025-06-19 07:12:46,REAL,2892618386,486,2892618872,2913461941
2025-06-19 07:12:48,FAKE,2892618872,241,2892619113,2913462426
2025-06-19 07:12:50,FAKE,2892619113,238,2892619351,2913462908
2025-06-19 07:12:52,REAL,2892619351,6044,2892625395,2913468952
2025-06-19 07:12:54,REAL,2892625395,13493,2892638888,2913482445
2025-06-19 07:12:56,REAL,2892638888,10320,2892649208,2913492765
2025-06-19 07:12:58,REAL,2892649208,10253,2892659461,2913503018
2025-06-19 07:13:00,REAL,2892659461,10257,2892669718,2913513275
2025-06-19 07:13:02,REAL,2892669718,10252,2892679970,2913523527
2025-06-19 07:13:04,REAL,2892679970,10253,2892690223,2913533780
2025-06-19 07:13:06,FAKE,2892690223,243,2892690466,2913544031
2025-06-19 07:13:08,REAL,2892690466,1275,2892691741,2913545306
2025-06-19 07:13:10,REAL,2892691741,476,2892692217,2913545782
2025-06-19 07:13:12,FAKE,2892692217,241,2892692458,2913546316
2025-06-19 07:13:14,REAL,2892692458,483,2892692941,2913546799
2025-06-19 07:13:16,REAL,2892692941,485,2892693426,2913547284
2025-06-19 07:13:18,REAL,2892693426,475,2892693901,2913547759
2025-06-19 07:13:20,REAL,2892693901,477,2892694378,2913548236
2025-06-19 07:13:22,FAKE,2892694378,243,2892694621,2913548712
2025-06-19 07:13:24,REAL,2892694621,5571,2892700192,2913554283
2025-06-19 07:13:26,FAKE,2892700192,243,2892700435,2913565802
2025-06-19 07:13:28,FAKE,2892700435,243,2892700678,2913576056
2025-06-19 07:13:30,REAL,2892700678,10251,2892710929,2913586307
2025-06-19 07:13:32,FAKE,2892710929,244,2892711173,2913596619
2025-06-19 07:13:34,REAL,2892711173,10255,2892721428,2913606874
2025-06-19 07:13:36,FAKE,2892721428,238,2892721666,2913617122
2025-06-19 07:13:38,REAL,2892721666,10318,2892731984,2913627440
2025-06-19 07:13:40,FAKE,2892731984,244,2892732228,2913628062
2025-06-19 07:13:42,FAKE,2892732228,243,2892732471,2913628546
2025-06-19 07:13:44,FAKE,2892732471,243,2892732714,2913629030
2025-06-19 07:13:46,FAKE,2892732714,238,2892732952,2913629574
2025-06-19 07:13:48,FAKE,2892732952,238,2892733190,2913630064
2025-06-19 07:13:50,FAKE,2892733190,238,2892733428,2913630554
2025-06-19 07:13:52,REAL,2892733428,485,2892733913,2913631039
2025-06-19 07:13:54,REAL,2892733913,489,2892734402,2913631528
2025-06-19 07:13:56,REAL,2892734402,6893,2892741295,2913638421
2025-06-19 07:13:58,REAL,2892741295,11241,2892752536,2913649662
2025-06-19 07:14:00,REAL,2892752536,10320,2892762856,2913659982
2025-06-19 07:14:02,REAL,2892762856,10253,2892773109,2913670235
2025-06-19 07:14:04,FAKE,2892773109,244,2892773353,2913680496
2025-06-19 07:14:06,REAL,2892773353,10248,2892783601,2913690744
2025-06-19 07:14:08,REAL,2892783601,10324,2892793925,2913701068
2025-06-19 07:14:10,REAL,2892793925,9837,2892803762,2913710905
2025-06-19 07:14:12,REAL,2892803762,488,2892804250,2913711393
2025-06-19 07:14:14,FAKE,2892804250,243,2892804493,2913711881
2025-06-19 07:14:16,FAKE,2892804493,241,2892804734,2913712363
2025-06-19 07:14:18,REAL,2892804734,485,2892805219,2913712848
2025-06-19 07:14:20,REAL,2892805219,489,2892805708,2913713337
2025-06-19 07:14:22,FAKE,2892805708,238,2892805946,2913713823
2025-06-19 07:14:24,REAL,2892805946,484,2892806430,2913714307
2025-06-19 07:14:26,REAL,2892806430,478,2892806908,2913714785
2025-06-19 07:14:28,REAL,2892806908,484,2892807392,2913715269
2025-06-19 07:14:30,REAL,2892807392,479,2892807871,2913715748
2025-06-19 07:14:32,FAKE,2892807871,244,2892808115,2913716230
2025-06-19 07:14:34,FAKE,2892808115,241,2892808356,2913716766
2025-06-19 07:14:36,FAKE,2892808356,243,2892808599,2913717306
2025-06-19 07:14:38,REAL,2892808599,478,2892809077,2913717784
2025-06-19 07:14:40,REAL,2892809077,487,2892809564,2913718271
2025-06-19 07:14:42,REAL,2892809564,494,2892810058,2913718765
2025-06-19 07:14:44,REAL,2892810058,479,2892810537,2913719244
2025-06-19 07:14:46,FAKE,2892810537,238,2892810775,2913719728
2025-06-19 07:14:48,REAL,2892810775,481,2892811256,2913720209
2025-06-19 07:14:50,FAKE,2892811256,238,2892811494,2913720691
2025-06-19 07:14:52,REAL,2892811494,485,2892811979,2913721176
2025-06-19 07:14:54,REAL,2892811979,477,2892812456,2913721653
2025-06-19 07:14:56,REAL,2892812456,477,2892812933,2913722130
2025-06-19 07:14:58,REAL,2892812933,481,2892813414,2913722611
2025-06-19 07:15:00,REAL,2892813414,8206,2892821620,2913730817
2025-06-19 07:15:02,REAL,2892821620,10849,2892832469,2913741666
2025-06-19 07:15:04,FAKE,2892832469,238,2892832707,2913751988
2025-06-19 07:15:06,FAKE,2892832707,244,2892832951,2913762242
2025-06-19 07:15:08,REAL,2892832951,10254,2892843205,2913772496
2025-06-19 07:15:10,FAKE,2892843205,238,2892843443,2913782818
2025-06-19 07:15:12,REAL,2892843443,10253,2892853696,2913793071
2025-06-19 07:15:14,FAKE,2892853696,244,2892853940,2913801612
2025-06-19 07:15:16,REAL,2892853940,477,2892854417,2913802089
2025-06-19 07:15:18,REAL,2892854417,487,2892854904,2913802576
2025-06-19 07:15:20,REAL,2892854904,488,2892855392,2913803064
2025-06-19 07:15:22,REAL,2892855392,549,2892855941,2913803613
2025-06-19 07:15:24,FAKE,2892855941,243,2892856184,2913804089
2025-06-19 07:15:26,REAL,2892856184,483,2892856667,2913804572
2025-06-19 07:15:28,REAL,2892856667,481,2892857148,2913805053
2025-06-19 07:15:30,REAL,2892857148,487,2892857635,2913805540
2025-06-19 07:15:32,REAL,2892857635,484,2892858119,2913806024
2025-06-19 07:15:34,REAL,2892858119,479,2892858598,2913806503
2025-06-19 07:15:36,REAL,2892858598,479,2892859077,2913806982
2025-06-19 07:15:38,REAL,2892859077,489,2892859566,2913807471
2025-06-19 07:15:40,FAKE,2892859566,243,2892859809,2913808006
2025-06-19 07:15:42,FAKE,2892859809,238,2892860047,2913808494
2025-06-19 07:15:44,REAL,2892860047,485,2892860532,2913808979
2025-06-19 07:15:46,REAL,2892860532,543,2892861075,2913809522
2025-06-19 07:15:48,FAKE,2892861075,243,2892861318,2913810002
2025-06-19 07:15:50,REAL,2892861318,490,2892861808,2913810492
2025-06-19 07:15:52,REAL,2892861808,494,2892862302,2913810986
2025-06-19 07:15:54,REAL,2892862302,489,2892862791,2913811475
2025-06-19 07:15:56,FAKE,2892862791,244,2892863035,2913811963
2025-06-19 07:15:58,REAL,2892863035,484,2892863519,2913812447
2025-06-19 07:16:00,FAKE,2892863519,238,2892863757,2913812936
2025-06-19 07:16:02,REAL,2892863757,478,2892864235,2913813414
2025-06-19 07:16:04,REAL,2892864235,9725,2892873960,2913823139
2025-06-19 07:16:06,REAL,2892873960,10451,2892884411,2913833590
2025-06-19 07:16:08,REAL,2892884411,10249,2892894660,2913843839
2025-06-19 07:16:10,REAL,2892894660,10381,2892905041,2913854220
2025-06-19 07:16:12,REAL,2892905041,10257,2892915298,2913864477
2025-06-19 07:16:14,REAL,2892915298,10252,2892925550,2913874729
2025-06-19 07:16:16,FAKE,2892925550,238,2892925788,2913885053
2025-06-19 07:16:18,REAL,2892925788,7279,2892933067,2913892332
2025-06-19 07:16:20,FAKE,2892933067,244,2892933311,2913892812
2025-06-19 07:16:22,FAKE,2892933311,243,2892933554,2913893296
2025-06-19 07:16:24,FAKE,2892933554,238,2892933792,2913898146
2025-06-19 07:16:26,FAKE,2892933792,243,2892934035,2913912236
2025-06-19 07:16:28,FAKE,2892934035,243,2892934278,2913922483
2025-06-19 07:16:30,REAL,2892934278,10251,2892944529,2913932734
2025-06-19 07:16:32,FAKE,2892944529,244,2892944773,2913943783
2025-06-19 07:16:34,REAL,2892944773,9578,2892954351,2913953361
2025-06-19 07:16:36,REAL,2892954351,10257,2892964608,2913963618
2025-06-19 07:16:38,REAL,2892964608,10259,2892974867,2913973877
2025-06-19 07:16:40,REAL,2892974867,2005,2892976872,2913975882
2025-06-19 07:16:42,REAL,2892976872,486,2892977358,2913976368
2025-06-19 07:16:44,FAKE,2892977358,241,2892977599,2913976852
2025-06-19 07:16:46,REAL,2892977599,475,2892978074,2913977327
2025-06-19 07:16:48,REAL,2892978074,485,2892978559,2913977812
2025-06-19 07:16:50,REAL,2892978559,488,2892979047,2913978300
2025-06-19 07:16:52,FAKE,2892979047,238,2892979285,2913978781
2025-06-19 07:16:54,FAKE,2892979285,244,2892979529,2913979262
2025-06-19 07:16:56,REAL,2892979529,545,2892980074,2913979807
2025-06-19 07:16:58,FAKE,2892980074,241,2892980315,2913980292
2025-06-19 07:17:00,REAL,2892980315,485,2892980800,2913980777
2025-06-19 07:17:02,FAKE,2892980800,238,2892981038,2913991767
2025-06-19 07:17:04,FAKE,2892981038,238,2892981276,2914002156
2025-06-19 07:17:06,FAKE,2892981276,241,2892981517,2914012416
2025-06-19 07:17:08,REAL,2892981517,10314,2892991831,2914022730
2025-06-19 07:17:10,REAL,2892991831,10247,2893002078,2914032977
2025-06-19 07:17:12,FAKE,2893002078,241,2893002319,2914043294
2025-06-19 07:17:14,FAKE,2893002319,238,2893002557,2914053544
2025-06-19 07:17:16,REAL,2893002557,6297,2893008854,2914059841
2025-06-19 07:17:18,REAL,2893008854,481,2893009335,2914060322
2025-06-19 07:17:20,FAKE,2893009335,238,2893009573,2914060857
2025-06-19 07:17:22,REAL,2893009573,485,2893010058,2914061342
2025-06-19 07:17:24,REAL,2893010058,492,2893010550,2914061834
2025-06-19 07:17:26,REAL,2893010550,483,2893011033,2914062317
2025-06-19 07:17:28,REAL,2893011033,476,2893011509,2914062793
2025-06-19 07:17:30,FAKE,2893011509,244,2893011753,2914063275
2025-06-19 07:17:32,REAL,2893011753,485,2893012238,2914063760
2025-06-19 07:17:34,REAL,2893012238,484,2893012722,2914064244
2025-06-19 07:17:36,REAL,2893012722,475,2893013197,2914064719
2025-06-19 07:17:38,REAL,2893013197,481,2893013678,2914065200
2025-06-19 07:17:40,REAL,2893013678,538,2893014216,2914065738
2025-06-19 07:17:42,REAL,2893014216,484,2893014700,2914066222
2025-06-19 07:17:44,REAL,2893014700,535,2893015235,2914066757
2025-06-19 07:17:46,FAKE,2893015235,238,2893015473,2914067243
2025-06-19 07:17:48,REAL,2893015473,488,2893015961,2914067731
2025-06-19 07:17:50,FAKE,2893015961,243,2893016204,2914068215
2025-06-19 07:17:52,REAL,2893016204,485,2893016689,2914068700
2025-06-19 07:17:54,FAKE,2893016689,238,2893016927,2914069190
2025-06-19 07:17:56,REAL,2893016927,489,2893017416,2914069679
2025-06-19 07:17:58,FAKE,2893017416,241,2893017657,2914070168
2025-06-19 07:18:00,REAL,2893017657,492,2893018149,2914070660
2025-06-19 07:18:02,REAL,2893018149,483,2893018632,2914071143
2025-06-19 07:18:04,FAKE,2893018632,244,2893018876,2914071620
2025-06-19 07:18:06,REAL,2893018876,482,2893019358,2914072102
2025-06-19 07:18:08,REAL,2893019358,536,2893019894,2914072638
2025-06-19 07:18:10,REAL,2893019894,487,2893020381,2914073125
2025-06-19 07:18:12,FAKE,2893020381,241,2893020622,2914073602
2025-06-19 07:18:14,FAKE,2893020622,238,2893020860,2914074082
2025-06-19 07:18:16,REAL,2893020860,15228,2893036088,2914089310
2025-06-19 07:18:18,REAL,2893036088,10313,2893046401,2914099623
2025-06-19 07:18:20,REAL,2893046401,10252,2893056653,2914109875
2025-06-19 07:18:22,FAKE,2893056653,243,2893056896,2914120194
2025-06-19 07:18:24,REAL,2893056896,10247,2893067143,2914130441
2025-06-19 07:18:26,REAL,2893067143,10260,2893077403,2914140701
2025-06-19 07:18:28,REAL,2893077403,10316,2893087719,2914151017
2025-06-19 07:18:30,FAKE,2893087719,243,2893087962,2914156178
2025-06-19 07:18:32,FAKE,2893087962,244,2893088206,2914156671
2025-06-19 07:18:34,REAL,2893088206,486,2893088692,2914157157
2025-06-19 07:18:36,FAKE,2893088692,243,2893088935,2914165390
2025-06-19 07:18:38,REAL,2893088935,13495,2893102430,2914178885
2025-06-19 07:18:40,REAL,2893102430,10251,2893112681,2914189136
2025-06-19 07:18:42,REAL,2893112681,10319,2893123000,2914199455
2025-06-19 07:18:44,REAL,2893123000,10254,2893133254,2914209709
2025-06-19 07:18:46,FAKE,2893133254,238,2893133492,2914219956
2025-06-19 07:18:48,REAL,2893133492,10314,2893143806,2914230270
2025-06-19 07:18:50,REAL,2893143806,9797,2893153603,2914240067
2025-06-19 07:18:52,REAL,2893153603,481,2893154084,2914240548
2025-06-19 07:18:54,REAL,2893154084,480,2893154564,2914241028
2025-06-19 07:18:56,FAKE,2893154564,238,2893154802,2914241518
2025-06-19 07:18:58,REAL,2893154802,484,2893155286,2914242002
2025-06-19 07:19:00,REAL,2893155286,483,2893155769,2914242485
2025-06-19 07:19:02,REAL,2893155769,476,2893156245,2914242961
2025-06-19 07:19:04,REAL,2893156245,484,2893156729,2914243445
2025-06-19 07:19:06,REAL,2893156729,533,2893157262,2914243978
2025-06-19 07:19:08,REAL,2893157262,487,2893157749,2914244465
2025-06-19 07:19:10,REAL,2893157749,477,2893158226,2914244942
2025-06-19 07:19:12,FAKE,2893158226,243,2893158469,2914245428
2025-06-19 07:19:14,REAL,2893158469,540,2893159009,2914245968
2025-06-19 07:19:16,FAKE,2893159009,244,2893159253,2914246453
2025-06-19 07:19:18,REAL,2893159253,480,2893159733,2914246933
2025-06-19 07:19:20,REAL,2893159733,478,2893160211,2914247411
2025-06-19 07:19:22,REAL,2893160211,478,2893160689,2914247889
2025-06-19 07:19:24,REAL,2893160689,486,2893161175,2914248375
2025-06-19 07:19:26,REAL,2893161175,487,2893161662,2914248862
2025-06-19 07:19:28,REAL,2893161662,476,2893162138,2914249338
2025-06-19 07:19:30,REAL,2893162138,480,2893162618,2914249818
2025-06-19 07:19:32,REAL,2893162618,485,2893163103,2914250303
2025-06-19 07:19:34,REAL,2893163103,476,2893163579,2914250779
2025-06-19 07:19:36,REAL,2893163579,492,2893164071,2914251271
2025-06-19 07:19:38,REAL,2893164071,482,2893164553,2914251753
2025-06-19 07:19:40,REAL,2893164553,484,2893165037,2914252237
2025-06-19 07:19:42,FAKE,2893165037,241,2893165278,2914252721
2025-06-19 07:19:44,REAL,2893165278,540,2893165818,2914253261
2025-06-19 07:19:46,REAL,2893165818,484,2893166302,2914253745
2025-06-19 07:19:48,REAL,2893166302,481,2893166783,2914254226
2025-06-19 07:19:50,REAL,2893166783,482,2893167265,2914254708
2025-06-19 07:19:52,FAKE,2893167265,243,2893167508,2914255194
2025-06-19 07:19:54,REAL,2893167508,482,2893167990,2914255676
2025-06-19 07:19:56,REAL,2893167990,485,2893168475,2914256161
2025-06-19 07:19:58,REAL,2893168475,538,2893169013,2914256699
2025-06-19 07:20:00,REAL,2893169013,487,2893169500,2914257186
2025-06-19 07:20:02,FAKE,2893169500,244,2893169744,2914257666
2025-06-19 07:20:04,REAL,2893169744,484,2893170228,2914258150
2025-06-19 07:20:06,FAKE,2893170228,244,2893170472,2914268666
2025-06-19 07:20:08,REAL,2893170472,11959,2893182431,2914280625
2025-06-19 07:20:10,REAL,2893182431,10257,2893192688,2914290882
2025-06-19 07:20:12,FAKE,2893192688,244,2893192932,2914301198
2025-06-19 07:20:14,FAKE,2893192932,243,2893193175,2914311440
2025-06-19 07:20:16,REAL,2893193175,10317,2893203492,2914321757
2025-06-19 07:20:18,FAKE,2893203492,241,2893203733,2914332002
2025-06-19 07:20:20,REAL,2893203733,8345,2893212078,2914340347
2025-06-19 07:20:22,REAL,2893212078,542,2893212620,2914340889
2025-06-19 07:20:24,REAL,2893212620,479,2893213099,2914341368
2025-06-19 07:20:26,REAL,2893213099,484,2893213583,2914341852
2025-06-19 07:20:28,FAKE,2893213583,241,2893213824,2914342335
2025-06-19 07:20:30,FAKE,2893213824,241,2893214065,2914342816
2025-06-19 07:20:32,REAL,2893214065,490,2893214555,2914343306
2025-06-19 07:20:34,REAL,2893214555,481,2893215036,2914343787
2025-06-19 07:20:36,FAKE,2893215036,244,2893215280,2914344275
2025-06-19 07:20:38,REAL,2893215280,10136,2893225416,2914354411
2025-06-19 07:20:40,REAL,2893225416,10580,2893235996,2914364991
2025-06-19 07:20:42,REAL,2893235996,10252,2893246248,2914375243
2025-06-19 07:20:44,REAL,2893246248,10247,2893256495,2914385490
2025-06-19 07:20:46,REAL,2893256495,10253,2893266748,2914395743
2025-06-19 07:20:48,REAL,2893266748,10316,2893277064,2914406059
2025-06-19 07:20:50,FAKE,2893277064,241,2893277305,2914416314
2025-06-19 07:20:52,REAL,2893277305,7610,2893284915,2914423924
2025-06-19 07:20:54,REAL,2893284915,490,2893285405,2914424414
2025-06-19 07:20:56,FAKE,2893285405,244,2893285649,2914424899
2025-06-19 07:20:58,REAL,2893285649,533,2893286182,2914425432
2025-06-19 07:21:00,FAKE,2893286182,243,2893286425,2914425920
2025-06-19 07:21:02,REAL,2893286425,474,2893286899,2914426394
2025-06-19 07:21:04,REAL,2893286899,483,2893287382,2914426877
2025-06-19 07:21:06,REAL,2893287382,494,2893287876,2914427371
2025-06-19 07:21:08,REAL,2893287876,484,2893288360,2914427855
2025-06-19 07:21:10,REAL,2893288360,487,2893288847,2914428342
2025-06-19 07:21:12,REAL,2893288847,483,2893289330,2914428825
2025-06-19 07:21:14,FAKE,2893289330,241,2893289571,2914429305
2025-06-19 07:21:16,REAL,2893289571,482,2893290053,2914429787
2025-06-19 07:21:18,REAL,2893290053,487,2893290540,2914430274
2025-06-19 07:21:20,REAL,2893290540,474,2893291014,2914430748
2025-06-19 07:21:22,REAL,2893291014,541,2893291555,2914431289
2025-06-19 07:21:24,FAKE,2893291555,244,2893291799,2914431776
2025-06-19 07:21:26,REAL,2893291799,486,2893292285,2914432262
2025-06-19 07:21:28,REAL,2893292285,476,2893292761,2914432738
2025-06-19 07:21:30,REAL,2893292761,486,2893293247,2914433224
2025-06-19 07:21:32,REAL,2893293247,492,2893293739,2914433716
2025-06-19 07:21:34,FAKE,2893293739,238,2893293977,2914434202
2025-06-19 07:21:36,REAL,2893293977,533,2893294510,2914434735
2025-06-19 07:21:38,REAL,2893294510,476,2893294986,2914435211
2025-06-19 07:21:40,REAL,2893294986,491,2893295477,2914435702
2025-06-19 07:21:42,REAL,2893295477,11385,2893306862,2914447087
2025-06-19 07:21:44,REAL,2893306862,10315,2893317177,2914457402
2025-06-19 07:21:46,REAL,2893317177,10321,2893327498,2914467723
2025-06-19 07:21:48,REAL,2893327498,10249,2893337747,2914477972
2025-06-19 07:21:50,REAL,2893337747,10247,2893347994,2914488219
2025-06-19 07:21:52,FAKE,2893347994,238,2893348232,2914498534
2025-06-19 07:21:54,REAL,2893348232,10258,2893358490,2914508792
2025-06-19 07:21:56,REAL,2893358490,6491,2893364981,2914515283
2025-06-19 07:21:58,REAL,2893364981,491,2893365472,2914515774
2025-06-19 07:22:00,FAKE,2893365472,241,2893365713,2914516252
2025-06-19 07:22:02,REAL,2893365713,494,2893366207,2914516746
2025-06-19 07:22:04,REAL,2893366207,481,2893366688,2914517227
2025-06-19 07:22:06,REAL,2893366688,492,2893367180,2914517719
2025-06-19 07:22:08,REAL,2893367180,484,2893367664,2914518203
2025-06-19 07:22:10,FAKE,2893367664,244,2893367908,2914518682
2025-06-19 07:22:12,REAL,2893367908,535,2893368443,2914519217
2025-06-19 07:22:14,FAKE,2893368443,244,2893368687,2914519699
2025-06-19 07:22:16,REAL,2893368687,477,2893369164,2914520176
2025-06-19 07:22:18,FAKE,2893369164,238,2893369402,2914520652
2025-06-19 07:22:20,REAL,2893369402,490,2893369892,2914521142
2025-06-19 07:22:22,FAKE,2893369892,243,2893370135,2914521629
2025-06-19 07:22:24,REAL,2893370135,480,2893370615,2914522109
2025-06-19 07:22:26,REAL,2893370615,547,2893371162,2914522656
2025-06-19 07:22:28,REAL,2893371162,487,2893371649,2914523143
2025-06-19 07:22:30,REAL,2893371649,486,2893372135,2914523629
2025-06-19 07:22:32,REAL,2893372135,485,2893372620,2914524114
2025-06-19 07:22:34,REAL,2893372620,482,2893373102,2914524596
2025-06-19 07:22:36,FAKE,2893373102,243,2893373345,2914525085
2025-06-19 07:22:38,REAL,2893373345,485,2893373830,2914525570
2025-06-19 07:22:40,FAKE,2893373830,243,2893374073,2914526046
2025-06-19 07:22:42,FAKE,2893374073,244,2893374317,2914526533
2025-06-19 07:22:44,FAKE,2893374317,238,2893374555,2914527016
2025-06-19 07:22:46,REAL,2893374555,493,2893375048,2914527509
2025-06-19 07:22:48,FAKE,2893375048,241,2893375289,2914527998
2025-06-19 07:22:50,REAL,2893375289,543,2893375832,2914528541
2025-06-19 07:22:52,REAL,2893375832,487,2893376319,2914529028
2025-06-19 07:22:54,FAKE,2893376319,241,2893376560,2914529513
2025-06-19 07:22:56,REAL,2893376560,490,2893377050,2914530003
2025-06-19 07:22:58,REAL,2893377050,478,2893377528,2914530481
2025-06-19 07:23:00,REAL,2893377528,484,2893378012,2914530965
2025-06-19 07:23:02,FAKE,2893378012,243,2893378255,2914531439
2025-06-19 07:23:04,FAKE,2893378255,241,2893378496,2914531929
2025-06-19 07:23:06,FAKE,2893378496,238,2893378734,2914532415
2025-06-19 07:23:08,FAKE,2893378734,238,2893378972,2914532907
2025-06-19 07:23:10,FAKE,2893378972,243,2893379215,2914533391
2025-06-19 07:23:12,REAL,2893379215,541,2893379756,2914533932
2025-06-19 07:23:14,REAL,2893379756,475,2893380231,2914534407
2025-06-19 07:23:16,REAL,2893380231,486,2893380717,2914534893
2025-06-19 07:23:18,REAL,2893380717,479,2893381196,2914535372
2025-06-19 07:23:20,REAL,2893381196,482,2893381678,2914535854
2025-06-19 07:23:22,REAL,2893381678,486,2893382164,2914536340
2025-06-19 07:23:24,REAL,2893382164,489,2893382653,2914536829
2025-06-19 07:23:26,REAL,2893382653,541,2893383194,2914537370
2025-06-19 07:23:28,REAL,2893383194,482,2893383676,2914537852
2025-06-19 07:23:30,REAL,2893383676,489,2893384165,2914538341
2025-06-19 07:23:32,REAL,2893384165,478,2893384643,2914538819
2025-06-19 07:23:34,REAL,2893384643,480,2893385123,2914539299
2025-06-19 07:23:36,REAL,2893385123,1216,2893386339,2914540515
2025-06-19 07:23:38,REAL,2893386339,14866,2893401205,2914555381
2025-06-19 07:23:40,REAL,2893401205,10255,2893411460,2914565636
2025-06-19 07:23:42,REAL,2893411460,10242,2893421702,2914575878
2025-06-19 07:23:44,REAL,2893421702,10249,2893431951,2914586127
2025-06-19 07:23:46,FAKE,2893431951,238,2893432189,2914596442
2025-06-19 07:23:48,REAL,2893432189,10258,2893442447,2914606700
2025-06-19 07:23:50,FAKE,2893442447,238,2893442685,2914616947
2025-06-19 07:23:52,REAL,2893442685,4568,2893447253,2914621515
2025-06-19 07:23:54,REAL,2893447253,475,2893447728,2914621990
2025-06-19 07:23:56,FAKE,2893447728,243,2893447971,2914622472
2025-06-19 07:23:58,FAKE,2893447971,241,2893448212,2914622952
2025-06-19 07:24:00,FAKE,2893448212,243,2893448455,2914623429
2025-06-19 07:24:02,REAL,2893448455,539,2893448994,2914623968
2025-06-19 07:24:04,REAL,2893448994,245,2893449239,2914624213
2025-06-19 07:24:06,REAL,2893449239,483,2893449722,2914624696
2025-06-19 07:24:08,REAL,2893449722,2208,2893451930,2914626904
2025-06-19 07:24:10,FAKE,2893451930,241,2893452171,2914638673
2025-06-19 07:24:12,REAL,2893452171,10248,2893462419,2914648921
2025-06-19 07:24:14,FAKE,2893462419,243,2893462662,2914659172
2025-06-19 07:24:16,REAL,2893462662,10311,2893472973,2914669483
2025-06-19 07:24:18,REAL,2893472973,10257,2893483230,2914679740
2025-06-19 07:24:20,REAL,2893483230,10251,2893493481,2914689991
2025-06-19 07:24:22,REAL,2893493481,10254,2893503735,2914700245
2025-06-19 07:24:24,FAKE,2893503735,244,2893503979,2914704224
2025-06-19 07:24:26,FAKE,2893503979,241,2893504220,2914704710
2025-06-19 07:24:28,REAL,2893504220,492,2893504712,2914705202
2025-06-19 07:24:30,FAKE,2893504712,241,2893504953,2914705691
2025-06-19 07:24:32,REAL,2893504953,477,2893505430,2914706168
2025-06-19 07:24:34,FAKE,2893505430,243,2893505673,2914706648
2025-06-19 07:24:36,REAL,2893505673,484,2893506157,2914707132
2025-06-19 07:24:38,REAL,2893506157,491,2893506648,2914707623
2025-06-19 07:24:40,REAL,2893506648,541,2893507189,2914708164
2025-06-19 07:24:42,REAL,2893507189,493,2893507682,2914708657
2025-06-19 07:24:44,FAKE,2893507682,241,2893507923,2914709142
2025-06-19 07:24:46,REAL,2893507923,481,2893508404,2914709623
2025-06-19 07:24:48,REAL,2893508404,478,2893508882,2914710101
2025-06-19 07:24:50,REAL,2893508882,476,2893509358,2914710577
2025-06-19 07:24:52,FAKE,2893509358,243,2893509601,2914711059
2025-06-19 07:24:54,REAL,2893509601,535,2893510136,2914711594
2025-06-19 07:24:56,FAKE,2893510136,243,2893510379,2914712076
2025-06-19 07:24:58,REAL,2893510379,479,2893510858,2914712555
2025-06-19 07:25:00,REAL,2893510858,484,2893511342,2914713039
2025-06-19 07:25:02,FAKE,2893511342,244,2893511586,2914713533
2025-06-19 07:25:04,REAL,2893511586,484,2893512070,2914714017
2025-06-19 07:25:06,REAL,2893512070,3260,2893515330,2914717277
2025-06-19 07:25:08,FAKE,2893515330,238,2893515568,2914730564
2025-06-19 07:25:10,FAKE,2893515568,244,2893515812,2914740807
2025-06-19 07:25:12,FAKE,2893515812,238,2893516050,2914751060
2025-06-19 07:25:14,REAL,2893516050,10318,2893526368,2914761378
2025-06-19 07:25:16,FAKE,2893526368,243,2893526611,2914771694
2025-06-19 07:25:18,REAL,2893526611,10322,2893536933,2914782016
2025-06-19 07:25:20,REAL,2893536933,10250,2893547183,2914792266
2025-06-19 07:25:22,REAL,2893547183,3053,2893550236,2914795319
2025-06-19 07:25:24,FAKE,2893550236,241,2893550477,2914795807
2025-06-19 07:25:26,REAL,2893550477,484,2893550961,2914796291
2025-06-19 07:25:28,FAKE,2893550961,243,2893551204,2914805971
2025-06-19 07:25:30,REAL,2893551204,10579,2893561783,2914816550
2025-06-19 07:25:32,REAL,2893561783,10314,2893572097,2914826864
2025-06-19 07:25:34,REAL,2893572097,10247,2893582344,2914837111
2025-06-19 07:25:36,REAL,2893582344,11944,2893594288,2914849055
2025-06-19 07:25:38,REAL,2893594288,8557,2893602845,2914857612
2025-06-19 07:25:40,REAL,2893602845,10256,2893613101,2914867868
2025-06-19 07:25:42,REAL,2893613101,7677,2893620778,2914875545
2025-06-19 07:25:44,REAL,2893620778,477,2893621255,2914876022
2025-06-19 07:25:46,REAL,2893621255,486,2893621741,2914876508
2025-06-19 07:25:48,REAL,2893621741,483,2893622224,2914876991
2025-06-19 07:25:50,REAL,2893622224,481,2893622705,2914877472
2025-06-19 07:25:52,REAL,2893622705,483,2893623188,2914877955
2025-06-19 07:25:54,FAKE,2893623188,238,2893623426,2914878502
2025-06-19 07:25:56,REAL,2893623426,479,2893623905,2914878981
2025-06-19 07:25:58,REAL,2893623905,485,2893624390,2914879466
2025-06-19 07:26:00,REAL,2893624390,10192,2893634582,2914889658
2025-06-19 07:26:02,FAKE,2893634582,238,2893634820,2914899972
2025-06-19 07:26:04,REAL,2893634820,10255,2893645075,2914910227
2025-06-19 07:26:06,REAL,2893645075,10315,2893655390,2914920542
2025-06-19 07:26:08,REAL,2893655390,10252,2893665642,2914930794
2025-06-19 07:26:10,REAL,2893665642,10325,2893675967,2914941119
2025-06-19 07:26:12,REAL,2893675967,10253,2893686220,2914951372
2025-06-19 07:26:14,FAKE,2893686220,238,2893686458,2914958322
2025-06-19 07:26:16,REAL,2893686458,478,2893686936,2914958800
2025-06-19 07:26:18,REAL,2893686936,490,2893687426,2914959290
2025-06-19 07:26:20,REAL,2893687426,487,2893687913,2914959777
2025-06-19 07:26:22,FAKE,2893687913,243,2893688156,2914960268
2025-06-19 07:26:24,REAL,2893688156,483,2893688639,2914960751
2025-06-19 07:26:26,REAL,2893688639,482,2893689121,2914961233
2025-06-19 07:26:28,REAL,2893689121,485,2893689606,2914961718
2025-06-19 07:26:30,REAL,2893689606,534,2893690140,2914962252
2025-06-19 07:26:32,REAL,2893690140,486,2893690626,2914962738
2025-06-19 07:26:34,REAL,2893690626,490,2893691116,2914963228
2025-06-19 07:26:36,FAKE,2893691116,241,2893691357,2914963714
2025-06-19 07:26:38,REAL,2893691357,484,2893691841,2914964198
2025-06-19 07:26:40,REAL,2893691841,544,2893692385,2914964742
2025-06-19 07:26:42,FAKE,2893692385,244,2893692629,2914965223
2025-06-19 07:26:44,REAL,2893692629,486,2893693115,2914965709
2025-06-19 07:26:46,FAKE,2893693115,244,2893693359,2914966193
2025-06-19 07:26:48,REAL,2893693359,493,2893693852,2914966686
2025-06-19 07:26:50,REAL,2893693852,482,2893694334,2914967168
2025-06-19 07:26:52,REAL,2893694334,485,2893694819,2914967653
2025-06-19 07:26:54,REAL,2893694819,480,2893695299,2914968133
2025-06-19 07:26:56,REAL,2893695299,490,2893695789,2914968623
2025-06-19 07:26:58,FAKE,2893695789,238,2893696027,2914969104
2025-06-19 07:27:00,FAKE,2893696027,244,2893696271,2914969587
2025-06-19 07:27:02,FAKE,2893696271,243,2893696514,2914970076
2025-06-19 07:27:04,FAKE,2893696514,244,2893696758,2914981585
2025-06-19 07:27:06,REAL,2893696758,10317,2893707075,2914991902
2025-06-19 07:27:08,REAL,2893707075,10316,2893717391,2915002218
2025-06-19 07:27:10,REAL,2893717391,10254,2893727645,2915012472
2025-06-19 07:27:12,REAL,2893727645,10257,2893737902,2915022729
2025-06-19 07:27:14,REAL,2893737902,10317,2893748219,2915033046
2025-06-19 07:27:16,FAKE,2893748219,244,2893748463,2915043306
2025-06-19 07:27:18,REAL,2893748463,5765,2893754228,2915049071
2025-06-19 07:27:20,REAL,2893754228,482,2893754710,2915049553
2025-06-19 07:27:22,REAL,2893754710,478,2893755188,2915050031
2025-06-19 07:27:24,FAKE,2893755188,244,2893755432,2915050510
2025-06-19 07:27:26,FAKE,2893755432,238,2893755670,2915051003
2025-06-19 07:27:28,FAKE,2893755670,238,2893755908,2915051491
2025-06-19 07:27:30,REAL,2893755908,476,2893756384,2915051967
2025-06-19 07:27:32,REAL,2893756384,478,2893756862,2915052445
2025-06-19 07:27:34,REAL,2893756862,485,2893757347,2915052930
2025-06-19 07:27:36,FAKE,2893757347,238,2893757585,2915064905
2025-06-19 07:27:38,FAKE,2893757585,244,2893757829,2915075158
2025-06-19 07:27:40,REAL,2893757829,10323,2893768152,2915085481
2025-06-19 07:27:42,REAL,2893768152,10258,2893778410,2915095739
2025-06-19 07:27:44,REAL,2893778410,10311,2893788721,2915106050
2025-06-19 07:27:46,REAL,2893788721,10318,2893799039,2915116368
2025-06-19 07:27:48,FAKE,2893799039,244,2893799283,2915126622
2025-06-19 07:27:50,REAL,2893799283,5106,2893804389,2915131728
2025-06-19 07:27:52,REAL,2893804389,488,2893804877,2915132216
2025-06-19 07:27:54,FAKE,2893804877,238,2893805115,2915132700
2025-06-19 07:27:56,REAL,2893805115,483,2893805598,2915133183
2025-06-19 07:27:58,FAKE,2893805598,244,2893805842,2915133669
2025-06-19 07:28:00,REAL,2893805842,485,2893806327,2915134154
2025-06-19 07:28:02,REAL,2893806327,486,2893806813,2915134640
2025-06-19 07:28:04,REAL,2893806813,484,2893807297,2915135124
2025-06-19 07:28:06,FAKE,2893807297,243,2893807540,2915135602
2025-06-19 07:28:08,REAL,2893807540,486,2893808026,2915136088
2025-06-19 07:28:10,REAL,2893808026,477,2893808503,2915136565
2025-06-19 07:28:12,REAL,2893808503,491,2893808994,2915137056
2025-06-19 07:28:14,REAL,2893808994,485,2893809479,2915137541
2025-06-19 07:28:16,REAL,2893809479,539,2893810018,2915138080
2025-06-19 07:28:18,REAL,2893810018,484,2893810502,2915138564
2025-06-19 07:28:20,REAL,2893810502,541,2893811043,2915139105
2025-06-19 07:28:22,REAL,2893811043,488,2893811531,2915139593
2025-06-19 07:28:24,REAL,2893811531,491,2893812022,2915140084
2025-06-19 07:28:26,FAKE,2893812022,238,2893812260,2915140574
2025-06-19 07:28:28,FAKE,2893812260,241,2893812501,2915147995
2025-06-19 07:28:30,FAKE,2893812501,241,2893812742,2915159255
2025-06-19 07:28:32,REAL,2893812742,10254,2893822996,2915169509
2025-06-19 07:28:34,REAL,2893822996,10247,2893833243,2915179756
2025-06-19 07:28:36,FAKE,2893833243,238,2893833481,2915190080
2025-06-19 07:28:38,FAKE,2893833481,243,2893833724,2915200322
2025-06-19 07:28:40,FAKE,2893833724,238,2893833962,2915210645
2025-06-19 07:28:42,REAL,2893833962,9129,2893843091,2915219774
2025-06-19 07:28:44,FAKE,2893843091,241,2893843332,2915220259
2025-06-19 07:28:46,REAL,2893843332,486,2893843818,2915220745
2025-06-19 07:28:48,FAKE,2893843818,241,2893844059,2915221232
2025-06-19 07:28:50,FAKE,2893844059,238,2893844297,2915221723
2025-06-19 07:28:52,REAL,2893844297,489,2893844786,2915222212
2025-06-19 07:28:54,REAL,2893844786,483,2893845269,2915222695
2025-06-19 07:28:56,REAL,2893845269,475,2893845744,2915223170
2025-06-19 07:28:58,REAL,2893845744,491,2893846235,2915223661
2025-06-19 07:29:00,REAL,2893846235,491,2893846726,2915224152
2025-06-19 07:29:02,REAL,2893846726,484,2893847210,2915224636
2025-06-19 07:29:04,REAL,2893847210,478,2893847688,2915225114
2025-06-19 07:29:06,FAKE,2893847688,241,2893847929,2915225607
2025-06-19 07:29:08,REAL,2893847929,543,2893848472,2915226150
2025-06-19 07:29:10,FAKE,2893848472,241,2893848713,2915226690
2025-06-19 07:29:12,REAL,2893848713,476,2893849189,2915227166
2025-06-19 07:29:14,REAL,2893849189,480,2893849669,2915227646
2025-06-19 07:29:16,FAKE,2893849669,243,2893849912,2915228127
2025-06-19 07:29:18,FAKE,2893849912,238,2893850150,2915228618
2025-06-19 07:29:20,FAKE,2893850150,243,2893850393,2915229099
2025-06-19 07:29:22,REAL,2893850393,486,2893850879,2915229585
2025-06-19 07:29:24,REAL,2893850879,483,2893851362,2915230068
2025-06-19 07:29:26,REAL,2893851362,492,2893851854,2915230560
2025-06-19 07:29:28,REAL,2893851854,483,2893852337,2915231043
2025-06-19 07:29:30,REAL,2893852337,480,2893852817,2915231523
2025-06-19 07:29:32,REAL,2893852817,482,2893853299,2915232005
2025-06-19 07:29:34,REAL,2893853299,485,2893853784,2915232490
2025-06-19 07:29:36,REAL,2893853784,481,2893854265,2915232971
2025-06-19 07:29:38,FAKE,2893854265,241,2893854506,2915233461
2025-06-19 07:29:40,REAL,2893854506,478,2893854984,2915233939
2025-06-19 07:29:42,REAL,2893854984,487,2893855471,2915234426
2025-06-19 07:29:44,REAL,2893855471,484,2893855955,2915234910
2025-06-19 07:29:46,FAKE,2893855955,238,2893856193,2915235394
2025-06-19 07:29:48,REAL,2893856193,476,2893856669,2915235870
2025-06-19 07:29:50,REAL,2893856669,541,2893857210,2915236411
2025-06-19 07:29:52,FAKE,2893857210,241,2893857451,2915247201
2025-06-19 07:29:54,REAL,2893857451,11907,2893869358,2915259108
2025-06-19 07:29:56,FAKE,2893869358,244,2893869602,2915269417
2025-06-19 07:29:58,REAL,2893869602,10314,2893879916,2915279731
2025-06-19 07:30:00,FAKE,2893879916,243,2893880159,2915290050
2025-06-19 07:30:02,FAKE,2893880159,241,2893880400,2915300304
2025-06-19 07:30:04,REAL,2893880400,10319,2893890719,2915310623
2025-06-19 07:30:06,FAKE,2893890719,243,2893890962,2915318570
2025-06-19 07:30:08,REAL,2893890962,484,2893891446,2915319054
2025-06-19 07:30:10,REAL,2893891446,488,2893891934,2915319542
2025-06-19 07:30:12,FAKE,2893891934,244,2893892178,2915320032
2025-06-19 07:30:14,FAKE,2893892178,243,2893892421,2915320521
2025-06-19 07:30:16,REAL,2893892421,484,2893892905,2915321005
2025-06-19 07:30:18,REAL,2893892905,481,2893893386,2915321486
2025-06-19 07:30:20,REAL,2893893386,544,2893893930,2915322030
2025-06-19 07:30:22,REAL,2893893930,485,2893894415,2915322515
2025-06-19 07:30:24,REAL,2893894415,484,2893894899,2915322999
2025-06-19 07:30:26,FAKE,2893894899,238,2893895137,2915323482
2025-06-19 07:30:28,REAL,2893895137,475,2893895612,2915323957
2025-06-19 07:30:30,REAL,2893895612,478,2893896090,2915324435
2025-06-19 07:30:32,FAKE,2893896090,243,2893896333,2915324922
2025-06-19 07:30:34,REAL,2893896333,488,2893896821,2915325410
2025-06-19 07:30:36,REAL,2893896821,482,2893897303,2915325892
2025-06-19 07:30:38,FAKE,2893897303,244,2893897547,2915326373
2025-06-19 07:30:40,FAKE,2893897547,243,2893897790,2915326854
2025-06-19 07:30:42,REAL,2893897790,479,2893898269,2915327333
2025-06-19 07:30:44,FAKE,2893898269,244,2893898513,2915331849
2025-06-19 07:30:46,REAL,2893898513,11317,2893909830,2915343166
2025-06-19 07:30:48,REAL,2893909830,10373,2893920203,2915353539
2025-06-19 07:30:50,REAL,2893920203,10250,2893930453,2915363789
2025-06-19 07:30:52,REAL,2893930453,10254,2893940707,2915374043
2025-06-19 07:30:54,REAL,2893940707,10262,2893950969,2915384305
2025-06-19 07:30:56,FAKE,2893950969,244,2893951213,2915394623
2025-06-19 07:30:58,REAL,2893951213,10254,2893961467,2915404877
2025-06-19 07:31:00,REAL,2893961467,2063,2893963530,2915406940
2025-06-19 07:31:02,FAKE,2893963530,244,2893963774,2915407424
2025-06-19 07:31:04,REAL,2893963774,490,2893964264,2915407914
2025-06-19 07:31:06,REAL,2893964264,10785,2893975049,2915418699
2025-06-19 07:31:08,REAL,2893975049,10392,2893985441,2915429091
2025-06-19 07:31:10,REAL,2893985441,10255,2893995696,2915439346
2025-06-19 07:31:12,FAKE,2893995696,244,2893995940,2915449596
2025-06-19 07:31:14,REAL,2893995940,10323,2894006263,2915459919
2025-06-19 07:31:16,REAL,2894006263,10244,2894016507,2915470163
2025-06-19 07:31:18,FAKE,2894016507,244,2894016751,2915480416
2025-06-19 07:31:20,REAL,2894016751,6619,2894023370,2915487035
2025-06-19 07:31:22,REAL,2894023370,484,2894023854,2915487519
2025-06-19 07:31:24,REAL,2894023854,488,2894024342,2915488007
2025-06-19 07:31:26,FAKE,2894024342,241,2894024583,2915488483
2025-06-19 07:31:28,FAKE,2894024583,244,2894024827,2915488964
2025-06-19 07:31:30,REAL,2894024827,489,2894025316,2915489453
2025-06-19 07:31:32,REAL,2894025316,478,2894025794,2915489931
2025-06-19 07:31:34,REAL,2894025794,481,2894026275,2915490412
2025-06-19 07:31:36,REAL,2894026275,536,2894026811,2915490948
2025-06-19 07:31:38,FAKE,2894026811,243,2894027054,2915491493
2025-06-19 07:31:40,REAL,2894027054,479,2894027533,2915491972
2025-06-19 07:31:42,REAL,2894027533,484,2894028017,2915492456
2025-06-19 07:31:44,REAL,2894028017,482,2894028499,2915492938
2025-06-19 07:31:46,FAKE,2894028499,243,2894028742,2915493426
2025-06-19 07:31:48,FAKE,2894028742,241,2894028983,2915493910
2025-06-19 07:31:50,REAL,2894028983,486,2894029469,2915494396
2025-06-19 07:31:52,FAKE,2894029469,243,2894029712,2915494887
2025-06-19 07:31:54,REAL,2894029712,481,2894030193,2915495368
2025-06-19 07:31:56,REAL,2894030193,487,2894030680,2915495855
2025-06-19 07:31:58,REAL,2894030680,491,2894031171,2915496346
2025-06-19 07:32:00,FAKE,2894031171,238,2894031409,2915496834
2025-06-19 07:32:02,REAL,2894031409,481,2894031890,2915497315
2025-06-19 07:32:04,REAL,2894031890,484,2894032374,2915497799
2025-06-19 07:32:06,FAKE,2894032374,238,2894032612,2915498288
2025-06-19 07:32:08,FAKE,2894032612,241,2894032853,2915504312
2025-06-19 07:32:10,FAKE,2894032853,238,2894033091,2915515494
2025-06-19 07:32:12,FAKE,2894033091,243,2894033334,2915525736
2025-06-19 07:32:14,REAL,2894033334,10321,2894043655,2915536057
2025-06-19 07:32:16,FAKE,2894043655,243,2894043898,2915546303
2025-06-19 07:32:18,REAL,2894043898,10255,2894054153,2915556558
2025-06-19 07:32:20,REAL,2894054153,10312,2894064465,2915566870
2025-06-19 07:32:22,FAKE,2894064465,241,2894064706,2915577115
2025-06-19 07:32:24,REAL,2894064706,815,2894065521,2915577930
2025-06-19 07:32:26,FAKE,2894065521,238,2894065759,2915578422
2025-06-19 07:32:28,REAL,2894065759,545,2894066304,2915578967
2025-06-19 07:32:30,REAL,2894066304,492,2894066796,2915579459
2025-06-19 07:32:32,REAL,2894066796,482,2894067278,2915579941
2025-06-19 07:32:34,REAL,2894067278,480,2894067758,2915580421
2025-06-19 07:32:36,REAL,2894067758,487,2894068245,2915580908
2025-06-19 07:32:38,REAL,2894068245,535,2894068780,2915581443
2025-06-19 07:32:40,REAL,2894068780,6696,2894075476,2915588139
2025-06-19 07:32:42,REAL,2894075476,11056,2894086532,2915599195
2025-06-19 07:32:44,FAKE,2894086532,243,2894086775,2915609449
2025-06-19 07:32:46,FAKE,2894086775,241,2894087016,2915619765
2025-06-19 07:32:48,REAL,2894087016,10257,2894097273,2915630022
2025-06-19 07:32:50,REAL,2894097273,10316,2894107589,2915640338
2025-06-19 07:32:52,FAKE,2894107589,243,2894107832,2915650583
2025-06-19 07:32:54,REAL,2894107832,9916,2894117748,2915660499
2025-06-19 07:32:56,REAL,2894117748,481,2894118229,2915660980
2025-06-19 07:32:58,FAKE,2894118229,241,2894118470,2915661460
2025-06-19 07:33:00,REAL,2894118470,1085,2894119555,2915662545
2025-06-19 07:33:02,REAL,2894119555,12165,2894131720,2915674710
2025-06-19 07:33:04,REAL,2894131720,10323,2894142043,2915685033
2025-06-19 07:33:06,REAL,2894142043,10254,2894152297,2915695287
2025-06-19 07:33:08,FAKE,2894152297,243,2894152540,2915705548
2025-06-19 07:33:10,REAL,2894152540,10322,2894162862,2915715870
2025-06-19 07:33:12,FAKE,2894162862,243,2894163105,2915726119
2025-06-19 07:33:14,REAL,2894163105,10245,2894173350,2915736364
2025-06-19 07:33:16,FAKE,2894173350,241,2894173591,2915741146
2025-06-19 07:33:18,REAL,2894173591,540,2894174131,2915741686
2025-06-19 07:33:20,REAL,2894174131,478,2894174609,2915742164
2025-06-19 07:33:22,REAL,2894174609,488,2894175097,2915742652
2025-06-19 07:33:24,REAL,2894175097,483,2894175580,2915743135
2025-06-19 07:33:26,FAKE,2894175580,243,2894175823,2915743620
2025-06-19 07:33:28,REAL,2894175823,489,2894176312,2915744109
2025-06-19 07:33:30,REAL,2894176312,536,2894176848,2915744645
2025-06-19 07:33:32,REAL,2894176848,483,2894177331,2915745128
2025-06-19 07:33:34,REAL,2894177331,487,2894177818,2915745615
2025-06-19 07:33:36,REAL,2894177818,484,2894178302,2915746099
2025-06-19 07:33:38,FAKE,2894178302,243,2894178545,2915746586
2025-06-19 07:33:40,REAL,2894178545,481,2894179026,2915747067
2025-06-19 07:33:42,REAL,2894179026,494,2894179520,2915747561
2025-06-19 07:33:44,FAKE,2894179520,241,2894179761,2915748045
2025-06-19 07:33:46,REAL,2894179761,484,2894180245,2915748529
2025-06-19 07:33:48,REAL,2894180245,485,2894180730,2915749014
2025-06-19 07:33:50,REAL,2894180730,488,2894181218,2915749502
2025-06-19 07:33:52,FAKE,2894181218,241,2894181459,2915749987
2025-06-19 07:33:54,REAL,2894181459,484,2894181943,2915750471
2025-06-19 07:33:56,REAL,2894181943,493,2894182436,2915750964
2025-06-19 07:33:58,REAL,2894182436,488,2894182924,2915751452
2025-06-19 07:34:00,REAL,2894182924,478,2894183402,2915751930
2025-06-19 07:34:02,REAL,2894183402,539,2894183941,2915752469
2025-06-19 07:34:04,REAL,2894183941,9803,2894193744,2915762272
2025-06-19 07:34:06,REAL,2894193744,12088,2894205832,2915774360
2025-06-19 07:34:08,REAL,2894205832,10251,2894216083,2915784611
2025-06-19 07:34:10,REAL,2894216083,10455,2894226538,2915795066
2025-06-19 07:34:12,FAKE,2894226538,244,2894226782,2915805183
2025-06-19 07:34:14,REAL,2894226782,10259,2894237041,2915815442
2025-06-19 07:34:16,REAL,2894237041,10256,2894247297,2915825698
2025-06-19 07:34:18,REAL,2894247297,8727,2894256024,2915834425
2025-06-19 07:34:20,REAL,2894256024,486,2894256510,2915834911
2025-06-19 07:34:22,FAKE,2894256510,238,2894256748,2915835395
2025-06-19 07:34:24,FAKE,2894256748,238,2894256986,2915835879
2025-06-19 07:34:26,REAL,2894256986,492,2894257478,2915836371
2025-06-19 07:34:28,FAKE,2894257478,244,2894257722,2915836850
2025-06-19 07:34:30,REAL,2894257722,482,2894258204,2915837332
2025-06-19 07:34:32,REAL,2894258204,550,2894258754,2915837882
2025-06-19 07:34:34,REAL,2894258754,479,2894259233,2915838361
2025-06-19 07:34:36,REAL,2894259233,484,2894259717,2915838845
2025-06-19 07:34:38,REAL,2894259717,483,2894260200,2915839328
2025-06-19 07:34:40,REAL,2894260200,482,2894260682,2915839810
2025-06-19 07:34:42,REAL,2894260682,546,2894261228,2915840356
2025-06-19 07:34:44,FAKE,2894261228,244,2894261472,2915840845
2025-06-19 07:34:46,REAL,2894261472,479,2894261951,2915841324
2025-06-19 07:34:48,REAL,2894261951,490,2894262441,2915841814
2025-06-19 07:34:50,FAKE,2894262441,243,2894262684,2915842292
2025-06-19 07:34:52,FAKE,2894262684,244,2894262928,2915842767
2025-06-19 07:34:54,REAL,2894262928,487,2894263415,2915843254
2025-06-19 07:34:56,REAL,2894263415,481,2894263896,2915843735
2025-06-19 07:34:58,REAL,2894263896,479,2894264375,2915844214
2025-06-19 07:35:00,REAL,2894264375,479,2894264854,2915844693
2025-06-19 07:35:02,REAL,2894264854,476,2894265330,2915845169
2025-06-19 07:35:04,REAL,2894265330,479,2894265809,2915845648
2025-06-19 07:35:06,REAL,2894265809,486,2894266295,2915846134
2025-06-19 07:35:08,REAL,2894266295,9333,2894275628,2915855467
2025-06-19 07:35:10,REAL,2894275628,10646,2894286274,2915866113
2025-06-19 07:35:12,FAKE,2894286274,241,2894286515,2915876374
2025-06-19 07:35:14,REAL,2894286515,10255,2894296770,2915886629
2025-06-19 07:35:16,REAL,2894296770,10309,2894307079,2915896938
2025-06-19 07:35:18,FAKE,2894307079,243,2894307322,2915907190
2025-06-19 07:35:20,FAKE,2894307322,238,2894307560,2915917517
2025-06-19 07:35:22,FAKE,2894307560,243,2894307803,2915924934
2025-06-19 07:35:24,REAL,2894307803,488,2894308291,2915925422
2025-06-19 07:35:26,REAL,2894308291,479,2894308770,2915925901
2025-06-19 07:35:28,REAL,2894308770,488,2894309258,2915926389
2025-06-19 07:35:30,FAKE,2894309258,244,2894309502,2915926868
2025-06-19 07:35:32,FAKE,2894309502,238,2894309740,2915927354
2025-06-19 07:35:34,FAKE,2894309740,244,2894309984,2915927840
2025-06-19 07:35:36,FAKE,2894309984,238,2894310222,2915928322
2025-06-19 07:35:38,FAKE,2894310222,244,2894310466,2915928806
2025-06-19 07:35:40,REAL,2894310466,10860,2894321326,2915939666
2025-06-19 07:35:42,FAKE,2894321326,244,2894321570,2915950181
2025-06-19 07:35:44,FAKE,2894321570,243,2894321813,2915960497
2025-06-19 07:35:46,REAL,2894321813,10248,2894332061,2915970745
2025-06-19 07:35:48,REAL,2894332061,10247,2894342308,2915980992
2025-06-19 07:35:50,REAL,2894342308,10379,2894352687,2915991371
2025-06-19 07:35:52,FAKE,2894352687,243,2894352930,2916001622
2025-06-19 07:35:54,FAKE,2894352930,238,2894353168,2916008441
2025-06-19 07:35:56,REAL,2894353168,486,2894353654,2916008927
2025-06-19 07:35:58,REAL,2894353654,494,2894354148,2916009421
2025-06-19 07:36:00,REAL,2894354148,483,2894354631,2916009904
2025-06-19 07:36:02,REAL,2894354631,490,2894355121,2916010394
2025-06-19 07:36:04,REAL,2894355121,483,2894355604,2916010877
2025-06-19 07:36:06,REAL,2894355604,483,2894356087,2916011360
2025-06-19 07:36:08,REAL,2894356087,485,2894356572,2916011845
2025-06-19 07:36:10,FAKE,2894356572,241,2894356813,2916012333
2025-06-19 07:36:12,FAKE,2894356813,244,2894357057,2916012812
2025-06-19 07:36:14,REAL,2894357057,484,2894357541,2916013296
2025-06-19 07:36:16,FAKE,2894357541,241,2894357782,2916013775
2025-06-19 07:36:18,REAL,2894357782,488,2894358270,2916014263
2025-06-19 07:36:20,FAKE,2894358270,241,2894358511,2916014745
2025-06-19 07:36:22,REAL,2894358511,479,2894358990,2916015224
2025-06-19 07:36:24,REAL,2894358990,491,2894359481,2916015715
2025-06-19 07:36:26,REAL,2894359481,593,2894360074,2916016308
2025-06-19 07:36:28,REAL,2894360074,488,2894360562,2916016796
2025-06-19 07:36:30,REAL,2894360562,476,2894361038,2916017272
2025-06-19 07:36:32,REAL,2894361038,477,2894361515,2916017749
2025-06-19 07:36:34,REAL,2894361515,482,2894361997,2916018231
2025-06-19 07:36:36,REAL,2894361997,481,2894362478,2916018712
2025-06-19 07:36:38,REAL,2894362478,489,2894362967,2916019201
2025-06-19 07:36:40,REAL,2894362967,484,2894363451,2916019685
2025-06-19 07:36:42,REAL,2894363451,487,2894363938,2916020172
2025-06-19 07:36:44,REAL,2894363938,486,2894364424,2916020658
2025-06-19 07:36:46,REAL,2894364424,485,2894364909,2916021143
2025-06-19 07:36:48,REAL,2894364909,488,2894365397,2916021631
2025-06-19 07:36:50,FAKE,2894365397,244,2894365641,2916022116
2025-06-19 07:36:52,REAL,2894365641,482,2894366123,2916022598
2025-06-19 07:36:54,FAKE,2894366123,241,2894366364,2916023081
2025-06-19 07:36:56,FAKE,2894366364,241,2894366605,2916023568
2025-06-19 07:36:58,REAL,2894366605,481,2894367086,2916024049
2025-06-19 07:37:00,REAL,2894367086,543,2894367629,2916024592
2025-06-19 07:37:02,FAKE,2894367629,241,2894367870,2916025076
2025-06-19 07:37:04,REAL,2894367870,474,2894368344,2916025550
2025-06-19 07:37:06,FAKE,2894368344,238,2894368582,2916026034
2025-06-19 07:37:08,FAKE,2894368582,244,2894368826,2916026522
2025-06-19 07:37:10,REAL,2894368826,481,2894369307,2916027003
2025-06-19 07:37:12,REAL,2894369307,489,2894369796,2916027492
2025-06-19 07:37:14,REAL,2894369796,538,2894370334,2916028030
2025-06-19 07:37:16,FAKE,2894370334,244,2894370578,2916028510
2025-06-19 07:37:18,FAKE,2894370578,241,2894370819,2916028997
2025-06-19 07:37:20,REAL,2894370819,492,2894371311,2916029489
2025-06-19 07:37:22,REAL,2894371311,485,2894371796,2916029974
2025-06-19 07:37:24,REAL,2894371796,478,2894372274,2916030452
2025-06-19 07:37:26,REAL,2894372274,479,2894372753,2916030931
2025-06-19 07:37:28,REAL,2894372753,484,2894373237,2916031415
2025-06-19 07:37:30,REAL,2894373237,490,2894373727,2916031905
2025-06-19 07:37:32,REAL,2894373727,476,2894374203,2916032381
2025-06-19 07:37:34,REAL,2894374203,487,2894374690,2916032868
2025-06-19 07:37:36,REAL,2894374690,542,2894375232,2916033410
2025-06-19 07:37:38,REAL,2894375232,491,2894375723,2916033901
2025-06-19 07:37:40,REAL,2894375723,478,2894376201,2916034379
2025-06-19 07:37:42,REAL,2894376201,485,2894376686,2916034864
2025-06-19 07:37:44,REAL,2894376686,483,2894377169,2916035347
2025-06-19 07:37:46,REAL,2894377169,487,2894377656,2916035834
2025-06-19 07:37:48,REAL,2894377656,486,2894378142,2916036320
2025-06-19 07:37:50,REAL,2894378142,493,2894378635,2916036813
2025-06-19 07:37:52,REAL,2894378635,475,2894379110,2916037288
2025-06-19 07:37:54,FAKE,2894379110,244,2894379354,2916037771
2025-06-19 07:37:56,REAL,2894379354,491,2894379845,2916038262
2025-06-19 07:37:58,REAL,2894379845,479,2894380324,2916038741
2025-06-19 07:38:00,REAL,2894380324,478,2894380802,2916039219
2025-06-19 07:38:02,REAL,2894380802,536,2894381338,2916039755
2025-06-19 07:38:04,REAL,2894381338,488,2894381826,2916040243
2025-06-19 07:38:06,FAKE,2894381826,238,2894382064,2916040730
2025-06-19 07:38:08,REAL,2894382064,490,2894382554,2916041220
2025-06-19 07:38:10,FAKE,2894382554,241,2894382795,2916041701
2025-06-19 07:38:12,FAKE,2894382795,241,2894383036,2916042245
2025-06-19 07:38:14,REAL,2894383036,478,2894383514,2916042723
2025-06-19 07:38:16,REAL,2894383514,1616,2894385130,2916044339
2025-06-19 07:38:18,REAL,2894385130,12494,2894397624,2916056833
2025-06-19 07:38:20,REAL,2894397624,10257,2894407881,2916067090
2025-06-19 07:38:22,FAKE,2894407881,241,2894408122,2916077339
2025-06-19 07:38:24,REAL,2894408122,10255,2894418377,2916087594
2025-06-19 07:38:26,FAKE,2894418377,243,2894418620,2916097844
2025-06-19 07:38:28,FAKE,2894418620,244,2894418864,2916108162
2025-06-19 07:38:30,REAL,2894418864,10183,2894429047,2916118345
2025-06-19 07:38:32,REAL,2894429047,4368,2894433415,2916122713
2025-06-19 07:38:34,FAKE,2894433415,243,2894433658,2916123197
2025-06-19 07:38:36,REAL,2894433658,488,2894434146,2916123685
2025-06-19 07:38:38,REAL,2894434146,7823,2894441969,2916131508
2025-06-19 07:38:40,FAKE,2894441969,243,2894442212,2916142355
2025-06-19 07:38:42,FAKE,2894442212,241,2894442453,2916153137
2025-06-19 07:38:44,FAKE,2894442453,238,2894442691,2916162928
2025-06-19 07:38:46,REAL,2894442691,10305,2894452996,2916173233
2025-06-19 07:38:48,REAL,2894452996,10260,2894463256,2916183493
2025-06-19 07:38:50,REAL,2894463256,10317,2894473573,2916193810
2025-06-19 07:38:52,FAKE,2894473573,238,2894473811,2916202738
2025-06-19 07:38:54,REAL,2894473811,491,2894474302,2916203229
2025-06-19 07:38:56,REAL,2894474302,475,2894474777,2916203704
2025-06-19 07:38:58,FAKE,2894474777,238,2894475015,2916204189
2025-06-19 07:39:00,REAL,2894475015,486,2894475501,2916204675
2025-06-19 07:39:02,FAKE,2894475501,243,2894475744,2916205162
2025-06-19 07:39:04,REAL,2894475744,479,2894476223,2916205641
2025-06-19 07:39:06,REAL,2894476223,481,2894476704,2916206122
2025-06-19 07:39:08,FAKE,2894476704,241,2894476945,2916206602
2025-06-19 07:39:10,FAKE,2894476945,244,2894477189,2916207078
2025-06-19 07:39:12,REAL,2894477189,479,2894477668,2916207557
2025-06-19 07:39:14,FAKE,2894477668,243,2894477911,2916208044
2025-06-19 07:39:16,FAKE,2894477911,244,2894478155,2916208527
2025-06-19 07:39:18,REAL,2894478155,485,2894478640,2916209012
2025-06-19 07:39:20,REAL,2894478640,479,2894479119,2916209491
2025-06-19 07:39:22,FAKE,2894479119,238,2894479357,2916209979
2025-06-19 07:39:24,REAL,2894479357,539,2894479896,2916210518
2025-06-19 07:39:26,REAL,2894479896,483,2894480379,2916211001
2025-06-19 07:39:28,REAL,2894480379,484,2894480863,2916211485
2025-06-19 07:39:30,REAL,2894480863,532,2894481395,2916212017
2025-06-19 07:39:32,REAL,2894481395,482,2894481877,2916212499
2025-06-19 07:39:34,FAKE,2894481877,243,2894482120,2916212993
2025-06-19 07:39:36,FAKE,2894482120,244,2894482364,2916213469
2025-06-19 07:39:38,REAL,2894482364,488,2894482852,2916213957
2025-06-19 07:39:40,REAL,2894482852,480,2894483332,2916214437
2025-06-19 07:39:42,FAKE,2894483332,244,2894483576,2916214929
2025-06-19 07:39:44,REAL,2894483576,486,2894484062,2916215415
2025-06-19 07:39:46,FAKE,2894484062,238,2894484300,2916215895
2025-06-19 07:39:48,FAKE,2894484300,243,2894484543,2916216381
2025-06-19 07:39:50,REAL,2894484543,482,2894485025,2916216863
2025-06-19 07:39:52,REAL,2894485025,486,2894485511,2916217349
2025-06-19 07:39:54,FAKE,2894485511,244,2894485755,2916217839
2025-06-19 07:39:56,FAKE,2894485755,241,2894485996,2916218324
2025-06-19 07:39:58,REAL,2894485996,477,2894486473,2916218801
2025-06-19 07:40:00,REAL,2894486473,480,2894486953,2916219281
2025-06-19 07:40:02,REAL,2894486953,3995,2894490948,2916223276
2025-06-19 07:40:04,REAL,2894490948,11575,2894502523,2916234851
2025-06-19 07:40:06,FAKE,2894502523,244,2894502767,2916245106
2025-06-19 07:40:08,REAL,2894502767,10313,2894513080,2916255419
2025-06-19 07:40:10,REAL,2894513080,10252,2894523332,2916265671
2025-06-19 07:40:12,REAL,2894523332,10324,2894533656,2916275995
2025-06-19 07:40:14,REAL,2894533656,10303,2894543959,2916286298
2025-06-19 07:40:16,REAL,2894543959,10319,2894554278,2916296617
2025-06-19 07:40:18,REAL,2894554278,2454,2894556732,2916299071
2025-06-19 07:40:20,REAL,2894556732,494,2894557226,2916299565
2025-06-19 07:40:22,REAL,2894557226,480,2894557706,2916300045
2025-06-19 07:40:24,REAL,2894557706,488,2894558194,2916300533
2025-06-19 07:40:26,REAL,2894558194,485,2894558679,2916301018
2025-06-19 07:40:28,FAKE,2894558679,244,2894558923,2916301494
2025-06-19 07:40:30,REAL,2894558923,484,2894559407,2916301978
2025-06-19 07:40:32,REAL,2894559407,483,2894559890,2916302461
2025-06-19 07:40:34,REAL,2894559890,482,2894560372,2916302943
2025-06-19 07:40:36,REAL,2894560372,490,2894560862,2916303433
2025-06-19 07:40:38,REAL,2894560862,484,2894561346,2916303917
2025-06-19 07:40:40,FAKE,2894561346,238,2894561584,2916304397
2025-06-19 07:40:42,FAKE,2894561584,243,2894561827,2916304887
2025-06-19 07:40:44,REAL,2894561827,4278,2894566105,2916309165
2025-06-19 07:40:46,FAKE,2894566105,238,2894566343,2916320475
2025-06-19 07:40:48,REAL,2894566343,10252,2894576595,2916330727
2025-06-19 07:40:50,REAL,2894576595,10320,2894586915,2916341047
2025-06-19 07:40:52,FAKE,2894586915,243,2894587158,2916351295
2025-06-19 07:40:54,FAKE,2894587158,244,2894587402,2916361547
2025-06-19 07:40:56,REAL,2894587402,10367,2894597769,2916371914
2025-06-19 07:40:58,FAKE,2894597769,243,2894598012,2916382163
2025-06-19 07:41:00,REAL,2894598012,1932,2894599944,2916384095
2025-06-19 07:41:02,REAL,2894599944,492,2894600436,2916384587
2025-06-19 07:41:04,REAL,2894600436,487,2894600923,2916385074
2025-06-19 07:41:06,FAKE,2894600923,241,2894601164,2916395730
2025-06-19 07:41:08,FAKE,2894601164,244,2894601408,2916406114
2025-06-19 07:41:10,REAL,2894601408,10245,2894611653,2916416359
2025-06-19 07:41:12,REAL,2894611653,10320,2894621973,2916426679
2025-06-19 07:41:14,REAL,2894621973,10252,2894632225,2916436931
2025-06-19 07:41:16,FAKE,2894632225,241,2894632466,2916447184
2025-06-19 07:41:18,FAKE,2894632466,244,2894632710,2916457435
2025-06-19 07:41:20,FAKE,2894632710,244,2894632954,2916464058
2025-06-19 07:41:22,REAL,2894632954,482,2894633436,2916464540
2025-06-19 07:41:24,FAKE,2894633436,241,2894633677,2916465024
2025-06-19 07:41:26,REAL,2894633677,477,2894634154,2916465501
2025-06-19 07:41:28,REAL,2894634154,487,2894634641,2916465988
2025-06-19 07:41:30,REAL,2894634641,486,2894635127,2916466474
2025-06-19 07:41:32,FAKE,2894635127,241,2894635368,2916466952
2025-06-19 07:41:34,REAL,2894635368,486,2894635854,2916467438
2025-06-19 07:41:36,REAL,2894635854,485,2894636339,2916467923
2025-06-19 07:41:38,REAL,2894636339,488,2894636827,2916468411
2025-06-19 07:41:40,REAL,2894636827,536,2894637363,2916468947
2025-06-19 07:41:42,REAL,2894637363,487,2894637850,2916469434
2025-06-19 07:41:44,REAL,2894637850,486,2894638336,2916469920
2025-06-19 07:41:46,REAL,2894638336,489,2894638825,2916470409
2025-06-19 07:41:48,FAKE,2894638825,238,2894639063,2916470902
2025-06-19 07:41:50,REAL,2894639063,477,2894639540,2916471379
2025-06-19 07:41:52,REAL,2894639540,487,2894640027,2916471866
2025-06-19 07:41:54,REAL,2894640027,482,2894640509,2916472348
2025-06-19 07:41:56,REAL,2894640509,539,2894641048,2916472887
2025-06-19 07:41:58,FAKE,2894641048,241,2894641289,2916473362
2025-06-19 07:42:00,REAL,2894641289,488,2894641777,2916473850
2025-06-19 07:42:02,FAKE,2894641777,238,2894642015,2916474332
2025-06-19 07:42:04,REAL,2894642015,486,2894642501,2916474818
2025-06-19 07:42:06,FAKE,2894642501,238,2894642739,2916475308
2025-06-19 07:42:08,FAKE,2894642739,241,2894642980,2916475789
2025-06-19 07:42:10,FAKE,2894642980,243,2894643223,2916476269
2025-06-19 07:42:12,FAKE,2894643223,238,2894643461,2916476752
2025-06-19 07:42:14,FAKE,2894643461,244,2894643705,2916477238
2025-06-19 07:42:16,FAKE,2894643705,238,2894643943,2916477730
2025-06-19 07:42:18,REAL,2894643943,486,2894644429,2916478216
2025-06-19 07:42:20,FAKE,2894644429,238,2894644667,2916478698
2025-06-19 07:42:22,REAL,2894644667,539,2894645206,2916479237
2025-06-19 07:42:24,FAKE,2894645206,241,2894645447,2916479726
2025-06-19 07:42:26,FAKE,2894645447,238,2894645685,2916480209
2025-06-19 07:42:28,REAL,2894645685,479,2894646164,2916480688
2025-06-19 07:42:30,REAL,2894646164,485,2894646649,2916481173
2025-06-19 07:42:32,FAKE,2894646649,238,2894646887,2916481656
2025-06-19 07:42:34,FAKE,2894646887,238,2894647125,2916482146
2025-06-19 07:42:36,FAKE,2894647125,243,2894647368,2916482633
2025-06-19 07:42:38,FAKE,2894647368,241,2894647609,2916483114
2025-06-19 07:42:40,REAL,2894647609,7886,2894655495,2916491000
2025-06-19 07:42:42,REAL,2894655495,10778,2894666273,2916501778
2025-06-19 07:42:44,REAL,2894666273,10258,2894676531,2916512036
2025-06-19 07:42:46,FAKE,2894676531,241,2894676772,2916522288
2025-06-19 07:42:48,REAL,2894676772,10311,2894687083,2916532599
2025-06-19 07:42:50,REAL,2894687083,10255,2894697338,2916542854
2025-06-19 07:42:52,FAKE,2894697338,241,2894697579,2916553101
2025-06-19 07:42:54,REAL,2894697579,9795,2894707374,2916562896
2025-06-19 07:42:56,REAL,2894707374,483,2894707857,2916563379
2025-06-19 07:42:58,REAL,2894707857,489,2894708346,2916563868
2025-06-19 07:43:00,REAL,2894708346,483,2894708829,2916564351
2025-06-19 07:43:02,REAL,2894708829,486,2894709315,2916564837
2025-06-19 07:43:04,REAL,2894709315,488,2894709803,2916565325
2025-06-19 07:43:06,REAL,2894709803,536,2894710339,2916565861
2025-06-19 07:43:08,FAKE,2894710339,238,2894710577,2916566352
2025-06-19 07:43:10,FAKE,2894710577,243,2894710820,2916566835
2025-06-19 07:43:12,REAL,2894710820,7697,2894718517,2916574532
2025-06-19 07:43:14,REAL,2894718517,11172,2894729689,2916585704
2025-06-19 07:43:16,REAL,2894729689,9986,2894739675,2916595690
2025-06-19 07:43:18,FAKE,2894739675,243,2894739918,2916605949
2025-06-19 07:43:20,REAL,2894739918,10255,2894750173,2916616204
2025-06-19 07:43:22,REAL,2894750173,10321,2894760494,2916626525
2025-06-19 07:43:24,FAKE,2894760494,238,2894760732,2916636779
2025-06-19 07:43:26,REAL,2894760732,9124,2894769856,2916645903
2025-06-19 07:43:28,FAKE,2894769856,238,2894770094,2916646381
2025-06-19 07:43:30,FAKE,2894770094,241,2894770335,2916646864
2025-06-19 07:43:32,FAKE,2894770335,243,2894770578,2916647352
2025-06-19 07:43:34,REAL,2894770578,481,2894771059,2916647833
2025-06-19 07:43:36,REAL,2894771059,484,2894771543,2916648317
2025-06-19 07:43:38,REAL,2894771543,485,2894772028,2916648802
2025-06-19 07:43:40,REAL,2894772028,482,2894772510,2916649284
2025-06-19 07:43:42,REAL,2894772510,486,2894772996,2916649770
2025-06-19 07:43:44,REAL,2894772996,476,2894773472,2916650246
2025-06-19 07:43:46,REAL,2894773472,492,2894773964,2916650738
2025-06-19 07:43:48,REAL,2894773964,544,2894774508,2916651282
2025-06-19 07:43:50,FAKE,2894774508,238,2894774746,2916651771
2025-06-19 07:43:52,REAL,2894774746,480,2894775226,2916652251
2025-06-19 07:43:54,FAKE,2894775226,243,2894775469,2916652735
2025-06-19 07:43:56,FAKE,2894775469,241,2894775710,2916653218
2025-06-19 07:43:58,REAL,2894775710,485,2894776195,2916653703
2025-06-19 07:44:00,REAL,2894776195,545,2894776740,2916654248
2025-06-19 07:44:02,FAKE,2894776740,238,2894776978,2916654728
2025-06-19 07:44:04,FAKE,2894776978,241,2894777219,2916655210
2025-06-19 07:44:06,FAKE,2894777219,243,2894777462,2916655696
2025-06-19 07:44:08,REAL,2894777462,481,2894777943,2916656177
2025-06-19 07:44:10,REAL,2894777943,478,2894778421,2916656655
2025-06-19 07:44:12,REAL,2894778421,486,2894778907,2916657141
2025-06-19 07:44:14,REAL,2894778907,2667,2894781574,2916659808
2025-06-19 07:44:16,REAL,2894781574,15016,2894796590,2916674824
2025-06-19 07:44:18,REAL,2894796590,10318,2894806908,2916685142
2025-06-19 07:44:20,REAL,2894806908,10244,2894817152,2916695386
2025-06-19 07:44:22,REAL,2894817152,10314,2894827466,2916705700
2025-06-19 07:44:24,FAKE,2894827466,243,2894827709,2916715944
2025-06-19 07:44:26,FAKE,2894827709,244,2894827953,2916726199
2025-06-19 07:44:28,REAL,2894827953,10315,2894838268,2916736514
2025-06-19 07:44:30,FAKE,2894838268,243,2894838511,2916739831
2025-06-19 07:44:32,REAL,2894838511,540,2894839051,2916740371
2025-06-19 07:44:34,REAL,2894839051,488,2894839539,2916740859
2025-06-19 07:44:36,REAL,2894839539,479,2894840018,2916741338
2025-06-19 07:44:38,FAKE,2894840018,238,2894840256,2916741820
2025-06-19 07:44:40,REAL,2894840256,491,2894840747,2916742311
2025-06-19 07:44:42,REAL,2894840747,478,2894841225,2916742789
2025-06-19 07:44:44,FAKE,2894841225,241,2894841466,2916743270
2025-06-19 07:44:46,REAL,2894841466,482,2894841948,2916743752
2025-06-19 07:44:48,FAKE,2894841948,243,2894842191,2916744234
2025-06-19 07:44:50,FAKE,2894842191,244,2894842435,2916744714
2025-06-19 07:44:52,FAKE,2894842435,241,2894842676,2916754251
2025-06-19 07:44:54,REAL,2894842676,10585,2894853261,2916764836
2025-06-19 07:44:56,REAL,2894853261,10247,2894863508,2916775083
2025-06-19 07:44:58,FAKE,2894863508,241,2894863749,2916785410
2025-06-19 07:45:00,FAKE,2894863749,243,2894863992,2916795665
2025-06-19 07:45:02,REAL,2894863992,10322,2894874314,2916805987
2025-06-19 07:45:04,REAL,2894874314,10254,2894884568,2916816241
2025-06-19 07:45:06,REAL,2894884568,7673,2894892241,2916823914
2025-06-19 07:45:08,REAL,2894892241,489,2894892730,2916824403
2025-06-19 07:45:10,FAKE,2894892730,243,2894892973,2916824886
2025-06-19 07:45:12,REAL,2894892973,479,2894893452,2916825365
2025-06-19 07:45:14,FAKE,2894893452,244,2894893696,2916825842
2025-06-19 07:45:16,REAL,2894893696,487,2894894183,2916826329
2025-06-19 07:45:18,FAKE,2894894183,243,2894894426,2916826810
2025-06-19 07:45:20,REAL,2894894426,488,2894894914,2916827298
2025-06-19 07:45:22,FAKE,2894894914,243,2894895157,2916827779
2025-06-19 07:45:24,REAL,2894895157,13367,2894908524,2916841146
2025-06-19 07:45:26,FAKE,2894908524,243,2894908767,2916852257
2025-06-19 07:45:28,REAL,2894908767,10251,2894919018,2916862508
2025-06-19 07:45:30,FAKE,2894919018,238,2894919256,2916872768
2025-06-19 07:45:32,REAL,2894919256,10318,2894929574,2916883086
2025-06-19 07:45:34,REAL,2894929574,10251,2894939825,2916893337
2025-06-19 07:45:36,REAL,2894939825,10247,2894950072,2916903584
2025-06-19 07:45:38,REAL,2894950072,6954,2894957026,2916910538
2025-06-19 07:45:40,REAL,2894957026,541,2894957567,2916911079
2025-06-19 07:45:42,REAL,2894957567,481,2894958048,2916911560
2025-06-19 07:45:44,REAL,2894958048,489,2894958537,2916912049
2025-06-19 07:45:46,FAKE,2894958537,241,2894958778,2916912541
2025-06-19 07:45:48,REAL,2894958778,485,2894959263,2916913026
2025-06-19 07:45:50,FAKE,2894959263,241,2894959504,2916913514
2025-06-19 07:45:52,REAL,2894959504,487,2894959991,2916914001
2025-06-19 07:45:54,REAL,2894959991,475,2894960466,2916914476
2025-06-19 07:45:56,REAL,2894960466,490,2894960956,2916914966
2025-06-19 07:45:58,FAKE,2894960956,238,2894961194,2916915450
2025-06-19 07:46:00,REAL,2894961194,487,2894961681,2916915937
2025-06-19 07:46:02,REAL,2894961681,476,2894962157,2916916413
2025-06-19 07:46:04,REAL,2894962157,487,2894962644,2916916900
2025-06-19 07:46:06,REAL,2894962644,489,2894963133,2916917389
2025-06-19 07:46:08,REAL,2894963133,486,2894963619,2916917875
2025-06-19 07:46:10,FAKE,2894963619,243,2894963862,2916918359
2025-06-19 07:46:12,FAKE,2894963862,238,2894964100,2916918901
2025-06-19 07:46:14,FAKE,2894964100,238,2894964338,2916919436
2025-06-19 07:46:16,REAL,2894964338,6499,2894970837,2916925935
2025-06-19 07:46:18,REAL,2894970837,14153,2894984990,2916940088
2025-06-19 07:46:20,REAL,2894984990,10257,2894995247,2916950345
2025-06-19 07:46:22,FAKE,2894995247,243,2894995490,2916960669
2025-06-19 07:46:24,REAL,2894995490,10247,2895005737,2916970916
2025-06-19 07:46:26,REAL,2895005737,10255,2895015992,2916981171
2025-06-19 07:46:28,REAL,2895015992,10312,2895026304,2916991483
2025-06-19 07:46:30,REAL,2895026304,10254,2895036558,2917001737
2025-06-19 07:46:32,REAL,2895036558,1140,2895037698,2917002877
2025-06-19 07:46:34,REAL,2895037698,492,2895038190,2917003369
2025-06-19 07:46:36,REAL,2895038190,486,2895038676,2917003855
2025-06-19 07:46:38,REAL,2895038676,482,2895039158,2917004337
2025-06-19 07:46:40,REAL,2895039158,487,2895039645,2917004824
2025-06-19 07:46:42,REAL,2895039645,478,2895040123,2917005302
2025-06-19 07:46:44,REAL,2895040123,487,2895040610,2917005789
2025-06-19 07:46:46,REAL,2895040610,486,2895041096,2917006275
2025-06-19 07:46:48,FAKE,2895041096,243,2895041339,2917006812
2025-06-19 07:46:50,REAL,2895041339,491,2895041830,2917007303
2025-06-19 07:46:52,REAL,2895041830,485,2895042315,2917007788
2025-06-19 07:46:54,FAKE,2895042315,241,2895042556,2917008274
2025-06-19 07:46:56,REAL,2895042556,475,2895043031,2917008749
2025-06-19 07:46:58,REAL,2895043031,486,2895043517,2917009235
2025-06-19 07:47:00,REAL,2895043517,493,2895044010,2917009728
2025-06-19 07:47:02,REAL,2895044010,540,2895044550,2917010268
2025-06-19 07:47:04,FAKE,2895044550,241,2895044791,2917010755
2025-06-19 07:47:06,REAL,2895044791,482,2895045273,2917011237
2025-06-19 07:47:08,REAL,2895045273,481,2895045754,2917011718
2025-06-19 07:47:10,REAL,2895045754,489,2895046243,2917012207
2025-06-19 07:47:12,REAL,2895046243,485,2895046728,2917012692
2025-06-19 07:47:14,REAL,2895046728,477,2895047205,2917013169
2025-06-19 07:47:16,FAKE,2895047205,243,2895047448,2917013654
2025-06-19 07:47:18,REAL,2895047448,493,2895047941,2917014147
2025-06-19 07:47:20,REAL,2895047941,481,2895048422,2917014628
2025-06-19 07:47:22,REAL,2895048422,493,2895048915,2917015121
2025-06-19 07:47:24,FAKE,2895048915,243,2895049158,2917015930
2025-06-19 07:47:26,REAL,2895049158,11641,2895060799,2917027571
2025-06-19 07:47:28,FAKE,2895060799,243,2895061042,2917037823
2025-06-19 07:47:30,FAKE,2895061042,243,2895061285,2917048074
2025-06-19 07:47:32,REAL,2895061285,10322,2895071607,2917058396
2025-06-19 07:47:34,REAL,2895071607,10252,2895081859,2917068648
2025-06-19 07:47:36,REAL,2895081859,10244,2895092103,2917078892
2025-06-19 07:47:38,FAKE,2895092103,243,2895092346,2917089202
2025-06-19 07:47:40,REAL,2895092346,4842,2895097188,2917094044
2025-06-19 07:47:42,REAL,2895097188,478,2895097666,2917094522
2025-06-19 07:47:44,REAL,2895097666,474,2895098140,2917094996
2025-06-19 07:47:46,REAL,2895098140,481,2895098621,2917095477
2025-06-19 07:47:48,REAL,2895098621,480,2895099101,2917095957
2025-06-19 07:47:50,REAL,2895099101,486,2895099587,2917096443
2025-06-19 07:47:52,REAL,2895099587,492,2895100079,2917096935
2025-06-19 07:47:54,REAL,2895100079,489,2895100568,2917097424
2025-06-19 07:47:56,FAKE,2895100568,241,2895100809,2917097900
2025-06-19 07:47:58,REAL,2895100809,537,2895101346,2917098437
2025-06-19 07:48:00,REAL,2895101346,488,2895101834,2917098925
2025-06-19 07:48:02,FAKE,2895101834,244,2895102078,2917099407
2025-06-19 07:48:04,REAL,2895102078,482,2895102560,2917099889
2025-06-19 07:48:06,REAL,2895102560,482,2895103042,2917100371
2025-06-19 07:48:08,REAL,2895103042,484,2895103526,2917100855
2025-06-19 07:48:10,FAKE,2895103526,238,2895103764,2917101343
2025-06-19 07:48:12,REAL,2895103764,550,2895104314,2917101893
2025-06-19 07:48:14,REAL,2895104314,482,2895104796,2917102375
2025-06-19 07:48:16,REAL,2895104796,478,2895105274,2917102853
2025-06-19 07:48:18,REAL,2895105274,476,2895105750,2917103329
2025-06-19 07:48:20,REAL,2895105750,485,2895106235,2917103814
2025-06-19 07:48:22,FAKE,2895106235,238,2895106473,2917104293
2025-06-19 07:48:24,REAL,2895106473,480,2895106953,2917104773
2025-06-19 07:48:26,FAKE,2895106953,243,2895107196,2917105261
2025-06-19 07:48:28,REAL,2895107196,491,2895107687,2917105752
2025-06-19 07:48:30,REAL,2895107687,484,2895108171,2917106236
2025-06-19 07:48:32,REAL,2895108171,541,2895108712,2917106777
2025-06-19 07:48:34,REAL,2895108712,484,2895109196,2917107261
2025-06-19 07:48:36,REAL,2895109196,489,2895109685,2917107750
2025-06-19 07:48:38,REAL,2895109685,484,2895110169,2917108234
2025-06-19 07:48:40,REAL,2895110169,483,2895110652,2917108717
2025-06-19 07:48:42,FAKE,2895110652,241,2895110893,2917109201
2025-06-19 07:48:44,REAL,2895110893,481,2895111374,2917109682
2025-06-19 07:48:46,REAL,2895111374,484,2895111858,2917110166
2025-06-19 07:48:48,REAL,2895111858,480,2895112338,2917110646
2025-06-19 07:48:50,REAL,2895112338,8542,2895120880,2917119188
2025-06-19 07:48:52,REAL,2895120880,10720,2895131600,2917129908
2025-06-19 07:48:54,FAKE,2895131600,241,2895131841,2917140155
2025-06-19 07:48:56,REAL,2895131841,10254,2895142095,2917150409
2025-06-19 07:48:58,REAL,2895142095,10313,2895152408,2917160722
2025-06-19 07:49:00,REAL,2895152408,10251,2895162659,2917170973
2025-06-19 07:49:02,REAL,2895162659,10257,2895172916,2917181230
2025-06-19 07:49:04,FAKE,2895172916,238,2895173154,2917189565
2025-06-19 07:49:06,REAL,2895173154,490,2895173644,2917190055
2025-06-19 07:49:08,REAL,2895173644,545,2895174189,2917190600
2025-06-19 07:49:10,REAL,2895174189,483,2895174672,2917191083
2025-06-19 07:49:12,FAKE,2895174672,243,2895174915,2917191576
2025-06-19 07:49:14,REAL,2895174915,487,2895175402,2917192063
2025-06-19 07:49:16,REAL,2895175402,490,2895175892,2917192553
2025-06-19 07:49:18,FAKE,2895175892,238,2895176130,2917193031
2025-06-19 07:49:20,FAKE,2895176130,238,2895176368,2917193514
2025-06-19 07:49:22,FAKE,2895176368,244,2895176612,2917193999
2025-06-19 07:49:24,REAL,2895176612,478,2895177090,2917194477
2025-06-19 07:49:26,FAKE,2895177090,241,2895177331,2917197934
2025-06-19 07:49:28,REAL,2895177331,11851,2895189182,2917209785
2025-06-19 07:49:30,REAL,2895189182,10257,2895199439,2917220042
2025-06-19 07:49:32,REAL,2895199439,10260,2895209699,2917230302
2025-06-19 07:49:34,FAKE,2895209699,241,2895209940,2917240614
2025-06-19 07:49:36,REAL,2895209940,10250,2895220190,2917250864
2025-06-19 07:49:38,REAL,2895220190,10250,2895230440,2917261114
2025-06-19 07:49:40,REAL,2895230440,10255,2895240695,2917271369
2025-06-19 07:49:42,REAL,2895240695,2733,2895243428,2917274102
2025-06-19 07:49:44,REAL,2895243428,478,2895243906,2917274580
2025-06-19 07:49:46,FAKE,2895243906,238,2895244144,2917275066
2025-06-19 07:49:48,REAL,2895244144,480,2895244624,2917275546
2025-06-19 07:49:50,FAKE,2895244624,243,2895244867,2917276023
2025-06-19 07:49:52,REAL,2895244867,484,2895245351,2917276507
2025-06-19 07:49:54,FAKE,2895245351,243,2895245594,2917276995
2025-06-19 07:49:56,REAL,2895245594,488,2895246082,2917277483
2025-06-19 07:49:58,FAKE,2895246082,244,2895246326,2917277968
2025-06-19 07:50:00,REAL,2895246326,548,2895246874,2917278516
2025-06-19 07:50:02,REAL,2895246874,477,2895247351,2917278993
2025-06-19 07:50:04,FAKE,2895247351,241,2895247592,2917279474
2025-06-19 07:50:06,REAL,2895247592,488,2895248080,2917279962
2025-06-19 07:50:08,FAKE,2895248080,241,2895248321,2917280444
2025-06-19 07:50:10,FAKE,2895248321,241,2895248562,2917280930
2025-06-19 07:50:12,FAKE,2895248562,244,2895248806,2917281409
2025-06-19 07:50:14,FAKE,2895248806,238,2895249044,2917281897
2025-06-19 07:50:16,FAKE,2895249044,244,2895249288,2917282434
2025-06-19 07:50:18,REAL,2895249288,485,2895249773,2917282919
2025-06-19 07:50:20,REAL,2895249773,10855,2895260628,2917293774
2025-06-19 07:50:22,REAL,2895260628,10457,2895271085,2917304231
2025-06-19 07:50:24,FAKE,2895271085,243,2895271328,2917314480
2025-06-19 07:50:26,REAL,2895271328,10306,2895281634,2917324786
2025-06-19 07:50:28,REAL,2895281634,10252,2895291886,2917335038
2025-06-19 07:50:30,REAL,2895291886,10315,2895302201,2917345353
2025-06-19 07:50:32,REAL,2895302201,10258,2895312459,2917355611
2025-06-19 07:50:34,FAKE,2895312459,243,2895312702,2917362299
2025-06-19 07:50:36,REAL,2895312702,487,2895313189,2917362786
2025-06-19 07:50:38,FAKE,2895313189,241,2895313430,2917363269
2025-06-19 07:50:40,REAL,2895313430,485,2895313915,2917363754
2025-06-19 07:50:42,FAKE,2895313915,241,2895314156,2917364238
2025-06-19 07:50:44,REAL,2895314156,486,2895314642,2917364724
2025-06-19 07:50:46,FAKE,2895314642,241,2895314883,2917365210
2025-06-19 07:50:48,REAL,2895314883,487,2895315370,2917365697
2025-06-19 07:50:50,REAL,2895315370,492,2895315862,2917366189
2025-06-19 07:50:52,REAL,2895315862,544,2895316406,2917366733
2025-06-19 07:50:54,REAL,2895316406,483,2895316889,2917367216
2025-06-19 07:50:56,REAL,2895316889,484,2895317373,2917367700
2025-06-19 07:50:58,FAKE,2895317373,238,2895317611,2917368182
2025-06-19 07:51:00,REAL,2895317611,482,2895318093,2917368664
2025-06-19 07:51:02,REAL,2895318093,481,2895318574,2917369145
2025-06-19 07:51:04,FAKE,2895318574,238,2895318812,2917369626
2025-06-19 07:51:06,FAKE,2895318812,241,2895319053,2917370117
2025-06-19 07:51:08,FAKE,2895319053,241,2895319294,2917370656
2025-06-19 07:51:10,REAL,2895319294,479,2895319773,2917371135
2025-06-19 07:51:12,REAL,2895319773,489,2895320262,2917371624
2025-06-19 07:51:14,FAKE,2895320262,243,2895320505,2917372102
2025-06-19 07:51:16,REAL,2895320505,540,2895321045,2917372642
2025-06-19 07:51:18,FAKE,2895321045,244,2895321289,2917373124
2025-06-19 07:51:20,REAL,2895321289,484,2895321773,2917373608
2025-06-19 07:51:22,FAKE,2895321773,243,2895322016,2917379716
2025-06-19 07:51:24,FAKE,2895322016,238,2895322254,2917391160
2025-06-19 07:51:26,REAL,2895322254,10318,2895332572,2917401478
2025-06-19 07:51:28,FAKE,2895332572,238,2895332810,2917411728
2025-06-19 07:51:30,FAKE,2895332810,244,2895333054,2917422045
2025-06-19 07:51:32,REAL,2895333054,10259,2895343313,2917432304
2025-06-19 07:51:34,FAKE,2895343313,238,2895343551,2917442613
2025-06-19 07:51:36,REAL,2895343551,10252,2895353803,2917452865
2025-06-19 07:51:38,FAKE,2895353803,243,2895354046,2917453870
2025-06-19 07:51:40,REAL,2895354046,479,2895354525,2917454349
2025-06-19 07:51:42,REAL,2895354525,480,2895355005,2917454829
2025-06-19 07:51:44,REAL,2895355005,540,2895355545,2917455369
2025-06-19 07:51:46,FAKE,2895355545,241,2895355786,2917455854
2025-06-19 07:51:48,FAKE,2895355786,243,2895356029,2917456340
2025-06-19 07:51:50,FAKE,2895356029,238,2895356267,2917456827
2025-06-19 07:51:52,FAKE,2895356267,243,2895356510,2917457305
2025-06-19 07:51:54,REAL,2895356510,483,2895356993,2917457788
2025-06-19 07:51:56,REAL,2895356993,487,2895357480,2917458275
2025-06-19 07:51:58,FAKE,2895357480,238,2895357718,2917458765
2025-06-19 07:52:00,REAL,2895357718,483,2895358201,2917459248
2025-06-19 07:52:02,REAL,2895358201,487,2895358688,2917459735
2025-06-19 07:52:04,REAL,2895358688,6107,2895364795,2917465842
2025-06-19 07:52:06,REAL,2895364795,11176,2895375971,2917477018
2025-06-19 07:52:08,REAL,2895375971,10322,2895386293,2917487340
2025-06-19 07:52:10,REAL,2895386293,10305,2895396598,2917497645
2025-06-19 07:52:12,REAL,2895396598,10320,2895406918,2917507965
2025-06-19 07:52:14,REAL,2895406918,10258,2895417176,2917518223
2025-06-19 07:52:16,FAKE,2895417176,241,2895417417,2917528475
2025-06-19 07:52:18,REAL,2895417417,10320,2895427737,2917538795
2025-06-19 07:52:20,REAL,2895427737,478,2895428215,2917539273
2025-06-19 07:52:22,REAL,2895428215,482,2895428697,2917539755
2025-06-19 07:52:24,REAL,2895428697,483,2895429180,2917540238
2025-06-19 07:52:26,REAL,2895429180,484,2895429664,2917540722
2025-06-19 07:52:28,FAKE,2895429664,243,2895429907,2917541207
2025-06-19 07:52:30,REAL,2895429907,488,2895430395,2917541695
2025-06-19 07:52:32,REAL,2895430395,484,2895430879,2917542179
2025-06-19 07:52:34,REAL,2895430879,535,2895431414,2917542714
2025-06-19 07:52:36,REAL,2895431414,486,2895431900,2917543200
2025-06-19 07:52:38,REAL,2895431900,492,2895432392,2917543692
2025-06-19 07:52:40,FAKE,2895432392,244,2895432636,2917544176
2025-06-19 07:52:42,FAKE,2895432636,243,2895432879,2917544665
2025-06-19 07:52:44,FAKE,2895432879,241,2895433120,2917545157
2025-06-19 07:52:46,REAL,2895433120,483,2895433603,2917545640
2025-06-19 07:52:48,REAL,2895433603,480,2895434083,2917546120
2025-06-19 07:52:50,REAL,2895434083,476,2895434559,2917546596
2025-06-19 07:52:52,REAL,2895434559,483,2895435042,2917547079
2025-06-19 07:52:54,FAKE,2895435042,238,2895435280,2917547621
2025-06-19 07:52:56,REAL,2895435280,484,2895435764,2917548105
2025-06-19 07:52:58,FAKE,2895435764,243,2895436007,2917548592
2025-06-19 07:53:00,REAL,2895436007,539,2895436546,2917549131
2025-06-19 07:53:02,REAL,2895436546,477,2895437023,2917549608
2025-06-19 07:53:04,REAL,2895437023,476,2895437499,2917550084
2025-06-19 07:53:06,REAL,2895437499,480,2895437979,2917550564
2025-06-19 07:53:08,REAL,2895437979,492,2895438471,2917551056
2025-06-19 07:53:10,REAL,2895438471,480,2895438951,2917551536
2025-06-19 07:53:12,FAKE,2895438951,243,2895439194,2917559018
2025-06-19 07:53:14,REAL,2895439194,11175,2895450369,2917570193
2025-06-19 07:53:16,REAL,2895450369,10316,2895460685,2917580509
2025-06-19 07:53:18,REAL,2895460685,10253,2895470938,2917590762
2025-06-19 07:53:20,REAL,2895470938,10321,2895481259,2917601083
2025-06-19 07:53:22,REAL,2895481259,10249,2895491508,2917611332
2025-06-19 07:53:24,FAKE,2895491508,244,2895491752,2917621585
2025-06-19 07:53:26,FAKE,2895491752,244,2895491996,2917631174
2025-06-19 07:53:28,FAKE,2895491996,241,2895492237,2917631659
2025-06-19 07:53:30,REAL,2895492237,488,2895492725,2917632147
2025-06-19 07:53:32,REAL,2895492725,479,2895493204,2917632626
2025-06-19 07:53:34,REAL,2895493204,481,2895493685,2917633107
2025-06-19 07:53:36,REAL,2895493685,490,2895494175,2917633597
2025-06-19 07:53:38,FAKE,2895494175,241,2895494416,2917634080
2025-06-19 07:53:40,REAL,2895494416,483,2895494899,2917634563
2025-06-19 07:53:42,REAL,2895494899,483,2895495382,2917635046
2025-06-19 07:53:44,REAL,2895495382,489,2895495871,2917635535
2025-06-19 07:53:46,FAKE,2895495871,241,2895496112,2917636024
2025-06-19 07:53:48,REAL,2895496112,485,2895496597,2917636509
2025-06-19 07:53:50,REAL,2895496597,488,2895497085,2917636997
2025-06-19 07:53:52,FAKE,2895497085,244,2895497329,2917637541
2025-06-19 07:53:54,REAL,2895497329,489,2895497818,2917638030
2025-06-19 07:53:56,REAL,2895497818,489,2895498307,2917638519
2025-06-19 07:53:58,REAL,2895498307,487,2895498794,2917639006
2025-06-19 07:54:00,REAL,2895498794,489,2895499283,2917639495
2025-06-19 07:54:02,REAL,2895499283,540,2895499823,2917640035
2025-06-19 07:54:04,FAKE,2895499823,243,2895500066,2917640510
2025-06-19 07:54:06,REAL,2895500066,483,2895500549,2917640993
2025-06-19 07:54:08,REAL,2895500549,479,2895501028,2917641472
2025-06-19 07:54:10,FAKE,2895501028,238,2895501266,2917641951
2025-06-19 07:54:12,REAL,2895501266,486,2895501752,2917642437
2025-06-19 07:54:14,FAKE,2895501752,244,2895501996,2917642926
2025-06-19 07:54:16,REAL,2895501996,479,2895502475,2917643405
2025-06-19 07:54:18,REAL,2895502475,487,2895502962,2917643892
2025-06-19 07:54:20,FAKE,2895502962,244,2895503206,2917644433
2025-06-19 07:54:22,REAL,2895503206,487,2895503693,2917644920
2025-06-19 07:54:24,REAL,2895503693,485,2895504178,2917645405
2025-06-19 07:54:26,REAL,2895504178,478,2895504656,2917645883
2025-06-19 07:54:28,FAKE,2895504656,243,2895504899,2917646366
2025-06-19 07:54:30,REAL,2895504899,487,2895505386,2917646853
2025-06-19 07:54:32,FAKE,2895505386,244,2895505630,2917647334
2025-06-19 07:54:34,REAL,2895505630,480,2895506110,2917647814
2025-06-19 07:54:36,REAL,2895506110,487,2895506597,2917648301
2025-06-19 07:54:38,REAL,2895506597,483,2895507080,2917648784
2025-06-19 07:54:40,REAL,2895507080,475,2895507555,2917649259
2025-06-19 07:54:42,REAL,2895507555,482,2895508037,2917649741
2025-06-19 07:54:44,REAL,2895508037,542,2895508579,2917650283
2025-06-19 07:54:46,FAKE,2895508579,244,2895508823,2917650758
2025-06-19 07:54:48,REAL,2895508823,486,2895509309,2917651244
2025-06-19 07:54:50,REAL,2895509309,491,2895509800,2917651735
2025-06-19 07:54:52,REAL,2895509800,539,2895510339,2917652274
2025-06-19 07:54:54,REAL,2895510339,476,2895510815,2917652750
2025-06-19 07:54:56,REAL,2895510815,488,2895511303,2917653238
2025-06-19 07:54:58,FAKE,2895511303,241,2895511544,2917653726
2025-06-19 07:55:00,REAL,2895511544,488,2895512032,2917654214
2025-06-19 07:55:02,REAL,2895512032,3464,2895515496,2917657678
2025-06-19 07:55:04,REAL,2895515496,11855,2895527351,2917669533
2025-06-19 07:55:06,REAL,2895527351,10256,2895537607,2917679789
2025-06-19 07:55:08,FAKE,2895537607,243,2895537850,2917690094
2025-06-19 07:55:10,REAL,2895537850,10319,2895548169,2917700413
2025-06-19 07:55:12,REAL,2895548169,10259,2895558428,2917710672
2025-06-19 07:55:14,FAKE,2895558428,243,2895558671,2917720920
2025-06-19 07:55:16,REAL,2895558671,10246,2895568917,2917731166
2025-06-19 07:55:18,REAL,2895568917,2797,2895571714,2917733963
2025-06-19 07:55:20,REAL,2895571714,490,2895572204,2917734453
2025-06-19 07:55:22,REAL,2895572204,480,2895572684,2917734933
2025-06-19 07:55:24,REAL,2895572684,486,2895573170,2917735419
2025-06-19 07:55:26,REAL,2895573170,484,2895573654,2917735903
2025-06-19 07:55:28,FAKE,2895573654,238,2895573892,2917736388
2025-06-19 07:55:30,FAKE,2895573892,238,2895574130,2917736869
2025-06-19 07:55:32,REAL,2895574130,488,2895574618,2917737357
2025-06-19 07:55:34,REAL,2895574618,541,2895575159,2917737898
2025-06-19 07:55:36,FAKE,2895575159,238,2895575397,2917738375
2025-06-19 07:55:38,REAL,2895575397,490,2895575887,2917738865
2025-06-19 07:55:40,REAL,2895575887,12439,2895588326,2917751304
2025-06-19 07:55:42,FAKE,2895588326,243,2895588569,2917762354
2025-06-19 07:55:44,REAL,2895588569,10317,2895598886,2917772671
2025-06-19 07:55:46,REAL,2895598886,10253,2895609139,2917782924
2025-06-19 07:55:48,REAL,2895609139,10253,2895619392,2917793177
2025-06-19 07:55:50,REAL,2895619392,10260,2895629652,2917803437
2025-06-19 07:55:52,REAL,2895629652,10313,2895639965,2917813750
2025-06-19 07:55:54,REAL,2895639965,6955,2895646920,2917820705
2025-06-19 07:55:56,FAKE,2895646920,244,2895647164,2917821196
2025-06-19 07:55:58,REAL,2895647164,535,2895647699,2917821731
2025-06-19 07:56:00,REAL,2895647699,484,2895648183,2917822215
2025-06-19 07:56:02,REAL,2895648183,481,2895648664,2917822696
2025-06-19 07:56:04,REAL,2895648664,488,2895649152,2917823184
2025-06-19 07:56:06,REAL,2895649152,483,2895649635,2917823667
2025-06-19 07:56:08,REAL,2895649635,484,2895650119,2917824151
2025-06-19 07:56:10,REAL,2895650119,484,2895650603,2917824635
2025-06-19 07:56:12,REAL,2895650603,484,2895651087,2917825119
2025-06-19 07:56:14,REAL,2895651087,485,2895651572,2917825604
2025-06-19 07:56:16,REAL,2895651572,484,2895652056,2917826088
2025-06-19 07:56:18,FAKE,2895652056,238,2895652294,2917826573
2025-06-19 07:56:20,FAKE,2895652294,243,2895652537,2917827065
2025-06-19 07:56:22,FAKE,2895652537,243,2895652780,2917827606
2025-06-19 07:56:24,REAL,2895652780,491,2895653271,2917828097
2025-06-19 07:56:26,REAL,2895653271,482,2895653753,2917828579
2025-06-19 07:56:28,FAKE,2895653753,238,2895653991,2917829116
2025-06-19 07:56:30,REAL,2895653991,476,2895654467,2917829592
2025-06-19 07:56:32,FAKE,2895654467,238,2895654705,2917830069
2025-06-19 07:56:34,REAL,2895654705,483,2895655188,2917830552
2025-06-19 07:56:36,REAL,2895655188,477,2895655665,2917831029
2025-06-19 07:56:38,FAKE,2895655665,241,2895655906,2917831507
2025-06-19 07:56:40,REAL,2895655906,490,2895656396,2917831997
2025-06-19 07:56:42,REAL,2895656396,491,2895656887,2917832488
2025-06-19 07:56:44,REAL,2895656887,478,2895657365,2917832966
2025-06-19 07:56:46,REAL,2895657365,542,2895657907,2917833508
2025-06-19 07:56:48,REAL,2895657907,478,2895658385,2917833986
2025-06-19 07:56:50,REAL,2895658385,488,2895658873,2917834474
2025-06-19 07:56:52,REAL,2895658873,489,2895659362,2917834963
2025-06-19 07:56:54,REAL,2895659362,476,2895659838,2917835439
2025-06-19 07:56:56,FAKE,2895659838,244,2895660082,2917835923
2025-06-19 07:56:58,REAL,2895660082,483,2895660565,2917836406
2025-06-19 07:57:00,REAL,2895660565,489,2895661054,2917836895
2025-06-19 07:57:02,REAL,2895661054,483,2895661537,2917837378
2025-06-19 07:57:04,REAL,2895661537,479,2895662016,2917837857
2025-06-19 07:57:06,FAKE,2895662016,241,2895662257,2917838344
2025-06-19 07:57:08,REAL,2895662257,487,2895662744,2917838831
2025-06-19 07:57:10,REAL,2895662744,488,2895663232,2917839319
2025-06-19 07:57:12,REAL,2895663232,535,2895663767,2917839854
2025-06-19 07:57:14,FAKE,2895663767,243,2895664010,2917840388
2025-06-19 07:57:16,REAL,2895664010,479,2895664489,2917840867
2025-06-19 07:57:18,REAL,2895664489,483,2895664972,2917841350
2025-06-19 07:57:20,FAKE,2895664972,244,2895665216,2917841827
2025-06-19 07:57:22,FAKE,2895665216,238,2895665454,2917842071
2025-06-19 07:57:24,REAL,2895665454,486,2895665940,2917842557
2025-06-19 07:57:26,REAL,2895665940,474,2895666414,2917843031
2025-06-19 07:57:28,FAKE,2895666414,244,2895666658,2917843516
2025-06-19 07:57:30,REAL,2895666658,481,2895667139,2917843997
2025-06-19 07:57:32,REAL,2895667139,489,2895667628,2917844486
2025-06-19 07:57:34,REAL,2895667628,490,2895668118,2917844976
2025-06-19 07:57:36,FAKE,2895668118,243,2895668361,2917845514
2025-06-19 07:57:38,REAL,2895668361,491,2895668852,2917846005
2025-06-19 07:57:40,REAL,2895668852,484,2895669336,2917846489
2025-06-19 07:57:42,REAL,2895669336,487,2895669823,2917846976
2025-06-19 07:57:44,REAL,2895669823,491,2895670314,2917847467
2025-06-19 07:57:46,REAL,2895670314,484,2895670798,2917847951
2025-06-19 07:57:48,REAL,2895670798,482,2895671280,2917848433
2025-06-19 07:57:50,REAL,2895671280,492,2895671772,2917848925
2025-06-19 07:57:52,REAL,2895671772,487,2895672259,2917849412
2025-06-19 07:57:54,REAL,2895672259,487,2895672746,2917849899
2025-06-19 07:57:56,FAKE,2895672746,238,2895672984,2917850377
2025-06-19 07:57:58,REAL,2895672984,489,2895673473,2917850866
2025-06-19 07:58:00,REAL,2895673473,536,2895674009,2917851402
2025-06-19 07:58:02,REAL,2895674009,533,2895674542,2917851935
2025-06-19 07:58:04,FAKE,2895674542,244,2895674786,2917852412
2025-06-19 07:58:06,REAL,2895674786,483,2895675269,2917852895
2025-06-19 07:58:08,REAL,2895675269,1487,2895676756,2917854382
2025-06-19 07:58:10,FAKE,2895676756,238,2895676994,2917866628
2025-06-19 07:58:12,REAL,2895676994,10257,2895687251,2917876885
2025-06-19 07:58:14,REAL,2895687251,10323,2895697574,2917887208
2025-06-19 07:58:16,FAKE,2895697574,241,2895697815,2917897460
2025-06-19 07:58:18,REAL,2895697815,10318,2895708133,2917907778
2025-06-19 07:58:20,REAL,2895708133,10316,2895718449,2917918094
2025-06-19 07:58:22,REAL,2895718449,10259,2895728708,2917928353
2025-06-19 07:58:24,REAL,2895728708,4453,2895733161,2917932806
2025-06-19 07:58:26,REAL,2895733161,534,2895733695,2917933340
2025-06-19 07:58:28,REAL,2895733695,485,2895734180,2917933825
2025-06-19 07:58:30,FAKE,2895734180,244,2895734424,2917934307
2025-06-19 07:58:32,FAKE,2895734424,241,2895734665,2917934787
2025-06-19 07:58:34,REAL,2895734665,486,2895735151,2917935273
2025-06-19 07:58:36,REAL,2895735151,475,2895735626,2917935748
2025-06-19 07:58:38,REAL,2895735626,488,2895736114,2917936236
2025-06-19 07:58:40,REAL,2895736114,2272,2895738386,2917938508
2025-06-19 07:58:42,FAKE,2895738386,243,2895738629,2917952850
2025-06-19 07:58:44,REAL,2895738629,10317,2895748946,2917963167
2025-06-19 07:58:46,FAKE,2895748946,243,2895749189,2917973415
2025-06-19 07:58:48,FAKE,2895749189,243,2895749432,2917983730
2025-06-19 07:58:50,FAKE,2895749432,244,2895749676,2917994045
2025-06-19 07:58:52,REAL,2895749676,10312,2895759988,2918004357
2025-06-19 07:58:54,FAKE,2895759988,238,2895760226,2918014606
2025-06-19 07:58:56,REAL,2895760226,3781,2895764007,2918018387
2025-06-19 07:58:58,FAKE,2895764007,241,2895764248,2918018871
2025-06-19 07:59:00,FAKE,2895764248,243,2895764491,2918019356
2025-06-19 07:59:02,REAL,2895764491,485,2895764976,2918019841
2025-06-19 07:59:04,REAL,2895764976,493,2895765469,2918020334
2025-06-19 07:59:06,FAKE,2895765469,238,2895765707,2918020815
2025-06-19 07:59:08,REAL,2895765707,485,2895766192,2918021300
2025-06-19 07:59:10,FAKE,2895766192,243,2895766435,2918021784
2025-06-19 07:59:12,REAL,2895766435,483,2895766918,2918022267
2025-06-19 07:59:14,REAL,2895766918,533,2895767451,2918022800
2025-06-19 07:59:16,REAL,2895767451,487,2895767938,2918023287
2025-06-19 07:59:18,REAL,2895767938,475,2895768413,2918023762
2025-06-19 07:59:20,FAKE,2895768413,241,2895768654,2918024248
2025-06-19 07:59:22,REAL,2895768654,478,2895769132,2918024726
2025-06-19 07:59:24,REAL,2895769132,483,2895769615,2918025209
2025-06-19 07:59:26,REAL,2895769615,481,2895770096,2918025690
2025-06-19 07:59:28,FAKE,2895770096,243,2895770339,2918026169
2025-06-19 07:59:30,REAL,2895770339,538,2895770877,2918026707
2025-06-19 07:59:32,REAL,2895770877,485,2895771362,2918027192
2025-06-19 07:59:34,REAL,2895771362,481,2895771843,2918027673
2025-06-19 07:59:36,FAKE,2895771843,243,2895772086,2918028208
2025-06-19 07:59:38,FAKE,2895772086,243,2895772329,2918028691
2025-06-19 07:59:40,REAL,2895772329,482,2895772811,2918029173
2025-06-19 07:59:42,REAL,2895772811,479,2895773290,2918029652
2025-06-19 07:59:44,REAL,2895773290,9407,2895782697,2918039059
2025-06-19 07:59:46,FAKE,2895782697,241,2895782938,2918049839
2025-06-19 07:59:48,FAKE,2895782938,244,2895783182,2918060153
2025-06-19 07:59:50,REAL,2895783182,10248,2895793430,2918070401
2025-06-19 07:59:52,REAL,2895793430,10441,2895803871,2918080842
2025-06-19 07:59:54,REAL,2895803871,10117,2895813988,2918090959
2025-06-19 07:59:56,REAL,2895813988,10318,2895824306,2918101277
2025-06-19 07:59:58,FAKE,2895824306,244,2895824550,2918109071
2025-06-19 08:00:00,REAL,2895824550,481,2895825031,2918109552
2025-06-19 08:00:02,FAKE,2895825031,241,2895825272,2918110033
2025-06-19 08:00:04,REAL,2895825272,486,2895825758,2918110519
2025-06-19 08:00:06,REAL,2895825758,480,2895826238,2918110999
2025-06-19 08:00:08,REAL,2895826238,475,2895826713,2918111474
2025-06-19 08:00:10,REAL,2895826713,486,2895827199,2918111960
2025-06-19 08:00:12,REAL,2895827199,494,2895827693,2918112454
2025-06-19 08:00:14,FAKE,2895827693,241,2895827934,2918112943
2025-06-19 08:00:16,REAL,2895827934,493,2895828427,2918113436
2025-06-19 08:00:18,REAL,2895828427,537,2895828964,2918113973
2025-06-19 08:00:20,REAL,2895828964,541,2895829505,2918114514
2025-06-19 08:00:22,REAL,2895829505,482,2895829987,2918114996
2025-06-19 08:00:24,REAL,2895829987,481,2895830468,2918115477
2025-06-19 08:00:26,FAKE,2895830468,244,2895830712,2918115960
2025-06-19 08:00:28,FAKE,2895830712,243,2895830955,2918116449
2025-06-19 08:00:30,REAL,2895830955,483,2895831438,2918116932
2025-06-19 08:00:32,FAKE,2895831438,243,2895831681,2918117415
2025-06-19 08:00:34,FAKE,2895831681,238,2895831919,2918117902
2025-06-19 08:00:36,FAKE,2895831919,238,2895832157,2918118385
2025-06-19 08:00:38,FAKE,2895832157,244,2895832401,2918118865
2025-06-19 08:00:40,REAL,2895832401,482,2895832883,2918119347
2025-06-19 08:00:42,FAKE,2895832883,244,2895833127,2918119893
2025-06-19 08:00:44,REAL,2895833127,484,2895833611,2918120377
2025-06-19 08:00:46,FAKE,2895833611,243,2895833854,2918120857
2025-06-19 08:00:48,FAKE,2895833854,244,2895834098,2918121337
2025-06-19 08:00:50,REAL,2895834098,486,2895834584,2918121823
2025-06-19 08:00:52,REAL,2895834584,533,2895835117,2918122356
2025-06-19 08:00:54,REAL,2895835117,486,2895835603,2918122842
2025-06-19 08:00:56,FAKE,2895835603,241,2895835844,2918123320
2025-06-19 08:00:58,REAL,2895835844,482,2895836326,2918123802
2025-06-19 08:01:00,FAKE,2895836326,238,2895836564,2918124286
2025-06-19 08:01:02,REAL,2895836564,483,2895837047,2918124769
2025-06-19 08:01:04,REAL,2895837047,537,2895837584,2918125306
2025-06-19 08:01:06,REAL,2895837584,493,2895838077,2918125799
2025-06-19 08:01:08,REAL,2895838077,486,2895838563,2918126285
2025-06-19 08:01:10,FAKE,2895838563,243,2895838806,2918126762
2025-06-19 08:01:12,REAL,2895838806,489,2895839295,2918127251
2025-06-19 08:01:14,FAKE,2895839295,244,2895839539,2918127738
2025-06-19 08:01:16,REAL,2895839539,485,2895840024,2918128223
2025-06-19 08:01:18,FAKE,2895840024,238,2895840262,2918128710
2025-06-19 08:01:20,REAL,2895840262,481,2895840743,2918129191
2025-06-19 08:01:22,REAL,2895840743,486,2895841229,2918129677
2025-06-19 08:01:24,REAL,2895841229,544,2895841773,2918130221
2025-06-19 08:01:26,REAL,2895841773,535,2895842308,2918130756
2025-06-19 08:01:28,REAL,2895842308,483,2895842791,2918131239
2025-06-19 08:01:30,REAL,2895842791,482,2895843273,2918131721
2025-06-19 08:01:32,REAL,2895843273,486,2895843759,2918132207
2025-06-19 08:01:34,FAKE,2895843759,243,2895844002,2918132685
2025-06-19 08:01:36,REAL,2895844002,477,2895844479,2918133162
2025-06-19 08:01:38,REAL,2895844479,479,2895844958,2918133641
2025-06-19 08:01:40,FAKE,2895844958,241,2895845199,2918140336
2025-06-19 08:01:42,REAL,2895845199,13161,2895858360,2918153497
2025-06-19 08:01:44,REAL,2895858360,10258,2895868618,2918163755
2025-06-19 08:01:46,FAKE,2895868618,238,2895868856,2918174074
2025-06-19 08:01:48,REAL,2895868856,10314,2895879170,2918184388
2025-06-19 08:01:50,FAKE,2895879170,243,2895879413,2918194710
2025-06-19 08:01:52,REAL,2895879413,10247,2895889660,2918204957
2025-06-19 08:01:54,REAL,2895889660,10247,2895899907,2918215204
2025-06-19 08:01:56,REAL,2895899907,814,2895900721,2918216018
2025-06-19 08:01:58,REAL,2895900721,484,2895901205,2918216502
2025-06-19 08:02:00,FAKE,2895901205,238,2895901443,2918216979
2025-06-19 08:02:02,REAL,2895901443,487,2895901930,2918217466
2025-06-19 08:02:04,FAKE,2895901930,238,2895902168,2918217950
2025-06-19 08:02:06,REAL,2895902168,485,2895902653,2918218435
2025-06-19 08:02:08,REAL,2895902653,484,2895903137,2918218919
2025-06-19 08:02:10,REAL,2895903137,545,2895903682,2918219464
2025-06-19 08:02:12,REAL,2895903682,540,2895904222,2918220004
2025-06-19 08:02:14,REAL,2895904222,482,2895904704,2918220486
2025-06-19 08:02:16,REAL,2895904704,481,2895905185,2918220967
2025-06-19 08:02:18,FAKE,2895905185,244,2895905429,2918221451
2025-06-19 08:02:20,REAL,2895905429,492,2895905921,2918221943
2025-06-19 08:02:22,REAL,2895905921,483,2895906404,2918222426
2025-06-19 08:02:24,REAL,2895906404,484,2895906888,2918222910
2025-06-19 08:02:26,REAL,2895906888,488,2895907376,2918223398
2025-06-19 08:02:28,FAKE,2895907376,238,2895907614,2918223875
2025-06-19 08:02:30,REAL,2895907614,481,2895908095,2918224356
2025-06-19 08:02:32,REAL,2895908095,550,2895908645,2918224906
2025-06-19 08:02:34,FAKE,2895908645,244,2895908889,2918225391
2025-06-19 08:02:36,REAL,2895908889,490,2895909379,2918225881
2025-06-19 08:02:38,REAL,2895909379,486,2895909865,2918226367
2025-06-19 08:02:40,REAL,2895909865,483,2895910348,2918226850
2025-06-19 08:02:42,FAKE,2895910348,243,2895910591,2918227343
2025-06-19 08:02:44,FAKE,2895910591,244,2895910835,2918227834
2025-06-19 08:02:46,REAL,2895910835,544,2895911379,2918228378
2025-06-19 08:02:48,REAL,2895911379,475,2895911854,2918228853
2025-06-19 08:02:50,REAL,2895911854,481,2895912335,2918229334
2025-06-19 08:02:52,REAL,2895912335,484,2895912819,2918229818
2025-06-19 08:02:54,REAL,2895912819,534,2895913353,2918230352
2025-06-19 08:02:56,REAL,2895913353,485,2895913838,2918230837
2025-06-19 08:02:58,REAL,2895913838,492,2895914330,2918231329
2025-06-19 08:03:00,FAKE,2895914330,243,2895914573,2918239339
2025-06-19 08:03:02,REAL,2895914573,10848,2895925421,2918250187
2025-06-19 08:03:04,FAKE,2895925421,244,2895925665,2918260429
2025-06-19 08:03:06,REAL,2895925665,10319,2895935984,2918270748
2025-06-19 08:03:08,REAL,2895935984,10251,2895946235,2918280999
2025-06-19 08:03:10,REAL,2895946235,10261,2895956496,2918291260
2025-06-19 08:03:12,FAKE,2895956496,241,2895956737,2918301519
2025-06-19 08:03:14,FAKE,2895956737,238,2895956975,2918310523
2025-06-19 08:03:16,REAL,2895956975,544,2895957519,2918311067
2025-06-19 08:03:18,FAKE,2895957519,241,2895957760,2918311624
2025-06-19 08:03:20,REAL,2895957760,485,2895958245,2918312109
2025-06-19 08:03:22,REAL,2895958245,485,2895958730,2918312594
2025-06-19 08:03:24,FAKE,2895958730,241,2895958971,2918313080
2025-06-19 08:03:26,REAL,2895958971,490,2895959461,2918313570
2025-06-19 08:03:28,REAL,2895959461,483,2895959944,2918314053
2025-06-19 08:03:30,FAKE,2895959944,241,2895960185,2918314540
2025-06-19 08:03:32,FAKE,2895960185,243,2895960428,2918315082
2025-06-19 08:03:34,FAKE,2895960428,243,2895960671,2918315560
2025-06-19 08:03:36,FAKE,2895960671,243,2895960914,2918316041
2025-06-19 08:03:38,REAL,2895960914,541,2895961455,2918316582
2025-06-19 08:03:40,REAL,2895961455,487,2895961942,2918317069
2025-06-19 08:03:42,FAKE,2895961942,238,2895962180,2918317558
2025-06-19 08:03:44,REAL,2895962180,478,2895962658,2918318036
2025-06-19 08:03:46,REAL,2895962658,489,2895963147,2918318525
2025-06-19 08:03:48,REAL,2895963147,487,2895963634,2918319012
2025-06-19 08:03:50,REAL,2895963634,491,2895964125,2918319503
2025-06-19 08:03:52,REAL,2895964125,480,2895964605,2918319983
2025-06-19 08:03:54,FAKE,2895964605,241,2895964846,2918320466
2025-06-19 08:03:56,FAKE,2895964846,244,2895965090,2918320948
2025-06-19 08:03:58,REAL,2895965090,492,2895965582,2918321440
2025-06-19 08:04:00,REAL,2895965582,543,2895966125,2918321983
2025-06-19 08:04:02,REAL,2895966125,488,2895966613,2918322471
2025-06-19 08:04:04,REAL,2895966613,476,2895967089,2918322947
2025-06-19 08:04:06,FAKE,2895967089,243,2895967332,2918323491
2025-06-19 08:04:08,REAL,2895967332,480,2895967812,2918323971
2025-06-19 08:04:10,REAL,2895967812,480,2895968292,2918324451
2025-06-19 08:04:12,FAKE,2895968292,241,2895968533,2918324934
2025-06-19 08:04:14,REAL,2895968533,479,2895969012,2918325413
2025-06-19 08:04:16,REAL,2895969012,490,2895969502,2918325903
2025-06-19 08:04:18,REAL,2895969502,480,2895969982,2918326383
2025-06-19 08:04:20,REAL,2895969982,484,2895970466,2918326867
2025-06-19 08:04:22,FAKE,2895970466,243,2895970709,2918327350
2025-06-19 08:04:24,REAL,2895970709,494,2895971203,2918327844
2025-06-19 08:04:26,REAL,2895971203,487,2895971690,2918328331
2025-06-19 08:04:28,REAL,2895971690,478,2895972168,2918328809
2025-06-19 08:04:30,FAKE,2895972168,244,2895972412,2918329286
2025-06-19 08:04:32,REAL,2895972412,478,2895972890,2918329764
2025-06-19 08:04:34,REAL,2895972890,545,2895973435,2918330309
2025-06-19 08:04:36,FAKE,2895973435,241,2895973676,2918330800
2025-06-19 08:04:38,REAL,2895973676,477,2895974153,2918331277
2025-06-19 08:04:40,REAL,2895974153,536,2895974689,2918331813
2025-06-19 08:04:42,REAL,2895974689,485,2895975174,2918332298
2025-06-19 08:04:44,FAKE,2895975174,241,2895975415,2918332782
2025-06-19 08:04:46,FAKE,2895975415,241,2895975656,2918333266
2025-06-19 08:04:48,REAL,2895975656,486,2895976142,2918333752
2025-06-19 08:04:50,REAL,2895976142,484,2895976626,2918334236
2025-06-19 08:04:52,REAL,2895976626,476,2895977102,2918334712
2025-06-19 08:04:54,REAL,2895977102,483,2895977585,2918335195
2025-06-19 08:04:56,REAL,2895977585,484,2895978069,2918335679
2025-06-19 08:04:58,REAL,2895978069,480,2895978549,2918336159
2025-06-19 08:05:00,FAKE,2895978549,243,2895978792,2918336648
2025-06-19 08:05:02,REAL,2895978792,484,2895979276,2918337132
2025-06-19 08:05:04,REAL,2895979276,478,2895979754,2918337610
2025-06-19 08:05:06,REAL,2895979754,480,2895980234,2918338090
2025-06-19 08:05:08,FAKE,2895980234,243,2895980477,2918338634
2025-06-19 08:05:10,REAL,2895980477,476,2895980953,2918339110
2025-06-19 08:05:12,FAKE,2895980953,241,2895981194,2918339603
2025-06-19 08:05:14,FAKE,2895981194,241,2895981435,2918340146
2025-06-19 08:05:16,REAL,2895981435,485,2895981920,2918340631
2025-06-19 08:05:18,REAL,2895981920,484,2895982404,2918341115
2025-06-19 08:05:20,REAL,2895982404,484,2895982888,2918341599
2025-06-19 08:05:22,REAL,2895982888,5378,2895988266,2918346977
2025-06-19 08:05:24,REAL,2895988266,14671,2896002937,2918361648
2025-06-19 08:05:26,REAL,2896002937,10317,2896013254,2918371965
2025-06-19 08:05:28,FAKE,2896013254,243,2896013497,2918382212
2025-06-19 08:05:30,REAL,2896013497,10314,2896023811,2918392526
2025-06-19 08:05:32,REAL,2896023811,10251,2896034062,2918402777
2025-06-19 08:05:34,REAL,2896034062,10255,2896044317,2918413032
2025-06-19 08:05:36,REAL,2896044317,10313,2896054630,2918423345
2025-06-19 08:05:38,FAKE,2896054630,241,2896054871,2918424822
2025-06-19 08:05:40,REAL,2896054871,490,2896055361,2918425312
2025-06-19 08:05:42,REAL,2896055361,541,2896055902,2918425853
2025-06-19 08:05:44,REAL,2896055902,488,2896056390,2918426341
2025-06-19 08:05:46,REAL,2896056390,474,2896056864,2918426815
2025-06-19 08:05:48,FAKE,2896056864,244,2896057108,2918427293
2025-06-19 08:05:50,FAKE,2896057108,243,2896057351,2918427786
2025-06-19 08:05:52,FAKE,2896057351,241,2896057592,2918428328
2025-06-19 08:05:54,REAL,2896057592,482,2896058074,2918428810
2025-06-19 08:05:56,REAL,2896058074,479,2896058553,2918429289
2025-06-19 08:05:58,REAL,2896058553,494,2896059047,2918429783
2025-06-19 08:06:00,FAKE,2896059047,244,2896059291,2918430268
2025-06-19 08:06:02,REAL,2896059291,494,2896059785,2918430762
2025-06-19 08:06:04,FAKE,2896059785,244,2896060029,2918437928
2025-06-19 08:06:06,REAL,2896060029,11771,2896071800,2918449699
2025-06-19 08:06:08,REAL,2896071800,10319,2896082119,2918460018
2025-06-19 08:06:10,FAKE,2896082119,244,2896082363,2918470275
2025-06-19 08:06:12,REAL,2896082363,10251,2896092614,2918480526
2025-06-19 08:06:14,REAL,2896092614,10321,2896102935,2918490847
2025-06-19 08:06:16,REAL,2896102935,10249,2896113184,2918501096
2025-06-19 08:06:18,REAL,2896113184,10305,2896123489,2918511401
2025-06-19 08:06:20,REAL,2896123489,950,2896124439,2918512351
2025-06-19 08:06:22,FAKE,2896124439,244,2896124683,2918512826
2025-06-19 08:06:24,FAKE,2896124683,243,2896124926,2918513316
2025-06-19 08:06:26,REAL,2896124926,483,2896125409,2918513799
2025-06-19 08:06:28,FAKE,2896125409,241,2896125650,2918514275
2025-06-19 08:06:30,REAL,2896125650,482,2896126132,2918514757
2025-06-19 08:06:32,FAKE,2896126132,241,2896126373,2918515240
2025-06-19 08:06:34,REAL,2896126373,532,2896126905,2918515772
2025-06-19 08:06:36,FAKE,2896126905,238,2896127143,2918522206
2025-06-19 08:06:38,FAKE,2896127143,243,2896127386,2918533185
2025-06-19 08:06:40,REAL,2896127386,10248,2896137634,2918543433
2025-06-19 08:06:42,FAKE,2896137634,243,2896137877,2918553749
2025-06-19 08:06:44,REAL,2896137877,10250,2896148127,2918563999
2025-06-19 08:06:46,REAL,2896148127,10318,2896158445,2918574317
2025-06-19 08:06:48,REAL,2896158445,10253,2896168698,2918584570
2025-06-19 08:06:50,FAKE,2896168698,243,2896168941,2918594690
2025-06-19 08:06:52,REAL,2896168941,540,2896169481,2918595230
2025-06-19 08:06:54,FAKE,2896169481,243,2896169724,2918595720
2025-06-19 08:06:56,REAL,2896169724,483,2896170207,2918596203
2025-06-19 08:06:58,FAKE,2896170207,243,2896170450,2918596684
2025-06-19 08:07:00,REAL,2896170450,488,2896170938,2918597172
2025-06-19 08:07:02,REAL,2896170938,480,2896171418,2918597652
2025-06-19 08:07:04,FAKE,2896171418,244,2896171662,2918598196
2025-06-19 08:07:06,FAKE,2896171662,244,2896171906,2918598687
2025-06-19 08:07:08,REAL,2896171906,6952,2896178858,2918605639
2025-06-19 08:07:10,FAKE,2896178858,244,2896179102,2918616489
2025-06-19 08:07:12,REAL,2896179102,10321,2896189423,2918626810
2025-06-19 08:07:14,REAL,2896189423,10246,2896199669,2918637056
2025-06-19 08:07:16,REAL,2896199669,10320,2896209989,2918647376
2025-06-19 08:07:18,FAKE,2896209989,238,2896210227,2918657632
2025-06-19 08:07:20,REAL,2896210227,10323,2896220550,2918667955
2025-06-19 08:07:22,REAL,2896220550,9455,2896230005,2918677410
2025-06-19 08:07:24,REAL,2896230005,486,2896230491,2918677896
2025-06-19 08:07:26,FAKE,2896230491,244,2896230735,2918678386
2025-06-19 08:07:28,REAL,2896230735,550,2896231285,2918678936
2025-06-19 08:07:30,REAL,2896231285,479,2896231764,2918679415
2025-06-19 08:07:32,REAL,2896231764,486,2896232250,2918679901
2025-06-19 08:07:34,REAL,2896232250,479,2896232729,2918680380
2025-06-19 08:07:36,REAL,2896232729,543,2896233272,2918680923
2025-06-19 08:07:38,REAL,2896233272,476,2896233748,2918681399
2025-06-19 08:07:40,FAKE,2896233748,238,2896233986,2918689276
2025-06-19 08:07:42,REAL,2896233986,10657,2896244643,2918699933
2025-06-19 08:07:44,REAL,2896244643,10251,2896254894,2918710184
2025-06-19 08:07:46,FAKE,2896254894,244,2896255138,2918720431
2025-06-19 08:07:48,REAL,2896255138,10317,2896265455,2918730748
2025-06-19 08:07:50,REAL,2896265455,10245,2896275700,2918740993
2025-06-19 08:07:52,FAKE,2896275700,241,2896275941,2918751238
2025-06-19 08:07:54,REAL,2896275941,8868,2896284809,2918760106
2025-06-19 08:07:56,FAKE,2896284809,243,2896285052,2918760593
2025-06-19 08:07:58,REAL,2896285052,483,2896285535,2918761076
2025-06-19 08:08:00,FAKE,2896285535,243,2896285778,2918761564
2025-06-19 08:08:02,REAL,2896285778,541,2896286319,2918762105
2025-06-19 08:08:04,REAL,2896286319,487,2896286806,2918762592
2025-06-19 08:08:06,REAL,2896286806,479,2896287285,2918763071
2025-06-19 08:08:08,REAL,2896287285,542,2896287827,2918763613
2025-06-19 08:08:10,REAL,2896287827,483,2896288310,2918764096
2025-06-19 08:08:12,REAL,2896288310,487,2896288797,2918764583
2025-06-19 08:08:14,REAL,2896288797,486,2896289283,2918765069
2025-06-19 08:08:16,REAL,2896289283,491,2896289774,2918765560
2025-06-19 08:08:18,REAL,2896289774,484,2896290258,2918766044
2025-06-19 08:08:20,FAKE,2896290258,244,2896290502,2918766530
2025-06-19 08:08:22,FAKE,2896290502,241,2896290743,2918767016
2025-06-19 08:08:24,FAKE,2896290743,238,2896290981,2918767504
2025-06-19 08:08:26,FAKE,2896290981,241,2896291222,2918767982
2025-06-19 08:08:28,FAKE,2896291222,243,2896291465,2918768462
2025-06-19 08:08:30,FAKE,2896291465,243,2896291708,2918768948
2025-06-19 08:08:32,REAL,2896291708,474,2896292182,2918769422
2025-06-19 08:08:34,FAKE,2896292182,244,2896292426,2918769903
2025-06-19 08:08:36,FAKE,2896292426,244,2896292670,2918770446
2025-06-19 08:08:38,FAKE,2896292670,244,2896292914,2918770980
2025-06-19 08:08:40,REAL,2896292914,485,2896293399,2918771465
2025-06-19 08:08:42,FAKE,2896293399,238,2896293637,2918771945
2025-06-19 08:08:44,REAL,2896293637,481,2896294118,2918772426
2025-06-19 08:08:46,FAKE,2896294118,238,2896294356,2918772912
2025-06-19 08:08:48,FAKE,2896294356,238,2896294594,2918773396
2025-06-19 08:08:50,REAL,2896294594,481,2896295075,2918773877
2025-06-19 08:08:52,REAL,2896295075,480,2896295555,2918774357
2025-06-19 08:08:54,FAKE,2896295555,238,2896295793,2918774835
2025-06-19 08:08:56,REAL,2896295793,477,2896296270,2918775312
2025-06-19 08:08:58,REAL,2896296270,481,2896296751,2918775793
2025-06-19 08:09:00,REAL,2896296751,493,2896297244,2918776286
2025-06-19 08:09:02,REAL,2896297244,482,2896297726,2918776768
2025-06-19 08:09:04,REAL,2896297726,477,2896298203,2918777245
2025-06-19 08:09:06,REAL,2896298203,477,2896298680,2918777722
2025-06-19 08:09:08,REAL,2896298680,543,2896299223,2918778265
2025-06-19 08:09:10,FAKE,2896299223,241,2896299464,2918778751
2025-06-19 08:09:12,FAKE,2896299464,238,2896299702,2918779295
2025-06-19 08:09:14,FAKE,2896299702,238,2896299940,2918779772
2025-06-19 08:09:16,FAKE,2896299940,241,2896300181,2918780260
2025-06-19 08:09:18,FAKE,2896300181,238,2896300419,2918780752
2025-06-19 08:09:20,REAL,2896300419,490,2896300909,2918781242
2025-06-19 08:09:22,REAL,2896300909,482,2896301391,2918781724
2025-06-19 08:09:24,REAL,2896301391,491,2896301882,2918782215
2025-06-19 08:09:26,REAL,2896301882,482,2896302364,2918782697
2025-06-19 08:09:28,REAL,2896302364,487,2896302851,2918783184
2025-06-19 08:09:30,REAL,2896302851,485,2896303336,2918783669
2025-06-19 08:09:32,REAL,2896303336,485,2896303821,2918784154
2025-06-19 08:09:34,REAL,2896303821,476,2896304297,2918784630
2025-06-19 08:09:36,REAL,2896304297,543,2896304840,2918785173
2025-06-19 08:09:38,FAKE,2896304840,241,2896305081,2918785706
2025-06-19 08:09:40,REAL,2896305081,488,2896305569,2918786194
2025-06-19 08:09:42,REAL,2896305569,10516,2896316085,2918796710
2025-06-19 08:09:44,FAKE,2896316085,238,2896316323,2918807235
2025-06-19 08:09:46,REAL,2896316323,10250,2896326573,2918817485
2025-06-19 08:09:48,REAL,2896326573,10261,2896336834,2918827746
2025-06-19 08:09:50,REAL,2896336834,10252,2896347086,2918837998
2025-06-19 08:09:52,REAL,2896347086,10256,2896357342,2918848254
2025-06-19 08:09:54,REAL,2896357342,10323,2896367665,2918858577
2025-06-19 08:09:56,REAL,2896367665,6687,2896374352,2918865264
2025-06-19 08:09:58,REAL,2896374352,475,2896374827,2918865739
2025-06-19 08:10:00,FAKE,2896374827,241,2896375068,2918866276
2025-06-19 08:10:02,REAL,2896375068,486,2896375554,2918866762
2025-06-19 08:10:04,REAL,2896375554,478,2896376032,2918867240
2025-06-19 08:10:06,REAL,2896376032,484,2896376516,2918867724
2025-06-19 08:10:08,REAL,2896376516,485,2896377001,2918868209
2025-06-19 08:10:10,REAL,2896377001,538,2896377539,2918868747
2025-06-19 08:10:12,REAL,2896377539,491,2896378030,2918869238
2025-06-19 08:10:14,REAL,2896378030,481,2896378511,2918869719
2025-06-19 08:10:16,REAL,2896378511,484,2896378995,2918870203
2025-06-19 08:10:18,FAKE,2896378995,238,2896379233,2918870681
2025-06-19 08:10:20,FAKE,2896379233,238,2896379471,2918871168
2025-06-19 08:10:22,FAKE,2896379471,238,2896379709,2918871646
2025-06-19 08:10:24,REAL,2896379709,487,2896380196,2918872133
2025-06-19 08:10:26,REAL,2896380196,540,2896380736,2918872673
2025-06-19 08:10:28,FAKE,2896380736,244,2896380980,2918873158
2025-06-19 08:10:30,REAL,2896380980,479,2896381459,2918873637
2025-06-19 08:10:32,REAL,2896381459,486,2896381945,2918874123
2025-06-19 08:10:34,FAKE,2896381945,244,2896382189,2918874614
2025-06-19 08:10:36,REAL,2896382189,485,2896382674,2918875099
2025-06-19 08:10:38,REAL,2896382674,485,2896383159,2918875584
2025-06-19 08:10:40,FAKE,2896383159,243,2896383402,2918876065
2025-06-19 08:10:42,REAL,2896383402,485,2896383887,2918876550
2025-06-19 08:10:44,REAL,2896383887,494,2896384381,2918877044
2025-06-19 08:10:46,REAL,2896384381,478,2896384859,2918877522
2025-06-19 08:10:48,FAKE,2896384859,244,2896385103,2918878008
2025-06-19 08:10:50,FAKE,2896385103,244,2896385347,2918878546
2025-06-19 08:10:52,REAL,2896385347,487,2896385834,2918879033
2025-06-19 08:10:54,REAL,2896385834,484,2896386318,2918879517
2025-06-19 08:10:56,REAL,2896386318,483,2896386801,2918880000
2025-06-19 08:10:58,REAL,2896386801,486,2896387287,2918880486
2025-06-19 08:11:00,FAKE,2896387287,244,2896387531,2918881034
2025-06-19 08:11:02,FAKE,2896387531,241,2896387772,2918881522
2025-06-19 08:11:04,FAKE,2896387772,243,2896388015,2918882007
2025-06-19 08:11:06,FAKE,2896388015,243,2896388258,2918882492
2025-06-19 08:11:08,REAL,2896388258,484,2896388742,2918882976
2025-06-19 08:11:10,REAL,2896388742,483,2896389225,2918883459
2025-06-19 08:11:12,REAL,2896389225,482,2896389707,2918883941
2025-06-19 08:11:14,FAKE,2896389707,244,2896389951,2918884488
2025-06-19 08:11:16,REAL,2896389951,483,2896390434,2918884971
2025-06-19 08:11:18,REAL,2896390434,487,2896390921,2918885458
2025-06-19 08:11:20,REAL,2896390921,489,2896391410,2918885947
2025-06-19 08:11:22,REAL,2896391410,483,2896391893,2918886430
2025-06-19 08:11:24,FAKE,2896391893,243,2896392136,2918886916
2025-06-19 08:11:26,REAL,2896392136,489,2896392625,2918887405
2025-06-19 08:11:28,REAL,2896392625,485,2896393110,2918887890
2025-06-19 08:11:30,FAKE,2896393110,238,2896393348,2918888372
2025-06-19 08:11:32,REAL,2896393348,483,2896393831,2918888855
2025-06-19 08:11:34,FAKE,2896393831,243,2896394074,2918889336
2025-06-19 08:11:36,REAL,2896394074,485,2896394559,2918889821
2025-06-19 08:11:38,FAKE,2896394559,238,2896394797,2918890356
2025-06-19 08:11:40,REAL,2896394797,480,2896395277,2918890836
2025-06-19 08:11:42,FAKE,2896395277,241,2896395518,2918891323
2025-06-19 08:11:44,REAL,2896395518,489,2896396007,2918891812
2025-06-19 08:11:46,REAL,2896396007,481,2896396488,2918892293
2025-06-19 08:11:48,FAKE,2896396488,243,2896396731,2918892780
2025-06-19 08:11:50,FAKE,2896396731,243,2896396974,2918893316
2025-06-19 08:11:52,REAL,2896396974,484,2896397458,2918893800
2025-06-19 08:11:54,REAL,2896397458,480,2896397938,2918894280
2025-06-19 08:11:56,REAL,2896397938,490,2896398428,2918894770
2025-06-19 08:11:58,REAL,2896398428,490,2896398918,2918895260
2025-06-19 08:12:00,REAL,2896398918,474,2896399392,2918895734
2025-06-19 08:12:02,REAL,2896399392,536,2896399928,2918896270
2025-06-19 08:12:04,REAL,2896399928,486,2896400414,2918896756
2025-06-19 08:12:06,REAL,2896400414,485,2896400899,2918897241
2025-06-19 08:12:08,REAL,2896400899,489,2896401388,2918897730
2025-06-19 08:12:10,REAL,2896401388,478,2896401866,2918898208
2025-06-19 08:12:12,REAL,2896401866,488,2896402354,2918898696
2025-06-19 08:12:14,FAKE,2896402354,244,2896402598,2918899186
2025-06-19 08:12:16,REAL,2896402598,479,2896403077,2918899665
2025-06-19 08:12:18,REAL,2896403077,488,2896403565,2918900153
2025-06-19 08:12:20,FAKE,2896403565,241,2896403806,2918900646
2025-06-19 08:12:22,REAL,2896403806,481,2896404287,2918901127
2025-06-19 08:12:24,REAL,2896404287,2207,2896406494,2918903334
2025-06-19 08:12:26,REAL,2896406494,11183,2896417677,2918914517
2025-06-19 08:12:28,FAKE,2896417677,244,2896417921,2918924826
2025-06-19 08:12:30,FAKE,2896417921,244,2896418165,2918935139
2025-06-19 08:12:32,REAL,2896418165,10246,2896428411,2918945385
2025-06-19 08:12:34,REAL,2896428411,10319,2896438730,2918955704
2025-06-19 08:12:36,REAL,2896438730,10324,2896449054,2918966028
2025-06-19 08:12:38,REAL,2896449054,10247,2896459301,2918976275
2025-06-19 08:12:40,REAL,2896459301,3919,2896463220,2918980194
2025-06-19 08:12:42,FAKE,2896463220,243,2896463463,2918980677
2025-06-19 08:12:44,REAL,2896463463,479,2896463942,2918981156
2025-06-19 08:12:46,REAL,2896463942,479,2896464421,2918981635
2025-06-19 08:12:48,REAL,2896464421,493,2896464914,2918982128
2025-06-19 08:12:50,REAL,2896464914,2412,2896467326,2918984540
2025-06-19 08:12:52,REAL,2896467326,11903,2896479229,2918996443
2025-06-19 08:12:54,FAKE,2896479229,238,2896479467,2919006763
2025-06-19 08:12:56,REAL,2896479467,10243,2896489710,2919017006
2025-06-19 08:12:58,REAL,2896489710,10257,2896499967,2919027263
2025-06-19 08:13:00,REAL,2896499967,10253,2896510220,2919037516
2025-06-19 08:13:02,FAKE,2896510220,244,2896510464,2919047775
2025-06-19 08:13:04,REAL,2896510464,10249,2896520713,2919058024
2025-06-19 08:13:06,REAL,2896520713,6167,2896526880,2919064191
2025-06-19 08:13:08,REAL,2896526880,11639,2896538519,2919075830
2025-06-19 08:13:10,REAL,2896538519,10260,2896548779,2919086090
2025-06-19 08:13:12,FAKE,2896548779,238,2896549017,2919096337
2025-06-19 08:13:14,REAL,2896549017,10312,2896559329,2919106649
2025-06-19 08:13:16,FAKE,2896559329,241,2896559570,2919116960
2025-06-19 08:13:18,REAL,2896559570,10251,2896569821,2919127211
2025-06-19 08:13:20,FAKE,2896569821,244,2896570065,2919137458
2025-06-19 08:13:22,REAL,2896570065,3389,2896573454,2919140847
2025-06-19 08:13:24,REAL,2896573454,486,2896573940,2919141333
2025-06-19 08:13:26,REAL,2896573940,488,2896574428,2919141821
2025-06-19 08:13:28,REAL,2896574428,489,2896574917,2919142310
2025-06-19 08:13:30,REAL,2896574917,487,2896575404,2919142797
2025-06-19 08:13:32,REAL,2896575404,486,2896575890,2919143283
2025-06-19 08:13:34,FAKE,2896575890,243,2896576133,2919143768
2025-06-19 08:13:36,REAL,2896576133,481,2896576614,2919144249
2025-06-19 08:13:38,REAL,2896576614,3400,2896580014,2919147649
2025-06-19 08:13:40,REAL,2896580014,11495,2896591509,2919159144
2025-06-19 08:13:42,REAL,2896591509,10253,2896601762,2919169397
2025-06-19 08:13:44,FAKE,2896601762,238,2896602000,2919179659
2025-06-19 08:13:46,REAL,2896602000,10259,2896612259,2919189918
2025-06-19 08:13:48,FAKE,2896612259,238,2896612497,2919200235
2025-06-19 08:13:50,REAL,2896612497,10253,2896622750,2919210488
2025-06-19 08:13:52,FAKE,2896622750,241,2896622991,2919220735
2025-06-19 08:13:54,REAL,2896622991,2787,2896625778,2919223522
2025-06-19 08:13:56,FAKE,2896625778,241,2896626019,2919224013
2025-06-19 08:13:58,REAL,2896626019,484,2896626503,2919224497
2025-06-19 08:14:00,REAL,2896626503,480,2896626983,2919224977
2025-06-19 08:14:02,REAL,2896626983,482,2896627465,2919225459
2025-06-19 08:14:04,FAKE,2896627465,243,2896627708,2919225943
2025-06-19 08:14:06,REAL,2896627708,545,2896628253,2919226488
2025-06-19 08:14:08,REAL,2896628253,483,2896628736,2919226971
2025-06-19 08:14:10,REAL,2896628736,246,2896628982,2919227217
2025-06-19 08:14:12,REAL,2896628982,477,2896629459,2919227694
2025-06-19 08:14:14,REAL,2896629459,482,2896629941,2919228176
2025-06-19 08:14:16,REAL,2896629941,480,2896630421,2919228656
2025-06-19 08:14:18,REAL,2896630421,477,2896630898,2919229133
2025-06-19 08:14:20,REAL,2896630898,492,2896631390,2919229625
2025-06-19 08:14:22,FAKE,2896631390,241,2896631631,2919230106
2025-06-19 08:14:24,FAKE,2896631631,243,2896631874,2919230587
2025-06-19 08:14:26,REAL,2896631874,480,2896632354,2919231067
2025-06-19 08:14:28,FAKE,2896632354,244,2896632598,2919231599
2025-06-19 08:14:30,REAL,2896632598,484,2896633082,2919232083
2025-06-19 08:14:32,REAL,2896633082,10459,2896643541,2919242542
2025-06-19 08:14:34,FAKE,2896643541,243,2896643784,2919252979
2025-06-19 08:14:36,REAL,2896643784,10249,2896654033,2919263228
2025-06-19 08:14:38,REAL,2896654033,10252,2896664285,2919273480
2025-06-19 08:14:40,REAL,2896664285,10318,2896674603,2919283798
2025-06-19 08:14:42,REAL,2896674603,10252,2896684855,2919294050
2025-06-19 08:14:44,FAKE,2896684855,244,2896685099,2919304371
2025-06-19 08:14:46,REAL,2896685099,6689,2896691788,2919311060
2025-06-19 08:14:48,REAL,2896691788,484,2896692272,2919311544
2025-06-19 08:14:50,REAL,2896692272,481,2896692753,2919312025
2025-06-19 08:14:52,REAL,2896692753,474,2896693227,2919312499
2025-06-19 08:14:54,REAL,2896693227,490,2896693717,2919312989
2025-06-19 08:14:56,REAL,2896693717,485,2896694202,2919313474
2025-06-19 08:14:58,FAKE,2896694202,238,2896694440,2919313960
2025-06-19 08:15:00,REAL,2896694440,483,2896694923,2919314443
2025-06-19 08:15:02,REAL,2896694923,541,2896695464,2919314984
2025-06-19 08:15:04,REAL,2896695464,494,2896695958,2919315478
2025-06-19 08:15:06,REAL,2896695958,491,2896696449,2919315969
2025-06-19 08:15:08,REAL,2896696449,485,2896696934,2919316454
2025-06-19 08:15:10,REAL,2896696934,487,2896697421,2919316941
2025-06-19 08:15:12,REAL,2896697421,483,2896697904,2919317424
2025-06-19 08:15:14,FAKE,2896697904,238,2896698142,2919317911
2025-06-19 08:15:16,REAL,2896698142,490,2896698632,2919318401
2025-06-19 08:15:18,REAL,2896698632,482,2896699114,2919318883
2025-06-19 08:15:20,FAKE,2896699114,238,2896699352,2919319425
2025-06-19 08:15:22,REAL,2896699352,488,2896699840,2919319913
2025-06-19 08:15:24,FAKE,2896699840,241,2896700081,2919320407
2025-06-19 08:15:26,REAL,2896700081,480,2896700561,2919320887
2025-06-19 08:15:28,REAL,2896700561,487,2896701048,2919321374
2025-06-19 08:15:30,REAL,2896701048,488,2896701536,2919321862
2025-06-19 08:15:32,FAKE,2896701536,244,2896701780,2919322401
2025-06-19 08:15:34,REAL,2896701780,479,2896702259,2919322880
2025-06-19 08:15:36,REAL,2896702259,482,2896702741,2919323362
2025-06-19 08:15:38,REAL,2896702741,484,2896703225,2919323846
2025-06-19 08:15:40,REAL,2896703225,488,2896703713,2919324334
2025-06-19 08:15:42,FAKE,2896703713,244,2896703957,2919324818
2025-06-19 08:15:44,FAKE,2896703957,238,2896704195,2919325297
2025-06-19 08:15:46,REAL,2896704195,487,2896704682,2919325784
2025-06-19 08:15:48,FAKE,2896704682,244,2896704926,2919326264
2025-06-19 08:15:50,REAL,2896704926,6171,2896711097,2919332435
2025-06-19 08:15:52,FAKE,2896711097,243,2896711340,2919343414
2025-06-19 08:15:54,REAL,2896711340,10314,2896721654,2919353728
2025-06-19 08:15:56,FAKE,2896721654,243,2896721897,2919363987
2025-06-19 08:15:58,REAL,2896721897,10317,2896732214,2919374304
2025-06-19 08:16:00,REAL,2896732214,10310,2896742524,2919384614
2025-06-19 08:16:02,REAL,2896742524,10325,2896752849,2919394939
2025-06-19 08:16:04,FAKE,2896752849,244,2896753093,2919405265
2025-06-19 08:16:06,FAKE,2896753093,238,2896753331,2919405758
2025-06-19 08:16:08,REAL,2896753331,487,2896753818,2919406245
2025-06-19 08:16:10,REAL,2896753818,488,2896754306,2919406733
2025-06-19 08:16:12,REAL,2896754306,486,2896754792,2919407219
2025-06-19 08:16:14,FAKE,2896754792,238,2896755030,2919407699
2025-06-19 08:16:16,REAL,2896755030,487,2896755517,2919408186
2025-06-19 08:16:18,FAKE,2896755517,241,2896755758,2919408666
2025-06-19 08:16:20,REAL,2896755758,486,2896756244,2919409152
2025-06-19 08:16:22,REAL,2896756244,8818,2896765062,2919417970
2025-06-19 08:16:24,REAL,2896765062,12897,2896777959,2919430867
2025-06-19 08:16:26,REAL,2896777959,10259,2896788218,2919441126
2025-06-19 08:16:28,REAL,2896788218,10436,2896798654,2919451562
2025-06-19 08:16:30,REAL,2896798654,10256,2896808910,2919461818
2025-06-19 08:16:32,REAL,2896808910,10319,2896819229,2919472137
2025-06-19 08:16:34,REAL,2896819229,10254,2896829483,2919482391
2025-06-19 08:16:36,FAKE,2896829483,244,2896829727,2919492114
2025-06-19 08:16:38,FAKE,2896829727,243,2896829970,2919492599
2025-06-19 08:16:40,FAKE,2896829970,244,2896830214,2919493081
2025-06-19 08:16:42,FAKE,2896830214,238,2896830452,2919493565
2025-06-19 08:16:44,REAL,2896830452,487,2896830939,2919494052
2025-06-19 08:16:46,REAL,2896830939,488,2896831427,2919494540
2025-06-19 08:16:48,REAL,2896831427,481,2896831908,2919495021
2025-06-19 08:16:50,REAL,2896831908,487,2896832395,2919495508
2025-06-19 08:16:52,REAL,2896832395,479,2896832874,2919495987
2025-06-19 08:16:54,REAL,2896832874,484,2896833358,2919496471
2025-06-19 08:16:56,REAL,2896833358,487,2896833845,2919496958
2025-06-19 08:16:58,FAKE,2896833845,244,2896834089,2919497496
2025-06-19 08:17:00,REAL,2896834089,485,2896834574,2919497981
2025-06-19 08:17:02,REAL,2896834574,490,2896835064,2919498471
2025-06-19 08:17:04,REAL,2896835064,7695,2896842759,2919506166
2025-06-19 08:17:06,REAL,2896842759,10910,2896853669,2919517076
2025-06-19 08:17:08,FAKE,2896853669,243,2896853912,2919527336
2025-06-19 08:17:10,FAKE,2896853912,243,2896854155,2919537589
2025-06-19 08:17:12,FAKE,2896854155,243,2896854398,2919547841
2025-06-19 08:17:14,REAL,2896854398,10248,2896864646,2919558089
2025-06-19 08:17:16,REAL,2896864646,10258,2896874904,2919568347
2025-06-19 08:17:18,FAKE,2896874904,244,2896875148,2919577542
2025-06-19 08:17:20,REAL,2896875148,477,2896875625,2919578019
2025-06-19 08:17:22,FAKE,2896875625,241,2896875866,2919578506
2025-06-19 08:17:24,FAKE,2896875866,244,2896876110,2919578999
2025-06-19 08:17:26,FAKE,2896876110,238,2896876348,2919579482
2025-06-19 08:17:28,FAKE,2896876348,238,2896876586,2919580015
2025-06-19 08:17:30,FAKE,2896876586,238,2896876824,2919580498
2025-06-19 08:17:32,REAL,2896876824,477,2896877301,2919580975
2025-06-19 08:17:34,REAL,2896877301,482,2896877783,2919581457
2025-06-19 08:17:36,REAL,2896877783,8344,2896886127,2919589801
2025-06-19 08:17:38,REAL,2896886127,10653,2896896780,2919600454
2025-06-19 08:17:40,FAKE,2896896780,244,2896897024,2919610767
2025-06-19 08:17:42,REAL,2896897024,10252,2896907276,2919621019
2025-06-19 08:17:44,FAKE,2896907276,243,2896907519,2919631276
2025-06-19 08:17:46,REAL,2896907519,10251,2896917770,2919641527
2025-06-19 08:17:48,REAL,2896917770,10254,2896928024,2919651781
2025-06-19 08:17:50,REAL,2896928024,8544,2896936568,2919660325
2025-06-19 08:17:52,FAKE,2896936568,238,2896936806,2919660814
2025-06-19 08:17:54,FAKE,2896936806,243,2896937049,2919661300
2025-06-19 08:17:56,REAL,2896937049,537,2896937586,2919661837
2025-06-19 08:17:58,FAKE,2896937586,238,2896937824,2919662317
2025-06-19 08:18:00,REAL,2896937824,482,2896938306,2919662799
2025-06-19 08:18:02,REAL,2896938306,490,2896938796,2919663289
2025-06-19 08:18:04,REAL,2896938796,487,2896939283,2919663776
2025-06-19 08:18:06,REAL,2896939283,487,2896939770,2919664263
2025-06-19 08:18:08,REAL,2896939770,479,2896940249,2919664742
2025-06-19 08:18:10,REAL,2896940249,478,2896940727,2919665220
2025-06-19 08:18:12,REAL,2896940727,491,2896941218,2919665711
2025-06-19 08:18:14,REAL,2896941218,480,2896941698,2919666191
2025-06-19 08:18:16,REAL,2896941698,486,2896942184,2919666677
2025-06-19 08:18:18,REAL,2896942184,541,2896942725,2919667218
2025-06-19 08:18:20,REAL,2896942725,478,2896943203,2919667696
2025-06-19 08:18:22,REAL,2896943203,476,2896943679,2919668172
2025-06-19 08:18:24,REAL,2896943679,490,2896944169,2919668662
2025-06-19 08:18:26,REAL,2896944169,536,2896944705,2919669198
2025-06-19 08:18:28,REAL,2896944705,492,2896945197,2919669690
2025-06-19 08:18:30,REAL,2896945197,477,2896945674,2919670167
2025-06-19 08:18:32,REAL,2896945674,486,2896946160,2919670653
2025-06-19 08:18:34,REAL,2896946160,492,2896946652,2919671145
2025-06-19 08:18:36,REAL,2896946652,484,2896947136,2919671629
2025-06-19 08:18:38,REAL,2896947136,493,2896947629,2919672122
2025-06-19 08:18:40,REAL,2896947629,10398,2896958027,2919682520
2025-06-19 08:18:42,REAL,2896958027,10588,2896968615,2919693108
2025-06-19 08:18:44,REAL,2896968615,10318,2896978933,2919703426
2025-06-19 08:18:46,REAL,2896978933,10252,2896989185,2919713678
2025-06-19 08:18:48,REAL,2896989185,10254,2896999439,2919723932
2025-06-19 08:18:50,FAKE,2896999439,238,2896999677,2919734184
2025-06-19 08:18:52,FAKE,2896999677,238,2896999915,2919744438
2025-06-19 08:18:54,REAL,2896999915,7284,2897007199,2919751722
2025-06-19 08:18:56,REAL,2897007199,546,2897007745,2919752268
2025-06-19 08:18:58,REAL,2897007745,487,2897008232,2919752755
2025-06-19 08:19:00,REAL,2897008232,483,2897008715,2919753238
2025-06-19 08:19:02,REAL,2897008715,475,2897009190,2919753713
2025-06-19 08:19:04,FAKE,2897009190,244,2897009434,2919754195
2025-06-19 08:19:06,REAL,2897009434,480,2897009914,2919754675
2025-06-19 08:19:08,REAL,2897009914,479,2897010393,2919755154
2025-06-19 08:19:10,REAL,2897010393,485,2897010878,2919755639
2025-06-19 08:19:12,FAKE,2897010878,244,2897011122,2919756119
2025-06-19 08:19:14,REAL,2897011122,490,2897011612,2919756609
2025-06-19 08:19:16,REAL,2897011612,479,2897012091,2919757088
2025-06-19 08:19:18,FAKE,2897012091,241,2897012332,2919757630
2025-06-19 08:19:20,FAKE,2897012332,243,2897012575,2919758112
2025-06-19 08:19:22,FAKE,2897012575,243,2897012818,2919758596
2025-06-19 08:19:24,REAL,2897012818,486,2897013304,2919759082
2025-06-19 08:19:26,REAL,2897013304,489,2897013793,2919759571
2025-06-19 08:19:28,REAL,2897013793,546,2897014339,2919760117
2025-06-19 08:19:30,REAL,2897014339,483,2897014822,2919760600
2025-06-19 08:19:32,REAL,2897014822,485,2897015307,2919761085
2025-06-19 08:19:34,REAL,2897015307,486,2897015793,2919761571
2025-06-19 08:19:36,FAKE,2897015793,241,2897016034,2919762055
2025-06-19 08:19:38,REAL,2897016034,486,2897016520,2919762541
2025-06-19 08:19:40,REAL,2897016520,484,2897017004,2919763025
2025-06-19 08:19:42,REAL,2897017004,479,2897017483,2919763504
2025-06-19 08:19:44,REAL,2897017483,488,2897017971,2919763992
2025-06-19 08:19:46,REAL,2897017971,483,2897018454,2919764475
2025-06-19 08:19:48,REAL,2897018454,481,2897018935,2919764956
2025-06-19 08:19:50,REAL,2897018935,488,2897019423,2919765444
2025-06-19 08:19:52,REAL,2897019423,483,2897019906,2919765927
2025-06-19 08:19:54,REAL,2897019906,548,2897020454,2919766475
2025-06-19 08:19:56,FAKE,2897020454,244,2897020698,2919766960
2025-06-19 08:19:58,FAKE,2897020698,241,2897020939,2919767443
2025-06-19 08:20:00,REAL,2897020939,476,2897021415,2919767919
2025-06-19 08:20:02,FAKE,2897021415,243,2897021658,2919768405
2025-06-19 08:20:04,REAL,2897021658,5831,2897027489,2919774236
2025-06-19 08:20:06,FAKE,2897027489,244,2897027733,2919785153
2025-06-19 08:20:08,REAL,2897027733,10323,2897038056,2919795476
2025-06-19 08:20:10,REAL,2897038056,10245,2897048301,2919805721
2025-06-19 08:20:12,FAKE,2897048301,243,2897048544,2919815969
2025-06-19 08:20:14,FAKE,2897048544,243,2897048787,2919826293
2025-06-19 08:20:16,FAKE,2897048787,244,2897049031,2919836547
2025-06-19 08:20:18,REAL,2897049031,10245,2897059276,2919846792
2025-06-19 08:20:20,REAL,2897059276,818,2897060094,2919847610
2025-06-19 08:20:22,FAKE,2897060094,241,2897060335,2919848092
2025-06-19 08:20:24,REAL,2897060335,488,2897060823,2919848580
2025-06-19 08:20:26,REAL,2897060823,11853,2897072676,2919860433
2025-06-19 08:20:28,FAKE,2897072676,243,2897072919,2919870687
2025-06-19 08:20:30,FAKE,2897072919,241,2897073160,2919881009
2025-06-19 08:20:32,REAL,2897073160,10259,2897083419,2919891268
2025-06-19 08:20:34,REAL,2897083419,10245,2897093664,2919901513
2025-06-19 08:20:36,FAKE,2897093664,244,2897093908,2919911828
2025-06-19 08:20:38,FAKE,2897093908,243,2897094151,2919922137
2025-06-19 08:20:40,REAL,2897094151,5372,2897099523,2919927509
2025-06-19 08:20:42,REAL,2897099523,479,2897100002,2919927988
2025-06-19 08:20:44,REAL,2897100002,484,2897100486,2919928472
2025-06-19 08:20:46,REAL,2897100486,6563,2897107049,2919935035
2025-06-19 08:20:48,REAL,2897107049,11106,2897118155,2919946141
2025-06-19 08:20:50,REAL,2897118155,10255,2897128410,2919956396
2025-06-19 08:20:52,FAKE,2897128410,243,2897128653,2919966710
2025-06-19 08:20:54,FAKE,2897128653,243,2897128896,2919976960
2025-06-19 08:20:56,REAL,2897128896,10248,2897139144,2919987208
2025-06-19 08:20:58,REAL,2897139144,10315,2897149459,2919997523
2025-06-19 08:21:00,REAL,2897149459,9853,2897159312,2920007376
2025-06-19 08:21:02,REAL,2897159312,490,2897159802,2920007866
2025-06-19 08:21:04,FAKE,2897159802,238,2897160040,2920008354
2025-06-19 08:21:06,REAL,2897160040,486,2897160526,2920008840
2025-06-19 08:21:08,REAL,2897160526,481,2897161007,2920009321
2025-06-19 08:21:10,REAL,2897161007,484,2897161491,2920009805
2025-06-19 08:21:12,REAL,2897161491,538,2897162029,2920010343
2025-06-19 08:21:14,FAKE,2897162029,244,2897162273,2920010883
2025-06-19 08:21:16,FAKE,2897162273,243,2897162516,2920011357
2025-06-19 08:21:18,FAKE,2897162516,244,2897162760,2920011841
2025-06-19 08:21:20,FAKE,2897162760,238,2897162998,2920012323
2025-06-19 08:21:22,FAKE,2897162998,244,2897163242,2920012806
2025-06-19 08:21:24,REAL,2897163242,484,2897163726,2920013290
2025-06-19 08:21:26,REAL,2897163726,486,2897164212,2920013776
2025-06-19 08:21:28,REAL,2897164212,487,2897164699,2920014263
2025-06-19 08:21:30,FAKE,2897164699,243,2897164942,2920014744
2025-06-19 08:21:32,REAL,2897164942,492,2897165434,2920015236
2025-06-19 08:21:34,REAL,2897165434,485,2897165919,2920015721
2025-06-19 08:21:36,REAL,2897165919,483,2897166402,2920016204
2025-06-19 08:21:38,FAKE,2897166402,238,2897166640,2920018014
2025-06-19 08:21:40,REAL,2897166640,11770,2897178410,2920029784
2025-06-19 08:21:42,REAL,2897178410,10250,2897188660,2920040034
2025-06-19 08:21:44,REAL,2897188660,10324,2897198984,2920050358
2025-06-19 08:21:46,REAL,2897198984,10247,2897209231,2920060605
2025-06-19 08:21:48,FAKE,2897209231,244,2897209475,2920070981
2025-06-19 08:21:50,FAKE,2897209475,243,2897209718,2920081227
2025-06-19 08:21:52,REAL,2897209718,10253,2897219971,2920091480
2025-06-19 08:21:54,FAKE,2897219971,243,2897220214,2920095533
2025-06-19 08:21:56,REAL,2897220214,488,2897220702,2920096021
2025-06-19 08:21:58,REAL,2897220702,482,2897221184,2920096503
2025-06-19 08:22:00,FAKE,2897221184,238,2897221422,2920096983
2025-06-19 08:22:02,FAKE,2897221422,244,2897221666,2920097475
2025-06-19 08:22:04,FAKE,2897221666,243,2897221909,2920097958
2025-06-19 08:22:06,REAL,2897221909,484,2897222393,2920098442
2025-06-19 08:22:08,FAKE,2897222393,244,2897222637,2920098975
2025-06-19 08:22:10,REAL,2897222637,2797,2897225434,2920101772
2025-06-19 08:22:12,FAKE,2897225434,244,2897225678,2920113152
2025-06-19 08:22:14,FAKE,2897225678,243,2897225921,2920123408
2025-06-19 08:22:16,REAL,2897225921,10325,2897236246,2920133733
2025-06-19 08:22:18,FAKE,2897236246,243,2897236489,2920143982
2025-06-19 08:22:20,REAL,2897236489,10244,2897246733,2920154226
2025-06-19 08:22:22,REAL,2897246733,10300,2897257033,2920164526
2025-06-19 08:22:24,FAKE,2897257033,238,2897257271,2920174777
2025-06-19 08:22:26,FAKE,2897257271,238,2897257509,2920178171
2025-06-19 08:22:28,FAKE,2897257509,243,2897257752,2920178659
2025-06-19 08:22:30,REAL,2897257752,483,2897258235,2920179142
2025-06-19 08:22:32,FAKE,2897258235,244,2897258479,2920179631
2025-06-19 08:22:34,REAL,2897258479,480,2897258959,2920180111
2025-06-19 08:22:36,REAL,2897258959,489,2897259448,2920180600
2025-06-19 08:22:38,REAL,2897259448,534,2897259982,2920181134
2025-06-19 08:22:40,REAL,2897259982,484,2897260466,2920181618
2025-06-19 08:22:42,REAL,2897260466,3399,2897263865,2920185017
2025-06-19 08:22:44,REAL,2897263865,15271,2897279136,2920200288
2025-06-19 08:22:46,REAL,2897279136,10317,2897289453,2920210605
2025-06-19 08:22:48,REAL,2897289453,10254,2897299707,2920220859
2025-06-19 08:22:50,REAL,2897299707,10320,2897310027,2920231179
2025-06-19 08:22:52,REAL,2897310027,10257,2897320284,2920241436
2025-06-19 08:22:54,REAL,2897320284,10244,2897330528,2920251680
2025-06-19 08:22:56,REAL,2897330528,10319,2897340847,2920261999
2025-06-19 08:22:58,REAL,2897340847,2857,2897343704,2920264856
2025-06-19 08:23:00,REAL,2897343704,488,2897344192,2920265344
2025-06-19 08:23:02,FAKE,2897344192,241,2897344433,2920265828
2025-06-19 08:23:04,FAKE,2897344433,238,2897344671,2920266314
2025-06-19 08:23:06,REAL,2897344671,484,2897345155,2920266798
2025-06-19 08:23:08,FAKE,2897345155,243,2897345398,2920267276
2025-06-19 08:23:10,FAKE,2897345398,243,2897345641,2920267821
2025-06-19 08:23:12,REAL,2897345641,484,2897346125,2920268305
2025-06-19 08:23:14,REAL,2897346125,4785,2897350910,2920273090
2025-06-19 08:23:16,REAL,2897350910,11373,2897362283,2920284463
2025-06-19 08:23:18,FAKE,2897362283,241,2897362524,2920294723
2025-06-19 08:23:20,REAL,2897362524,10313,2897372837,2920305036
2025-06-19 08:23:22,REAL,2897372837,10252,2897383089,2920315288
2025-06-19 08:23:24,FAKE,2897383089,243,2897383332,2920325545
2025-06-19 08:23:26,REAL,2897383332,10251,2897393583,2920335796
2025-06-19 08:23:28,REAL,2897393583,10322,2897403905,2920346118
2025-06-19 08:23:30,REAL,2897403905,2139,2897406044,2920348257
2025-06-19 08:23:32,REAL,2897406044,538,2897406582,2920348795
2025-06-19 08:23:34,REAL,2897406582,482,2897407064,2920349277
2025-06-19 08:23:36,REAL,2897407064,490,2897407554,2920349767
2025-06-19 08:23:38,REAL,2897407554,478,2897408032,2920350245
2025-06-19 08:23:40,FAKE,2897408032,238,2897408270,2920350728
2025-06-19 08:23:42,REAL,2897408270,543,2897408813,2920351271
2025-06-19 08:23:44,REAL,2897408813,481,2897409294,2920351752
2025-06-19 08:23:46,FAKE,2897409294,241,2897409535,2920357131
2025-06-19 08:23:48,REAL,2897409535,11172,2897420707,2920368303
2025-06-19 08:23:50,FAKE,2897420707,241,2897420948,2920378564
2025-06-19 08:23:52,FAKE,2897420948,238,2897421186,2920388815
2025-06-19 08:23:54,REAL,2897421186,10258,2897431444,2920399073
2025-06-19 08:23:56,REAL,2897431444,10322,2897441766,2920409395
2025-06-19 08:23:58,REAL,2897441766,10246,2897452012,2920419641
2025-06-19 08:24:00,FAKE,2897452012,241,2897452253,2920429892
2025-06-19 08:24:02,REAL,2897452253,1547,2897453800,2920431439
2025-06-19 08:24:04,REAL,2897453800,543,2897454343,2920431982
2025-06-19 08:24:06,REAL,2897454343,474,2897454817,2920432456
2025-06-19 08:24:08,REAL,2897454817,489,2897455306,2920432945
2025-06-19 08:24:10,REAL,2897455306,475,2897455781,2920433420
2025-06-19 08:24:12,REAL,2897455781,476,2897456257,2920433896
2025-06-19 08:24:14,REAL,2897456257,535,2897456792,2920434431
2025-06-19 08:24:16,FAKE,2897456792,244,2897457036,2920434924
2025-06-19 08:24:18,REAL,2897457036,480,2897457516,2920435404
2025-06-19 08:24:20,REAL,2897457516,488,2897458004,2920435892
2025-06-19 08:24:22,REAL,2897458004,480,2897458484,2920436372
2025-06-19 08:24:24,FAKE,2897458484,243,2897458727,2920436857
2025-06-19 08:24:26,FAKE,2897458727,243,2897458970,2920437347
2025-06-19 08:24:28,FAKE,2897458970,244,2897459214,2920437828
2025-06-19 08:24:30,REAL,2897459214,484,2897459698,2920438312
2025-06-19 08:24:32,REAL,2897459698,485,2897460183,2920438797
2025-06-19 08:24:34,REAL,2897460183,488,2897460671,2920439285
2025-06-19 08:24:36,REAL,2897460671,482,2897461153,2920439767
2025-06-19 08:24:38,REAL,2897461153,486,2897461639,2920440253
2025-06-19 08:24:40,REAL,2897461639,483,2897462122,2920440736
2025-06-19 08:24:42,REAL,2897462122,539,2897462661,2920441275
2025-06-19 08:24:44,REAL,2897462661,477,2897463138,2920441752
2025-06-19 08:24:46,REAL,2897463138,491,2897463629,2920442243
2025-06-19 08:24:48,REAL,2897463629,488,2897464117,2920442731
2025-06-19 08:24:50,REAL,2897464117,479,2897464596,2920443210
2025-06-19 08:24:52,REAL,2897464596,476,2897465072,2920443686
2025-06-19 08:24:54,REAL,2897465072,539,2897465611,2920444225
2025-06-19 08:24:56,FAKE,2897465611,238,2897465849,2920444710
2025-06-19 08:24:58,FAKE,2897465849,243,2897466092,2920445195
2025-06-19 08:25:00,REAL,2897466092,476,2897466568,2920445671
2025-06-19 08:25:02,REAL,2897466568,489,2897467057,2920446160
2025-06-19 08:25:04,FAKE,2897467057,243,2897467300,2920446648
2025-06-19 08:25:06,REAL,2897467300,490,2897467790,2920447138
2025-06-19 08:25:08,REAL,2897467790,484,2897468274,2920447622
2025-06-19 08:25:10,REAL,2897468274,488,2897468762,2920448110
2025-06-19 08:25:12,REAL,2897468762,540,2897469302,2920448650
2025-06-19 08:25:14,FAKE,2897469302,238,2897469540,2920449133
2025-06-19 08:25:16,FAKE,2897469540,241,2897469781,2920449620
2025-06-19 08:25:18,REAL,2897469781,483,2897470264,2920450103
2025-06-19 08:25:20,REAL,2897470264,486,2897470750,2920450589
2025-06-19 08:25:22,FAKE,2897470750,244,2897470994,2920451068
2025-06-19 08:25:24,REAL,2897470994,482,2897471476,2920451550
2025-06-19 08:25:26,REAL,2897471476,486,2897471962,2920452036
2025-06-19 08:25:28,REAL,2897471962,474,2897472436,2920452510
2025-06-19 08:25:30,FAKE,2897472436,238,2897472674,2920452993
2025-06-19 08:25:32,REAL,2897472674,7158,2897479832,2920460151
2025-06-19 08:25:34,FAKE,2897479832,243,2897480075,2920470997
2025-06-19 08:25:36,REAL,2897480075,10253,2897490328,2920481250
2025-06-19 08:25:38,REAL,2897490328,10249,2897500577,2920491499
2025-06-19 08:25:40,FAKE,2897500577,243,2897500820,2920501751
2025-06-19 08:25:42,FAKE,2897500820,243,2897501063,2920512000
2025-06-19 08:25:44,REAL,2897501063,10367,2897511430,2920522367
2025-06-19 08:25:46,REAL,2897511430,9322,2897520752,2920531689
2025-06-19 08:25:48,REAL,2897520752,492,2897521244,2920532181
2025-06-19 08:25:50,REAL,2897521244,485,2897521729,2920532666
2025-06-19 08:25:52,REAL,2897521729,484,2897522213,2920533150
2025-06-19 08:25:54,FAKE,2897522213,241,2897522454,2920533637
2025-06-19 08:25:56,FAKE,2897522454,241,2897522695,2920534124
2025-06-19 08:25:58,REAL,2897522695,477,2897523172,2920534601
2025-06-19 08:26:00,REAL,2897523172,491,2897523663,2920535092
2025-06-19 08:26:02,REAL,2897523663,489,2897524152,2920535581
2025-06-19 08:26:04,REAL,2897524152,482,2897524634,2920536063
2025-06-19 08:26:06,FAKE,2897524634,243,2897524877,2920536540
2025-06-19 08:26:08,FAKE,2897524877,244,2897525121,2920537022
2025-06-19 08:26:10,FAKE,2897525121,241,2897525362,2920537508
2025-06-19 08:26:12,REAL,2897525362,547,2897525909,2920538055
2025-06-19 08:26:14,REAL,2897525909,486,2897526395,2920538541
2025-06-19 08:26:16,FAKE,2897526395,243,2897526638,2920539029
2025-06-19 08:26:18,REAL,2897526638,479,2897527117,2920539508
2025-06-19 08:26:20,REAL,2897527117,478,2897527595,2920539986
2025-06-19 08:26:22,FAKE,2897527595,243,2897527838,2920540468
2025-06-19 08:26:24,REAL,2897527838,486,2897528324,2920540954
2025-06-19 08:26:26,REAL,2897528324,484,2897528808,2920541438
2025-06-19 08:26:28,FAKE,2897528808,243,2897529051,2920541919
2025-06-19 08:26:30,REAL,2897529051,490,2897529541,2920542409
2025-06-19 08:26:32,FAKE,2897529541,238,2897529779,2920542892
2025-06-19 08:26:34,REAL,2897529779,489,2897530268,2920543381
2025-06-19 08:26:36,REAL,2897530268,536,2897530804,2920543917
2025-06-19 08:26:38,REAL,2897530804,487,2897531291,2920544404
2025-06-19 08:26:40,REAL,2897531291,484,2897531775,2920544888
2025-06-19 08:26:42,REAL,2897531775,488,2897532263,2920545376
2025-06-19 08:26:44,FAKE,2897532263,243,2897532506,2920545858
2025-06-19 08:26:46,REAL,2897532506,487,2897532993,2920546345
2025-06-19 08:26:48,REAL,2897532993,483,2897533476,2920546828
2025-06-19 08:26:50,REAL,2897533476,488,2897533964,2920547316
2025-06-19 08:26:52,REAL,2897533964,491,2897534455,2920547807
2025-06-19 08:26:54,REAL,2897534455,535,2897534990,2920548342
2025-06-19 08:26:56,FAKE,2897534990,238,2897535228,2920548827
2025-06-19 08:26:58,REAL,2897535228,483,2897535711,2920549310
2025-06-19 08:27:00,FAKE,2897535711,243,2897535954,2920549791
2025-06-19 08:27:02,FAKE,2897535954,241,2897536195,2920550268
2025-06-19 08:27:04,FAKE,2897536195,244,2897536439,2920550751
2025-06-19 08:27:06,REAL,2897536439,492,2897536931,2920551243
2025-06-19 08:27:08,REAL,2897536931,487,2897537418,2920551730
2025-06-19 08:27:10,FAKE,2897537418,243,2897537661,2920552208
2025-06-19 08:27:12,REAL,2897537661,486,2897538147,2920552694
2025-06-19 08:27:14,REAL,2897538147,494,2897538641,2920553188
2025-06-19 08:27:16,REAL,2897538641,483,2897539124,2920553671
2025-06-19 08:27:18,FAKE,2897539124,243,2897539367,2920554156
2025-06-19 08:27:20,REAL,2897539367,481,2897539848,2920554637
2025-06-19 08:27:22,FAKE,2897539848,241,2897540089,2920555122
2025-06-19 08:27:24,FAKE,2897540089,244,2897540333,2920555612
2025-06-19 08:27:26,FAKE,2897540333,243,2897540576,2920556104
2025-06-19 08:27:28,FAKE,2897540576,244,2897540820,2920556648
2025-06-19 08:27:30,REAL,2897540820,491,2897541311,2920557139
2025-06-19 08:27:32,FAKE,2897541311,238,2897541549,2920560671
2025-06-19 08:27:34,REAL,2897541549,11443,2897552992,2920572114
2025-06-19 08:27:36,REAL,2897552992,10259,2897563251,2920582373
2025-06-19 08:27:38,REAL,2897563251,10256,2897573507,2920592629
2025-06-19 08:27:40,FAKE,2897573507,238,2897573745,2920602946
2025-06-19 08:27:42,REAL,2897573745,10247,2897583992,2920613193
2025-06-19 08:27:44,FAKE,2897583992,243,2897584235,2920623443
2025-06-19 08:27:46,FAKE,2897584235,238,2897584473,2920633759
2025-06-19 08:27:48,REAL,2897584473,2661,2897587134,2920636420
2025-06-19 08:27:50,FAKE,2897587134,241,2897587375,2920636910
2025-06-19 08:27:52,FAKE,2897587375,241,2897587616,2920637400
2025-06-19 08:27:54,FAKE,2897587616,241,2897587857,2920649304
2025-06-19 08:27:56,REAL,2897587857,11372,2897599229,2920660676
2025-06-19 08:27:58,REAL,2897599229,10260,2897609489,2920670936
2025-06-19 08:28:00,REAL,2897609489,10311,2897619800,2920681247
2025-06-19 08:28:02,REAL,2897619800,10249,2897630049,2920691496
2025-06-19 08:28:04,FAKE,2897630049,238,2897630287,2920701749
2025-06-19 08:28:06,REAL,2897630287,10315,2897640602,2920712064
2025-06-19 08:28:08,REAL,2897640602,7156,2897647758,2920719220
2025-06-19 08:28:10,REAL,2897647758,489,2897648247,2920719709
2025-06-19 08:28:12,REAL,2897648247,481,2897648728,2920720190
2025-06-19 08:28:14,FAKE,2897648728,238,2897648966,2920720678
2025-06-19 08:28:16,FAKE,2897648966,238,2897649204,2920721161
2025-06-19 08:28:18,FAKE,2897649204,241,2897649445,2920721701
2025-06-19 08:28:20,FAKE,2897649445,241,2897649686,2920722188
2025-06-19 08:28:22,REAL,2897649686,486,2897650172,2920722674
2025-06-19 08:28:24,FAKE,2897650172,243,2897650415,2920723155
2025-06-19 08:28:26,REAL,2897650415,483,2897650898,2920723638
2025-06-19 08:28:28,REAL,2897650898,478,2897651376,2920724116
2025-06-19 08:28:30,REAL,2897651376,481,2897651857,2920724597
2025-06-19 08:28:32,REAL,2897651857,483,2897652340,2920725080
2025-06-19 08:28:34,FAKE,2897652340,243,2897652583,2920725628
2025-06-19 08:28:36,REAL,2897652583,487,2897653070,2920726115
2025-06-19 08:28:38,FAKE,2897653070,244,2897653314,2920726603
2025-06-19 08:28:40,REAL,2897653314,482,2897653796,2920727085
2025-06-19 08:28:42,REAL,2897653796,486,2897654282,2920727571
2025-06-19 08:28:44,REAL,2897654282,478,2897654760,2920728049
2025-06-19 08:28:46,FAKE,2897654760,241,2897655001,2920728542
2025-06-19 08:28:48,FAKE,2897655001,244,2897655245,2920729033
2025-06-19 08:28:50,REAL,2897655245,491,2897655736,2920729524
2025-06-19 08:28:52,FAKE,2897655736,241,2897655977,2920730009
2025-06-19 08:28:54,REAL,2897655977,491,2897656468,2920730500
2025-06-19 08:28:56,FAKE,2897656468,244,2897656712,2920730986
2025-06-19 08:28:58,FAKE,2897656712,238,2897656950,2920731471
2025-06-19 08:29:00,REAL,2897656950,479,2897657429,2920731950
2025-06-19 08:29:02,REAL,2897657429,484,2897657913,2920732434
2025-06-19 08:29:04,REAL,2897657913,476,2897658389,2920732910
2025-06-19 08:29:06,FAKE,2897658389,241,2897658630,2920733394
2025-06-19 08:29:08,REAL,2897658630,484,2897659114,2920733878
2025-06-19 08:29:10,FAKE,2897659114,241,2897659355,2920734418
2025-06-19 08:29:12,REAL,2897659355,490,2897659845,2920734908
2025-06-19 08:29:14,FAKE,2897659845,243,2897660088,2920735392
2025-06-19 08:29:16,REAL,2897660088,477,2897660565,2920735869
2025-06-19 08:29:18,FAKE,2897660565,243,2897660808,2920741846
2025-06-19 08:29:20,REAL,2897660808,11241,2897672049,2920753087
2025-06-19 08:29:22,REAL,2897672049,10254,2897682303,2920763341
2025-06-19 08:29:24,REAL,2897682303,10256,2897692559,2920773597
2025-06-19 08:29:26,REAL,2897692559,10254,2897702813,2920783851
2025-06-19 08:29:28,REAL,2897702813,10316,2897713129,2920794167
2025-06-19 08:29:30,REAL,2897713129,10257,2897723386,2920804424
2025-06-19 08:29:32,REAL,2897723386,10248,2897733634,2920814672
2025-06-19 08:29:34,REAL,2897733634,748,2897734382,2920815420
2025-06-19 08:29:36,FAKE,2897734382,238,2897734620,2920815902
2025-06-19 08:29:38,REAL,2897734620,481,2897735101,2920816383
2025-06-19 08:29:40,REAL,2897735101,488,2897735589,2920816871
2025-06-19 08:29:42,FAKE,2897735589,241,2897735830,2920817350
2025-06-19 08:29:44,REAL,2897735830,487,2897736317,2920817837
2025-06-19 08:29:46,REAL,2897736317,476,2897736793,2920818313
2025-06-19 08:29:48,REAL,2897736793,488,2897737281,2920818801
2025-06-19 08:29:50,FAKE,2897737281,241,2897737522,2920825631
2025-06-19 08:29:52,FAKE,2897737522,238,2897737760,2920836889
2025-06-19 08:29:54,REAL,2897737760,10247,2897748007,2920847136
2025-06-19 08:29:56,REAL,2897748007,10316,2897758323,2920857452
2025-06-19 08:29:58,FAKE,2897758323,243,2897758566,2920867702
2025-06-19 08:30:00,REAL,2897758566,10246,2897768812,2920877948
2025-06-19 08:30:02,REAL,2897768812,10307,2897779119,2920888255
2025-06-19 08:30:04,REAL,2897779119,9918,2897789037,2920898173
2025-06-19 08:30:06,FAKE,2897789037,241,2897789278,2920898658
2025-06-19 08:30:08,REAL,2897789278,484,2897789762,2920899142
2025-06-19 08:30:10,FAKE,2897789762,238,2897790000,2920899621
2025-06-19 08:30:12,FAKE,2897790000,244,2897790244,2920900108
2025-06-19 08:30:14,REAL,2897790244,487,2897790731,2920900595
2025-06-19 08:30:16,REAL,2897790731,477,2897791208,2920901072
2025-06-19 08:30:18,REAL,2897791208,479,2897791687,2920901551
2025-06-19 08:30:20,REAL,2897791687,482,2897792169,2920902033
2025-06-19 08:30:22,REAL,2897792169,7284,2897799453,2920909317
2025-06-19 08:30:24,REAL,2897799453,10911,2897810364,2920920228
2025-06-19 08:30:26,REAL,2897810364,10314,2897820678,2920930542
2025-06-19 08:30:28,FAKE,2897820678,238,2897820916,2920940791
2025-06-19 08:30:30,REAL,2897820916,10320,2897831236,2920951111
2025-06-19 08:30:32,REAL,2897831236,10260,2897841496,2920961371
2025-06-19 08:30:34,REAL,2897841496,10248,2897851744,2920971619
2025-06-19 08:30:36,FAKE,2897851744,243,2897851987,2920980883
2025-06-19 08:30:38,REAL,2897851987,486,2897852473,2920981369
2025-06-19 08:30:40,REAL,2897852473,487,2897852960,2920981856
2025-06-19 08:30:42,REAL,2897852960,487,2897853447,2920982343
2025-06-19 08:30:44,REAL,2897853447,483,2897853930,2920982826
2025-06-19 08:30:46,REAL,2897853930,480,2897854410,2920983306
2025-06-19 08:30:48,FAKE,2897854410,244,2897854654,2920983788
2025-06-19 08:30:50,FAKE,2897854654,244,2897854898,2920984328
2025-06-19 08:30:52,REAL,2897854898,475,2897855373,2920984803
2025-06-19 08:30:54,REAL,2897855373,8886,2897864259,2920993689
2025-06-19 08:30:56,REAL,2897864259,10782,2897875041,2921004471
2025-06-19 08:30:58,REAL,2897875041,10251,2897885292,2921014722
2025-06-19 08:31:00,REAL,2897885292,10259,2897895551,2921024981
2025-06-19 08:31:02,FAKE,2897895551,238,2897895789,2921035302
2025-06-19 08:31:04,FAKE,2897895789,238,2897896027,2921045550
2025-06-19 08:31:06,REAL,2897896027,10970,2897906997,2921056520
2025-06-19 08:31:08,REAL,2897906997,7699,2897914696,2921064219
2025-06-19 08:31:10,REAL,2897914696,483,2897915179,2921064702
2025-06-19 08:31:12,REAL,2897915179,487,2897915666,2921065189
2025-06-19 08:31:14,FAKE,2897915666,243,2897915909,2921065669
2025-06-19 08:31:16,FAKE,2897915909,241,2897916150,2921066201
2025-06-19 08:31:18,FAKE,2897916150,241,2897916391,2921066684
2025-06-19 08:31:20,REAL,2897916391,484,2897916875,2921067168
2025-06-19 08:31:22,FAKE,2897916875,244,2897917119,2921067653
2025-06-19 08:31:24,FAKE,2897917119,243,2897917362,2921068134
2025-06-19 08:31:26,REAL,2897917362,11768,2897929130,2921079902
2025-06-19 08:31:28,REAL,2897929130,11711,2897940841,2921091613
2025-06-19 08:31:30,FAKE,2897940841,238,2897941079,2921101866
2025-06-19 08:31:32,FAKE,2897941079,238,2897941317,2921112112
2025-06-19 08:31:34,FAKE,2897941317,238,2897941555,2921122368
2025-06-19 08:31:36,REAL,2897941555,10255,2897951810,2921132623
2025-06-19 08:31:38,FAKE,2897951810,244,2897952054,2921142940
2025-06-19 08:31:40,FAKE,2897952054,238,2897952292,2921151012
2025-06-19 08:31:42,REAL,2897952292,476,2897952768,2921151488
2025-06-19 08:31:44,REAL,2897952768,491,2897953259,2921151979
2025-06-19 08:31:46,FAKE,2897953259,241,2897953500,2921155502
2025-06-19 08:31:48,REAL,2897953500,11708,2897965208,2921167210
2025-06-19 08:31:50,REAL,2897965208,10310,2897975518,2921177520
2025-06-19 08:31:52,REAL,2897975518,10258,2897985776,2921187778
2025-06-19 08:31:54,FAKE,2897985776,238,2897986014,2921198037
2025-06-19 08:31:56,REAL,2897986014,10253,2897996267,2921208290
2025-06-19 08:31:58,REAL,2897996267,10253,2898006520,2921218543
2025-06-19 08:32:00,REAL,2898006520,10259,2898016779,2921228802
2025-06-19 08:32:02,FAKE,2898016779,244,2898017023,2921231527
2025-06-19 08:32:04,REAL,2898017023,534,2898017557,2921232061
2025-06-19 08:32:06,FAKE,2898017557,241,2898017798,2921232543
2025-06-19 08:32:08,REAL,2898017798,479,2898018277,2921233022
2025-06-19 08:32:10,FAKE,2898018277,238,2898018515,2921233507
2025-06-19 08:32:12,FAKE,2898018515,243,2898018758,2921233994
2025-06-19 08:32:14,FAKE,2898018758,243,2898019001,2921234483
2025-06-19 08:32:16,FAKE,2898019001,238,2898019239,2921234970
2025-06-19 08:32:18,FAKE,2898019239,243,2898019482,2921239682
2025-06-19 08:32:20,REAL,2898019482,11323,2898030805,2921251005
2025-06-19 08:32:22,REAL,2898030805,10247,2898041052,2921261252
2025-06-19 08:32:24,REAL,2898041052,10319,2898051371,2921271571
2025-06-19 08:32:26,FAKE,2898051371,241,2898051612,2921281822
2025-06-19 08:32:28,FAKE,2898051612,244,2898051856,2921292129
2025-06-19 08:32:30,REAL,2898051856,10254,2898062110,2921302383
2025-06-19 08:32:32,REAL,2898062110,10314,2898072424,2921312697
2025-06-19 08:32:34,FAKE,2898072424,243,2898072667,2921314832
2025-06-19 08:32:36,REAL,2898072667,487,2898073154,2921315319
2025-06-19 08:32:38,REAL,2898073154,475,2898073629,2921315794
2025-06-19 08:32:40,REAL,2898073629,491,2898074120,2921316285
2025-06-19 08:32:42,REAL,2898074120,489,2898074609,2921316774
2025-06-19 08:32:44,REAL,2898074609,493,2898075102,2921317267
2025-06-19 08:32:46,FAKE,2898075102,238,2898075340,2921317754
2025-06-19 08:32:48,FAKE,2898075340,244,2898075584,2921318232
2025-06-19 08:32:50,REAL,2898075584,489,2898076073,2921318721
2025-06-19 08:32:52,REAL,2898076073,489,2898076562,2921319210
2025-06-19 08:32:54,REAL,2898076562,544,2898077106,2921319754
2025-06-19 08:32:56,REAL,2898077106,485,2898077591,2921320239
2025-06-19 08:32:58,FAKE,2898077591,241,2898077832,2921320725
2025-06-19 08:33:00,FAKE,2898077832,244,2898078076,2921321209
2025-06-19 08:33:02,REAL,2898078076,488,2898078564,2921321697
2025-06-19 08:33:04,FAKE,2898078564,244,2898078808,2921322180
2025-06-19 08:33:06,REAL,2898078808,491,2898079299,2921322671
2025-06-19 08:33:08,REAL,2898079299,542,2898079841,2921323213
2025-06-19 08:33:10,REAL,2898079841,493,2898080334,2921323706
2025-06-19 08:33:12,REAL,2898080334,484,2898080818,2921324190
2025-06-19 08:33:14,FAKE,2898080818,238,2898081056,2921324669
2025-06-19 08:33:16,FAKE,2898081056,238,2898081294,2921325150
2025-06-19 08:33:18,REAL,2898081294,548,2898081842,2921325698
2025-06-19 08:33:20,REAL,2898081842,490,2898082332,2921326188
2025-06-19 08:33:22,REAL,2898082332,492,2898082824,2921326680
2025-06-19 08:33:24,REAL,2898082824,483,2898083307,2921327163
2025-06-19 08:33:26,FAKE,2898083307,241,2898083548,2921327646
2025-06-19 08:33:28,FAKE,2898083548,238,2898083786,2921341412
2025-06-19 08:33:30,REAL,2898083786,10249,2898094035,2921351661
2025-06-19 08:33:32,REAL,2898094035,10311,2898104346,2921361972
2025-06-19 08:33:34,REAL,2898104346,10252,2898114598,2921372224
2025-06-19 08:33:36,REAL,2898114598,10319,2898124917,2921382543
2025-06-19 08:33:38,REAL,2898124917,10257,2898135174,2921392800
2025-06-19 08:33:40,REAL,2898135174,10252,2898145426,2921403052
2025-06-19 08:33:42,FAKE,2898145426,244,2898145670,2921408876
2025-06-19 08:33:44,REAL,2898145670,483,2898146153,2921409359
2025-06-19 08:33:46,FAKE,2898146153,241,2898146394,2921409843
2025-06-19 08:33:48,REAL,2898146394,488,2898146882,2921410331
2025-06-19 08:33:50,REAL,2898146882,483,2898147365,2921410814
2025-06-19 08:33:52,REAL,2898147365,482,2898147847,2921411296
2025-06-19 08:33:54,REAL,2898147847,481,2898148328,2921411777
2025-06-19 08:33:56,REAL,2898148328,486,2898148814,2921412263
2025-06-19 08:33:58,FAKE,2898148814,238,2898149052,2921412742
2025-06-19 08:34:00,REAL,2898149052,12167,2898161219,2921424909
2025-06-19 08:34:02,REAL,2898161219,10259,2898171478,2921435168
2025-06-19 08:34:04,REAL,2898171478,10323,2898181801,2921445491
2025-06-19 08:34:06,REAL,2898181801,10254,2898192055,2921455745
2025-06-19 08:34:08,REAL,2898192055,10373,2898202428,2921466118
2025-06-19 08:34:10,REAL,2898202428,10252,2898212680,2921476370
2025-06-19 08:34:12,REAL,2898212680,10250,2898222930,2921486620
2025-06-19 08:34:14,REAL,2898222930,5104,2898228034,2921491724
2025-06-19 08:34:16,REAL,2898228034,486,2898228520,2921492210
2025-06-19 08:34:18,REAL,2898228520,490,2898229010,2921492700
2025-06-19 08:34:20,REAL,2898229010,486,2898229496,2921493186
2025-06-19 08:34:22,REAL,2898229496,488,2898229984,2921493674
2025-06-19 08:34:24,FAKE,2898229984,238,2898230222,2921494152
2025-06-19 08:34:26,FAKE,2898230222,241,2898230463,2921494635
2025-06-19 08:34:28,REAL,2898230463,487,2898230950,2921495122
2025-06-19 08:34:30,FAKE,2898230950,238,2898231188,2921496529
2025-06-19 08:34:32,REAL,2898231188,14942,2898246130,2921511471
2025-06-19 08:34:34,REAL,2898246130,10259,2898256389,2921521730
2025-06-19 08:34:36,REAL,2898256389,10251,2898266640,2921531981
2025-06-19 08:34:38,REAL,2898266640,10246,2898276886,2921542227
2025-06-19 08:34:40,REAL,2898276886,10317,2898287203,2921552544
2025-06-19 08:34:42,REAL,2898287203,10261,2898297464,2921562805
2025-06-19 08:34:44,FAKE,2898297464,243,2898297707,2921573050
2025-06-19 08:34:46,REAL,2898297707,4443,2898302150,2921577493
2025-06-19 08:34:48,REAL,2898302150,483,2898302633,2921577976
2025-06-19 08:34:50,REAL,2898302633,485,2898303118,2921578461
2025-06-19 08:34:52,REAL,2898303118,488,2898303606,2921578949
2025-06-19 08:34:54,FAKE,2898303606,243,2898303849,2921579432
2025-06-19 08:34:56,REAL,2898303849,485,2898304334,2921579917
2025-06-19 08:34:58,REAL,2898304334,541,2898304875,2921580458
2025-06-19 08:35:00,FAKE,2898304875,241,2898305116,2921580936
2025-06-19 08:35:02,FAKE,2898305116,238,2898305354,2921581421
2025-06-19 08:35:04,REAL,2898305354,487,2898305841,2921581908
2025-06-19 08:35:06,REAL,2898305841,474,2898306315,2921582382
2025-06-19 08:35:08,FAKE,2898306315,243,2898306558,2921582863
2025-06-19 08:35:10,FAKE,2898306558,244,2898306802,2921583355
2025-06-19 08:35:12,REAL,2898306802,481,2898307283,2921583836
2025-06-19 08:35:14,FAKE,2898307283,238,2898307521,2921584320
2025-06-19 08:35:16,REAL,2898307521,476,2898307997,2921584796
2025-06-19 08:35:18,REAL,2898307997,484,2898308481,2921585280
2025-06-19 08:35:20,REAL,2898308481,545,2898309026,2921585825
2025-06-19 08:35:22,REAL,2898309026,483,2898309509,2921586308
2025-06-19 08:35:24,FAKE,2898309509,238,2898309747,2921586849
2025-06-19 08:35:26,REAL,2898309747,484,2898310231,2921587333
2025-06-19 08:35:28,REAL,2898310231,492,2898310723,2921587825
2025-06-19 08:35:30,FAKE,2898310723,244,2898310967,2921588312
2025-06-19 08:35:32,REAL,2898310967,482,2898311449,2921588794
2025-06-19 08:35:34,REAL,2898311449,2928,2898314377,2921591722
2025-06-19 08:35:36,REAL,2898314377,11375,2898325752,2921603097
2025-06-19 08:35:38,FAKE,2898325752,238,2898325990,2921613416
2025-06-19 08:35:40,REAL,2898325990,10252,2898336242,2921623668
2025-06-19 08:35:42,REAL,2898336242,10249,2898346491,2921633917
2025-06-19 08:35:44,REAL,2898346491,10308,2898356799,2921644225
2025-06-19 08:35:46,REAL,2898356799,10250,2898367049,2921654475
2025-06-19 08:35:48,FAKE,2898367049,241,2898367290,2921664720
2025-06-19 08:35:50,FAKE,2898367290,241,2898367531,2921668035
2025-06-19 08:35:52,REAL,2898367531,485,2898368016,2921668520
2025-06-19 08:35:54,REAL,2898368016,487,2898368503,2921669007
2025-06-19 08:35:56,FAKE,2898368503,238,2898368741,2921678339
2025-06-19 08:35:58,FAKE,2898368741,238,2898368979,2921688787
2025-06-19 08:36:00,FAKE,2898368979,244,2898369223,2921699037
2025-06-19 08:36:02,FAKE,2898369223,244,2898369467,2921709295
2025-06-19 08:36:04,FAKE,2898369467,241,2898369708,2921719616
2025-06-19 08:36:06,FAKE,2898369708,244,2898369952,2921729860
2025-06-19 08:36:08,REAL,2898369952,10255,2898380207,2921740115
2025-06-19 08:36:10,REAL,2898380207,7752,2898387959,2921747867
2025-06-19 08:36:12,REAL,2898387959,485,2898388444,2921748352
2025-06-19 08:36:14,FAKE,2898388444,243,2898388687,2921748839
2025-06-19 08:36:16,REAL,2898388687,542,2898389229,2921749381
2025-06-19 08:36:18,REAL,2898389229,489,2898389718,2921749870
2025-06-19 08:36:20,REAL,2898389718,481,2898390199,2921750351
2025-06-19 08:36:22,FAKE,2898390199,243,2898390442,2921750838
2025-06-19 08:36:24,REAL,2898390442,479,2898390921,2921751317
2025-06-19 08:36:26,FAKE,2898390921,243,2898391164,2921751807
2025-06-19 08:36:28,FAKE,2898391164,244,2898391408,2921752293
2025-06-19 08:36:30,REAL,2898391408,487,2898391895,2921752780
2025-06-19 08:36:32,REAL,2898391895,484,2898392379,2921753264
2025-06-19 08:36:34,REAL,2898392379,486,2898392865,2921753750
2025-06-19 08:36:36,REAL,2898392865,483,2898393348,2921754233
2025-06-19 08:36:38,FAKE,2898393348,243,2898393591,2921754719
2025-06-19 08:36:40,REAL,2898393591,485,2898394076,2921755204
2025-06-19 08:36:42,FAKE,2898394076,244,2898394320,2921755737
2025-06-19 08:36:44,FAKE,2898394320,244,2898394564,2921756216
2025-06-19 08:36:46,FAKE,2898394564,244,2898394808,2921756759
2025-06-19 08:36:48,REAL,2898394808,493,2898395301,2921757252
2025-06-19 08:36:50,REAL,2898395301,486,2898395787,2921757738
2025-06-19 08:36:52,REAL,2898395787,486,2898396273,2921758224
2025-06-19 08:36:54,REAL,2898396273,487,2898396760,2921758711
2025-06-19 08:36:56,REAL,2898396760,484,2898397244,2921759195
2025-06-19 08:36:58,FAKE,2898397244,238,2898397482,2921759675
2025-06-19 08:37:00,REAL,2898397482,484,2898397966,2921760159
2025-06-19 08:37:02,FAKE,2898397966,244,2898398210,2921760639
2025-06-19 08:37:04,REAL,2898398210,492,2898398702,2921761131
2025-06-19 08:37:06,REAL,2898398702,489,2898399191,2921761620
2025-06-19 08:37:08,REAL,2898399191,542,2898399733,2921762162
2025-06-19 08:37:10,REAL,2898399733,485,2898400218,2921762647
2025-06-19 08:37:12,REAL,2898400218,488,2898400706,2921763135
2025-06-19 08:37:14,REAL,2898400706,480,2898401186,2921763615
2025-06-19 08:37:16,REAL,2898401186,482,2898401668,2921764097
2025-06-19 08:37:18,REAL,2898401668,488,2898402156,2921764585
2025-06-19 08:37:20,FAKE,2898402156,243,2898402399,2921765067
2025-06-19 08:37:22,REAL,2898402399,489,2898402888,2921765556
2025-06-19 08:37:24,REAL,2898402888,491,2898403379,2921766047
2025-06-19 08:37:26,REAL,2898403379,485,2898403864,2921766532
2025-06-19 08:37:28,FAKE,2898403864,241,2898404105,2921767015
2025-06-19 08:37:30,REAL,2898404105,484,2898404589,2921767499
2025-06-19 08:37:32,FAKE,2898404589,238,2898404827,2921767987
2025-06-19 08:37:34,REAL,2898404827,544,2898405371,2921768531
2025-06-19 08:37:36,FAKE,2898405371,238,2898405609,2921769018
2025-06-19 08:37:38,REAL,2898405609,544,2898406153,2921769562
2025-06-19 08:37:40,FAKE,2898406153,241,2898406394,2921770046
2025-06-19 08:37:42,REAL,2898406394,479,2898406873,2921770525
2025-06-19 08:37:44,REAL,2898406873,479,2898407352,2921771004
2025-06-19 08:37:46,FAKE,2898407352,243,2898407595,2921771486
2025-06-19 08:37:48,REAL,2898407595,483,2898408078,2921771969
2025-06-19 08:37:50,REAL,2898408078,486,2898408564,2921772455
2025-06-19 08:37:52,REAL,2898408564,486,2898409050,2921772941
2025-06-19 08:37:54,REAL,2898409050,483,2898409533,2921773424
2025-06-19 08:37:56,REAL,2898409533,5582,2898415115,2921779006
2025-06-19 08:37:58,REAL,2898415115,10965,2898426080,2921789971
2025-06-19 08:38:00,REAL,2898426080,10250,2898436330,2921800221
2025-06-19 08:38:02,REAL,2898436330,10317,2898446647,2921810538
2025-06-19 08:38:04,REAL,2898446647,10313,2898456960,2921820851
2025-06-19 08:38:06,REAL,2898456960,10260,2898467220,2921831111
2025-06-19 08:38:08,REAL,2898467220,10323,2898477543,2921841434
2025-06-19 08:38:10,REAL,2898477543,10323,2898487866,2921851757
2025-06-19 08:38:12,FAKE,2898487866,244,2898488110,2921852838
2025-06-19 08:38:14,REAL,2898488110,479,2898488589,2921853317
2025-06-19 08:38:16,REAL,2898488589,482,2898489071,2921853799
2025-06-19 08:38:18,FAKE,2898489071,241,2898489312,2921854286
2025-06-19 08:38:20,REAL,2898489312,484,2898489796,2921854770
2025-06-19 08:38:22,REAL,2898489796,485,2898490281,2921855255
2025-06-19 08:38:24,FAKE,2898490281,243,2898490524,2921855795
2025-06-19 08:38:26,REAL,2898490524,478,2898491002,2921856273
2025-06-19 08:38:28,REAL,2898491002,6899,2898497901,2921863172
2025-06-19 08:38:30,REAL,2898497901,12841,2898510742,2921876013
2025-06-19 08:38:32,REAL,2898510742,10324,2898521066,2921886337
2025-06-19 08:38:34,REAL,2898521066,10248,2898531314,2921896585
2025-06-19 08:38:36,REAL,2898531314,10319,2898541633,2921906904
2025-06-19 08:38:38,REAL,2898541633,10318,2898551951,2921917222
2025-06-19 08:38:40,REAL,2898551951,10309,2898562260,2921927531
2025-06-19 08:38:42,REAL,2898562260,10251,2898572511,2921937782
2025-06-19 08:38:44,REAL,2898572511,484,2898572995,2921938266
2025-06-19 08:38:46,REAL,2898572995,485,2898573480,2921938751
2025-06-19 08:38:48,FAKE,2898573480,238,2898573718,2921939310
2025-06-19 08:38:50,FAKE,2898573718,238,2898573956,2921954447
2025-06-19 08:38:52,FAKE,2898573956,241,2898574197,2921964703
2025-06-19 08:38:54,REAL,2898574197,10314,2898584511,2921975017
2025-06-19 08:38:56,FAKE,2898584511,244,2898584755,2921985268
2025-06-19 08:38:58,FAKE,2898584755,244,2898584999,2921995592
2025-06-19 08:39:00,REAL,2898584999,10253,2898595252,2922005845
2025-06-19 08:39:02,REAL,2898595252,10315,2898605567,2922016160
2025-06-19 08:39:04,FAKE,2898605567,244,2898605811,2922021140
2025-06-19 08:39:06,REAL,2898605811,480,2898606291,2922021620
2025-06-19 08:39:08,REAL,2898606291,491,2898606782,2922022111
2025-06-19 08:39:10,REAL,2898606782,481,2898607263,2922022592
2025-06-19 08:39:12,REAL,2898607263,486,2898607749,2922023078
2025-06-19 08:39:14,FAKE,2898607749,238,2898607987,2922023559
2025-06-19 08:39:16,FAKE,2898607987,244,2898608231,2922024099
2025-06-19 08:39:18,FAKE,2898608231,238,2898608469,2922024576
2025-06-19 08:39:20,REAL,2898608469,1287,2898609756,2922025863
2025-06-19 08:39:22,REAL,2898609756,11784,2898621540,2922037647
2025-06-19 08:39:24,REAL,2898621540,10248,2898631788,2922047895
2025-06-19 08:39:26,REAL,2898631788,10255,2898642043,2922058150
2025-06-19 08:39:28,REAL,2898642043,10251,2898652294,2922068401
2025-06-19 08:39:30,REAL,2898652294,10313,2898662607,2922078714
2025-06-19 08:39:32,FAKE,2898662607,238,2898662845,2922088962
2025-06-19 08:39:34,REAL,2898662845,10248,2898673093,2922099210
2025-06-19 08:39:36,REAL,2898673093,4375,2898677468,2922103585
2025-06-19 08:39:38,REAL,2898677468,494,2898677962,2922104079
2025-06-19 08:39:40,REAL,2898677962,480,2898678442,2922104559
2025-06-19 08:39:42,REAL,2898678442,486,2898678928,2922105045
2025-06-19 08:39:44,REAL,2898678928,480,2898679408,2922105525
2025-06-19 08:39:46,REAL,2898679408,488,2898679896,2922106013
2025-06-19 08:39:48,REAL,2898679896,533,2898680429,2922106546
2025-06-19 08:39:50,FAKE,2898680429,244,2898680673,2922107031
2025-06-19 08:39:52,REAL,2898680673,475,2898681148,2922107506
2025-06-19 08:39:54,REAL,2898681148,480,2898681628,2922107986
2025-06-19 08:39:56,REAL,2898681628,481,2898682109,2922108467
2025-06-19 08:39:58,REAL,2898682109,482,2898682591,2922108949
2025-06-19 08:40:00,REAL,2898682591,478,2898683069,2922109427
2025-06-19 08:40:02,REAL,2898683069,481,2898683550,2922109908
2025-06-19 08:40:04,FAKE,2898683550,244,2898683794,2922110392
2025-06-19 08:40:06,REAL,2898683794,486,2898684280,2922110878
2025-06-19 08:40:08,REAL,2898684280,7819,2898692099,2922118697
2025-06-19 08:40:10,REAL,2898692099,10780,2898702879,2922129477
2025-06-19 08:40:12,REAL,2898702879,10254,2898713133,2922139731
2025-06-19 08:40:14,REAL,2898713133,10252,2898723385,2922149983
2025-06-19 08:40:16,FAKE,2898723385,238,2898723623,2922160240
2025-06-19 08:40:18,REAL,2898723623,10325,2898733948,2922170565
2025-06-19 08:40:20,REAL,2898733948,10306,2898744254,2922180871
2025-06-19 08:40:22,REAL,2898744254,8666,2898752920,2922189537
2025-06-19 08:40:24,REAL,2898752920,482,2898753402,2922190019
2025-06-19 08:40:26,FAKE,2898753402,241,2898753643,2922190512
2025-06-19 08:40:28,FAKE,2898753643,243,2898753886,2922193047
2025-06-19 08:40:30,REAL,2898753886,11700,2898765586,2922204747
2025-06-19 08:40:32,REAL,2898765586,10247,2898775833,2922214994
2025-06-19 08:40:34,REAL,2898775833,10252,2898786085,2922225246
2025-06-19 08:40:36,REAL,2898786085,10319,2898796404,2922235565
2025-06-19 08:40:38,FAKE,2898796404,244,2898796648,2922245825
2025-06-19 08:40:40,REAL,2898796648,10318,2898806966,2922256143
2025-06-19 08:40:42,REAL,2898806966,10258,2898817224,2922266401
2025-06-19 08:40:44,REAL,2898817224,3524,2898820748,2922269925
2025-06-19 08:40:46,FAKE,2898820748,244,2898820992,2922270404
2025-06-19 08:40:48,REAL,2898820992,484,2898821476,2922270888
2025-06-19 08:40:50,FAKE,2898821476,243,2898821719,2922271433
2025-06-19 08:40:52,REAL,2898821719,488,2898822207,2922271921
2025-06-19 08:40:54,REAL,2898822207,488,2898822695,2922272409
2025-06-19 08:40:56,FAKE,2898822695,243,2898822938,2922272899
2025-06-19 08:40:58,REAL,2898822938,485,2898823423,2922273384
2025-06-19 08:41:00,FAKE,2898823423,244,2898823667,2922276651
2025-06-19 08:41:02,REAL,2898823667,14560,2898838227,2922291211
2025-06-19 08:41:04,FAKE,2898838227,244,2898838471,2922301465
2025-06-19 08:41:06,REAL,2898838471,10252,2898848723,2922311717
2025-06-19 08:41:08,REAL,2898848723,10324,2898859047,2922322041
2025-06-19 08:41:10,REAL,2898859047,10253,2898869300,2922332294
2025-06-19 08:41:12,FAKE,2898869300,238,2898869538,2922342549
2025-06-19 08:41:14,REAL,2898869538,10258,2898879796,2922352807
2025-06-19 08:41:16,REAL,2898879796,2864,2898882660,2922355671
2025-06-19 08:41:18,REAL,2898882660,484,2898883144,2922356155
2025-06-19 08:41:20,REAL,2898883144,490,2898883634,2922356645
2025-06-19 08:41:22,FAKE,2898883634,238,2898883872,2922366232
2025-06-19 08:41:24,REAL,2898883872,10512,2898894384,2922376744
2025-06-19 08:41:26,FAKE,2898894384,241,2898894625,2922386991
2025-06-19 08:41:28,REAL,2898894625,10313,2898904938,2922397304
2025-06-19 08:41:30,FAKE,2898904938,244,2898905182,2922407563
2025-06-19 08:41:32,REAL,2898905182,10246,2898915428,2922417809
2025-06-19 08:41:34,FAKE,2898915428,243,2898915671,2922428064
2025-06-19 08:41:36,REAL,2898915671,7550,2898923221,2922435614
2025-06-19 08:41:38,REAL,2898923221,484,2898923705,2922436098
2025-06-19 08:41:40,FAKE,2898923705,241,2898923946,2922436579
2025-06-19 08:41:42,REAL,2898923946,478,2898924424,2922437057
2025-06-19 08:41:44,REAL,2898924424,484,2898924908,2922437541
2025-06-19 08:41:46,FAKE,2898924908,241,2898925149,2922438019
2025-06-19 08:41:48,REAL,2898925149,480,2898925629,2922438499
2025-06-19 08:41:50,REAL,2898925629,482,2898926111,2922438981
2025-06-19 08:41:52,REAL,2898926111,476,2898926587,2922439457
2025-06-19 08:41:54,FAKE,2898926587,241,2898926828,2922439993
2025-06-19 08:41:56,REAL,2898926828,480,2898927308,2922440473
2025-06-19 08:41:58,REAL,2898927308,482,2898927790,2922440955
2025-06-19 08:42:00,REAL,2898927790,484,2898928274,2922441439
2025-06-19 08:42:02,FAKE,2898928274,243,2898928517,2922441926
2025-06-19 08:42:04,REAL,2898928517,481,2898928998,2922442407
2025-06-19 08:42:06,REAL,2898928998,482,2898929480,2922442889
2025-06-19 08:42:08,REAL,2898929480,486,2898929966,2922443375
2025-06-19 08:42:10,REAL,2898929966,544,2898930510,2922443919
2025-06-19 08:42:12,REAL,2898930510,477,2898930987,2922444396
2025-06-19 08:42:14,REAL,2898930987,490,2898931477,2922444886
2025-06-19 08:42:16,FAKE,2898931477,241,2898931718,2922445374
2025-06-19 08:42:18,REAL,2898931718,483,2898932201,2922445857
2025-06-19 08:42:20,FAKE,2898932201,243,2898932444,2922446346
2025-06-19 08:42:22,FAKE,2898932444,244,2898932688,2922446834
2025-06-19 08:42:24,REAL,2898932688,536,2898933224,2922447370
2025-06-19 08:42:26,REAL,2898933224,481,2898933705,2922447851
2025-06-19 08:42:28,REAL,2898933705,484,2898934189,2922448335
2025-06-19 08:42:30,REAL,2898934189,479,2898934668,2922448814
2025-06-19 08:42:32,FAKE,2898934668,241,2898934909,2922449305
2025-06-19 08:42:34,REAL,2898934909,491,2898935400,2922449796
2025-06-19 08:42:36,REAL,2898935400,11116,2898946516,2922460912
2025-06-19 08:42:38,REAL,2898946516,10325,2898956841,2922471237
2025-06-19 08:42:40,REAL,2898956841,10255,2898967096,2922481492
2025-06-19 08:42:42,REAL,2898967096,10259,2898977355,2922491751
2025-06-19 08:42:44,REAL,2898977355,10325,2898987680,2922502076
2025-06-19 08:42:46,FAKE,2898987680,241,2898987921,2922512334
2025-06-19 08:42:48,FAKE,2898987921,241,2898988162,2922522586
2025-06-19 08:42:50,REAL,2898988162,6224,2898994386,2922528810
2025-06-19 08:42:52,REAL,2898994386,477,2898994863,2922529287
2025-06-19 08:42:54,FAKE,2898994863,238,2898995101,2922529771
2025-06-19 08:42:56,FAKE,2898995101,238,2898995339,2922530247
2025-06-19 08:42:58,FAKE,2898995339,243,2898995582,2922530794
2025-06-19 08:43:00,REAL,2898995582,490,2898996072,2922531284
2025-06-19 08:43:02,FAKE,2898996072,241,2898996313,2922531768
2025-06-19 08:43:04,FAKE,2898996313,241,2898996554,2922532248
2025-06-19 08:43:06,REAL,2898996554,484,2898997038,2922532732
2025-06-19 08:43:08,REAL,2898997038,11315,2899008353,2922544047
2025-06-19 08:43:10,REAL,2899008353,10255,2899018608,2922554302
2025-06-19 08:43:12,REAL,2899018608,11042,2899029650,2922565344
2025-06-19 08:43:14,REAL,2899029650,9526,2899039176,2922574870
2025-06-19 08:43:16,REAL,2899039176,10247,2899049423,2922585117
2025-06-19 08:43:18,REAL,2899049423,10310,2899059733,2922595427
2025-06-19 08:43:20,FAKE,2899059733,244,2899059977,2922605686
2025-06-19 08:43:22,FAKE,2899059977,241,2899060218,2922611254
2025-06-19 08:43:24,REAL,2899060218,491,2899060709,2922611745
2025-06-19 08:43:26,REAL,2899060709,479,2899061188,2922612224
2025-06-19 08:43:28,REAL,2899061188,491,2899061679,2922612715
2025-06-19 08:43:30,REAL,2899061679,540,2899062219,2922613255
2025-06-19 08:43:32,REAL,2899062219,492,2899062711,2922613747
2025-06-19 08:43:34,FAKE,2899062711,241,2899062952,2922614225
2025-06-19 08:43:36,REAL,2899062952,486,2899063438,2922614711
2025-06-19 08:43:38,FAKE,2899063438,244,2899063682,2922615328
2025-06-19 08:43:40,REAL,2899063682,12436,2899076118,2922627764
2025-06-19 08:43:42,REAL,2899076118,10312,2899086430,2922638076
2025-06-19 08:43:44,REAL,2899086430,10252,2899096682,2922648328
2025-06-19 08:43:46,REAL,2899096682,10314,2899106996,2922658642
2025-06-19 08:43:48,REAL,2899106996,10254,2899117250,2922668896
2025-06-19 08:43:50,REAL,2899117250,10252,2899127502,2922679148
2025-06-19 08:43:52,REAL,2899127502,10247,2899137749,2922689395
2025-06-19 08:43:54,FAKE,2899137749,238,2899137987,2922694369
2025-06-19 08:43:56,REAL,2899137987,483,2899138470,2922694852
2025-06-19 08:43:58,REAL,2899138470,482,2899138952,2922695334
2025-06-19 08:44:00,FAKE,2899138952,241,2899139193,2922695875
2025-06-19 08:44:02,FAKE,2899139193,244,2899139437,2922696355
2025-06-19 08:44:04,FAKE,2899139437,241,2899139678,2922696835
2025-06-19 08:44:06,REAL,2899139678,481,2899140159,2922697316
2025-06-19 08:44:08,REAL,2899140159,481,2899140640,2922697797
2025-06-19 08:44:10,REAL,2899140640,1680,2899142320,2922699477
2025-06-19 08:44:12,REAL,2899142320,14278,2899156598,2922713755
2025-06-19 08:44:14,FAKE,2899156598,244,2899156842,2922724065
2025-06-19 08:44:16,REAL,2899156842,10246,2899167088,2922734311
2025-06-19 08:44:18,REAL,2899167088,10253,2899177341,2922744564
2025-06-19 08:44:20,REAL,2899177341,10317,2899187658,2922754881
2025-06-19 08:44:22,REAL,2899187658,10251,2899197909,2922765132
2025-06-19 08:44:24,FAKE,2899197909,244,2899198153,2922775380
2025-06-19 08:44:26,FAKE,2899198153,238,2899198391,2922779684
2025-06-19 08:44:28,FAKE,2899198391,238,2899198629,2922780158
2025-06-19 08:44:30,REAL,2899198629,485,2899199114,2922780643
2025-06-19 08:44:32,REAL,2899199114,534,2899199648,2922781177
2025-06-19 08:44:34,REAL,2899199648,485,2899200133,2922781662
2025-06-19 08:44:36,REAL,2899200133,478,2899200611,2922782140
2025-06-19 08:44:38,FAKE,2899200611,238,2899200849,2922782622
2025-06-19 08:44:40,REAL,2899200849,488,2899201337,2922783110
2025-06-19 08:44:42,REAL,2899201337,2276,2899203613,2922785386
2025-06-19 08:44:44,REAL,2899203613,11505,2899215118,2922796891
2025-06-19 08:44:46,REAL,2899215118,10324,2899225442,2922807215
2025-06-19 08:44:48,FAKE,2899225442,241,2899225683,2922817471
2025-06-19 08:44:50,REAL,2899225683,10248,2899235931,2922827719
2025-06-19 08:44:52,REAL,2899235931,10313,2899246244,2922838032
2025-06-19 08:44:54,REAL,2899246244,10306,2899256550,2922848338
2025-06-19 08:44:56,FAKE,2899256550,243,2899256793,2922858585
2025-06-19 08:44:58,REAL,2899256793,3718,2899260511,2922862303
2025-06-19 08:45:00,REAL,2899260511,489,2899261000,2922862792
2025-06-19 08:45:02,REAL,2899261000,484,2899261484,2922863276
2025-06-19 08:45:04,REAL,2899261484,478,2899261962,2922863754
2025-06-19 08:45:06,FAKE,2899261962,241,2899262203,2922864241
2025-06-19 08:45:08,REAL,2899262203,486,2899262689,2922864727
2025-06-19 08:45:10,REAL,2899262689,490,2899263179,2922865217
2025-06-19 08:45:12,REAL,2899263179,487,2899263666,2922865704
2025-06-19 08:45:14,FAKE,2899263666,238,2899263904,2922866188
2025-06-19 08:45:16,REAL,2899263904,540,2899264444,2922866728
2025-06-19 08:45:18,REAL,2899264444,481,2899264925,2922867209
2025-06-19 08:45:20,FAKE,2899264925,244,2899265169,2922867692
2025-06-19 08:45:22,REAL,2899265169,477,2899265646,2922868169
2025-06-19 08:45:24,REAL,2899265646,485,2899266131,2922868654
2025-06-19 08:45:26,REAL,2899266131,479,2899266610,2922869133
2025-06-19 08:45:28,FAKE,2899266610,241,2899266851,2922869608
2025-06-19 08:45:30,REAL,2899266851,541,2899267392,2922870149
2025-06-19 08:45:32,REAL,2899267392,488,2899267880,2922870637
2025-06-19 08:45:34,FAKE,2899267880,241,2899268121,2922871124
2025-06-19 08:45:36,REAL,2899268121,487,2899268608,2922871611
2025-06-19 08:45:38,FAKE,2899268608,244,2899268852,2922872101
2025-06-19 08:45:40,FAKE,2899268852,244,2899269096,2922872638
2025-06-19 08:45:42,REAL,2899269096,488,2899269584,2922873126
2025-06-19 08:45:44,REAL,2899269584,485,2899270069,2922873611
2025-06-19 08:45:46,REAL,2899270069,488,2899270557,2922874099
2025-06-19 08:45:48,FAKE,2899270557,238,2899270795,2922874574
2025-06-19 08:45:50,FAKE,2899270795,243,2899271038,2922875061
2025-06-19 08:45:52,FAKE,2899271038,243,2899271281,2922875539
2025-06-19 08:45:54,REAL,2899271281,487,2899271768,2922876026
2025-06-19 08:45:56,REAL,2899271768,480,2899272248,2922876506
2025-06-19 08:45:58,REAL,2899272248,484,2899272732,2922876990
2025-06-19 08:46:00,REAL,2899272732,481,2899273213,2922877471
2025-06-19 08:46:02,FAKE,2899273213,243,2899273456,2922878006
2025-06-19 08:46:04,REAL,2899273456,476,2899273932,2922878482
2025-06-19 08:46:06,REAL,2899273932,482,2899274414,2922878964
2025-06-19 08:46:08,FAKE,2899274414,244,2899274658,2922879450
2025-06-19 08:46:10,REAL,2899274658,487,2899275145,2922879937
2025-06-19 08:46:12,FAKE,2899275145,244,2899275389,2922880412
2025-06-19 08:46:14,FAKE,2899275389,243,2899275632,2922880894
2025-06-19 08:46:16,FAKE,2899275632,243,2899275875,2922881376
2025-06-19 08:46:18,FAKE,2899275875,238,2899276113,2922886018
2025-06-19 08:46:20,FAKE,2899276113,244,2899276357,2922900300
2025-06-19 08:46:22,REAL,2899276357,10251,2899286608,2922910551
2025-06-19 08:46:24,FAKE,2899286608,241,2899286849,2922920927
2025-06-19 08:46:26,REAL,2899286849,10249,2899297098,2922931176
2025-06-19 08:46:28,REAL,2899297098,10255,2899307353,2922941431
2025-06-19 08:46:30,FAKE,2899307353,243,2899307596,2922951743
2025-06-19 08:46:32,FAKE,2899307596,238,2899307834,2922961995
2025-06-19 08:46:34,FAKE,2899307834,238,2899308072,2922963800
2025-06-19 08:46:36,REAL,2899308072,479,2899308551,2922964279
2025-06-19 08:46:38,REAL,2899308551,492,2899309043,2922964771
2025-06-19 08:46:40,REAL,2899309043,480,2899309523,2922965251
2025-06-19 08:46:42,REAL,2899309523,479,2899310002,2922965730
2025-06-19 08:46:44,FAKE,2899310002,238,2899310240,2922966267
2025-06-19 08:46:46,FAKE,2899310240,244,2899310484,2922966749
2025-06-19 08:46:48,FAKE,2899310484,243,2899310727,2922967290
2025-06-19 08:46:50,REAL,2899310727,5514,2899316241,2922972804
2025-06-19 08:46:52,FAKE,2899316241,243,2899316484,2922984181
2025-06-19 08:46:54,REAL,2899316484,10258,2899326742,2922994439
2025-06-19 08:46:56,REAL,2899326742,10311,2899337053,2923004750
2025-06-19 08:46:58,REAL,2899337053,10246,2899347299,2923014996
2025-06-19 08:47:00,FAKE,2899347299,241,2899347540,2923025245
2025-06-19 08:47:02,REAL,2899347540,10315,2899357855,2923035560
2025-06-19 08:47:04,REAL,2899357855,10244,2899368099,2923045804
2025-06-19 08:47:06,REAL,2899368099,1207,2899369306,2923047011
2025-06-19 08:47:08,REAL,2899369306,479,2899369785,2923047490
2025-06-19 08:47:10,REAL,2899369785,537,2899370322,2923048027
2025-06-19 08:47:12,REAL,2899370322,493,2899370815,2923048520
2025-06-19 08:47:14,FAKE,2899370815,244,2899371059,2923049001
2025-06-19 08:47:16,REAL,2899371059,541,2899371600,2923049542
2025-06-19 08:47:18,FAKE,2899371600,243,2899371843,2923050025
2025-06-19 08:47:20,REAL,2899371843,479,2899372322,2923050504
2025-06-19 08:47:22,REAL,2899372322,6035,2899378357,2923056539
2025-06-19 08:47:24,REAL,2899378357,11319,2899389676,2923067858
2025-06-19 08:47:26,REAL,2899389676,10256,2899399932,2923078114
2025-06-19 08:47:28,REAL,2899399932,10319,2899410251,2923088433
2025-06-19 08:47:30,REAL,2899410251,10245,2899420496,2923098678
2025-06-19 08:47:32,FAKE,2899420496,243,2899420739,2923108984
2025-06-19 08:47:34,FAKE,2899420739,241,2899420980,2923119308
2025-06-19 08:47:36,REAL,2899420980,10249,2899431229,2923129557
2025-06-19 08:47:38,REAL,2899431229,550,2899431779,2923130107
2025-06-19 08:47:40,REAL,2899431779,478,2899432257,2923130585
2025-06-19 08:47:42,REAL,2899432257,488,2899432745,2923131073
2025-06-19 08:47:44,REAL,2899432745,483,2899433228,2923131556
2025-06-19 08:47:46,REAL,2899433228,485,2899433713,2923132041
2025-06-19 08:47:48,REAL,2899433713,299,2899434012,2923132340
2025-06-19 08:47:50,REAL,2899434012,482,2899434494,2923132822
2025-06-19 08:47:52,REAL,2899434494,486,2899434980,2923133308
2025-06-19 08:47:54,FAKE,2899434980,238,2899435218,2923133853
2025-06-19 08:47:56,REAL,2899435218,494,2899435712,2923134347
2025-06-19 08:47:58,REAL,2899435712,483,2899436195,2923134830
2025-06-19 08:48:00,FAKE,2899436195,244,2899436439,2923135313
2025-06-19 08:48:02,REAL,2899436439,483,2899436922,2923135796
2025-06-19 08:48:04,FAKE,2899436922,244,2899437166,2923136271
2025-06-19 08:48:06,REAL,2899437166,488,2899437654,2923136759
2025-06-19 08:48:08,FAKE,2899437654,244,2899437898,2923137248
2025-06-19 08:48:10,FAKE,2899437898,241,2899438139,2923137731
2025-06-19 08:48:12,REAL,2899438139,488,2899438627,2923138219
2025-06-19 08:48:14,REAL,2899438627,484,2899439111,2923138703
2025-06-19 08:48:16,FAKE,2899439111,243,2899439354,2923139238
2025-06-19 08:48:18,FAKE,2899439354,241,2899439595,2923139783
2025-06-19 08:48:20,REAL,2899439595,484,2899440079,2923140267
2025-06-19 08:48:22,FAKE,2899440079,238,2899440317,2923140747
2025-06-19 08:48:24,REAL,2899440317,482,2899440799,2923141229
2025-06-19 08:48:26,REAL,2899440799,7749,2899448548,2923148978
2025-06-19 08:48:28,FAKE,2899448548,241,2899448789,2923159959
2025-06-19 08:48:30,FAKE,2899448789,241,2899449030,2923170272
2025-06-19 08:48:32,FAKE,2899449030,243,2899449273,2923180520
2025-06-19 08:48:34,REAL,2899449273,10315,2899459588,2923190835
2025-06-19 08:48:36,FAKE,2899459588,244,2899459832,2923201087
2025-06-19 08:48:38,FAKE,2899459832,243,2899460075,2923211337
2025-06-19 08:48:40,FAKE,2899460075,244,2899460319,2923220515
2025-06-19 08:48:42,FAKE,2899460319,243,2899460562,2923221001
2025-06-19 08:48:44,FAKE,2899460562,243,2899460805,2923221491
2025-06-19 08:48:46,REAL,2899460805,485,2899461290,2923221976
2025-06-19 08:48:48,REAL,2899461290,484,2899461774,2923222460
2025-06-19 08:48:50,FAKE,2899461774,238,2899462012,2923222935
2025-06-19 08:48:52,REAL,2899462012,533,2899462545,2923223468
2025-06-19 08:48:54,REAL,2899462545,477,2899463022,2923223945
2025-06-19 08:48:56,REAL,2899463022,484,2899463506,2923224429
2025-06-19 08:48:58,REAL,2899463506,8348,2899471854,2923232777
2025-06-19 08:49:00,REAL,2899471854,10516,2899482370,2923243293
2025-06-19 08:49:02,REAL,2899482370,10303,2899492673,2923253596
2025-06-19 08:49:04,FAKE,2899492673,243,2899492916,2923263923
2025-06-19 08:49:06,FAKE,2899492916,243,2899493159,2923274177
2025-06-19 08:49:08,REAL,2899493159,10322,2899503481,2923284499
2025-06-19 08:49:10,REAL,2899503481,10255,2899513736,2923294754
2025-06-19 08:49:12,FAKE,2899513736,243,2899513979,2923303220
2025-06-19 08:49:14,REAL,2899513979,491,2899514470,2923303711
2025-06-19 08:49:16,REAL,2899514470,482,2899514952,2923304193
2025-06-19 08:49:18,FAKE,2899514952,243,2899515195,2923304670
2025-06-19 08:49:20,REAL,2899515195,486,2899515681,2923305156
2025-06-19 08:49:22,REAL,2899515681,490,2899516171,2923305646
2025-06-19 08:49:24,REAL,2899516171,593,2899516764,2923306239
2025-06-19 08:49:26,REAL,2899516764,480,2899517244,2923306719
2025-06-19 08:49:28,REAL,2899517244,480,2899517724,2923307199
2025-06-19 08:49:30,REAL,2899517724,9735,2899527459,2923316934
2025-06-19 08:49:32,FAKE,2899527459,243,2899527702,2923327450
2025-06-19 08:49:34,REAL,2899527702,10247,2899537949,2923337697
2025-06-19 08:49:36,REAL,2899537949,10317,2899548266,2923348014
2025-06-19 08:49:38,FAKE,2899548266,238,2899548504,2923358271
2025-06-19 08:49:40,FAKE,2899548504,243,2899548747,2923368596
2025-06-19 08:49:42,REAL,2899548747,10247,2899558994,2923378843
2025-06-19 08:49:44,REAL,2899558994,7806,2899566800,2923386649
2025-06-19 08:49:46,REAL,2899566800,488,2899567288,2923387137
2025-06-19 08:49:48,FAKE,2899567288,243,2899567531,2923387622
2025-06-19 08:49:50,REAL,2899567531,487,2899568018,2923388109
2025-06-19 08:49:52,REAL,2899568018,493,2899568511,2923388602
2025-06-19 08:49:54,REAL,2899568511,488,2899568999,2923389090
2025-06-19 08:49:56,REAL,2899568999,544,2899569543,2923389634
2025-06-19 08:49:58,FAKE,2899569543,241,2899569784,2923390123
2025-06-19 08:50:00,REAL,2899569784,486,2899570270,2923390609
2025-06-19 08:50:02,FAKE,2899570270,243,2899570513,2923391089
2025-06-19 08:50:04,REAL,2899570513,483,2899570996,2923391572
2025-06-19 08:50:06,REAL,2899570996,533,2899571529,2923392105
2025-06-19 08:50:08,FAKE,2899571529,243,2899571772,2923392589
2025-06-19 08:50:10,REAL,2899571772,484,2899572256,2923393073
2025-06-19 08:50:12,REAL,2899572256,485,2899572741,2923393558
2025-06-19 08:50:14,FAKE,2899572741,241,2899572982,2923394044
2025-06-19 08:50:16,FAKE,2899572982,243,2899573225,2923394521
2025-06-19 08:50:18,FAKE,2899573225,241,2899573466,2923395008
2025-06-19 08:50:20,REAL,2899573466,478,2899573944,2923395486
2025-06-19 08:50:22,REAL,2899573944,4450,2899578394,2923399936
2025-06-19 08:50:24,REAL,2899578394,11837,2899590231,2923411773
2025-06-19 08:50:26,REAL,2899590231,10253,2899600484,2923422026
2025-06-19 08:50:28,FAKE,2899600484,244,2899600728,2923432281
2025-06-19 08:50:30,FAKE,2899600728,241,2899600969,2923442530
2025-06-19 08:50:32,FAKE,2899600969,241,2899601210,2923452847
2025-06-19 08:50:34,REAL,2899601210,10255,2899611465,2923463102
2025-06-19 08:50:36,REAL,2899611465,10256,2899621721,2923473358
2025-06-19 08:50:38,REAL,2899621721,2007,2899623728,2923475365
2025-06-19 08:50:40,FAKE,2899623728,244,2899623972,2923475854
2025-06-19 08:50:42,REAL,2899623972,477,2899624449,2923476331
2025-06-19 08:50:44,FAKE,2899624449,238,2899624687,2923476821
2025-06-19 08:50:46,FAKE,2899624687,243,2899624930,2923477360
2025-06-19 08:50:48,REAL,2899624930,483,2899625413,2923477843
2025-06-19 08:50:50,REAL,2899625413,541,2899625954,2923478384
2025-06-19 08:50:52,FAKE,2899625954,244,2899626198,2923478875
2025-06-19 08:50:54,REAL,2899626198,480,2899626678,2923479355
2025-06-19 08:50:56,REAL,2899626678,477,2899627155,2923479832
2025-06-19 08:50:58,FAKE,2899627155,241,2899627396,2923480317
2025-06-19 08:51:00,REAL,2899627396,486,2899627882,2923480803
2025-06-19 08:51:02,REAL,2899627882,482,2899628364,2923481285
2025-06-19 08:51:04,FAKE,2899628364,243,2899628607,2923481777
2025-06-19 08:51:06,REAL,2899628607,476,2899629083,2923482253
2025-06-19 08:51:08,REAL,2899629083,489,2899629572,2923482742
2025-06-19 08:51:10,REAL,2899629572,476,2899630048,2923483218
2025-06-19 08:51:12,REAL,2899630048,483,2899630531,2923483701
2025-06-19 08:51:14,REAL,2899630531,542,2899631073,2923484243
2025-06-19 08:51:16,REAL,2899631073,486,2899631559,2923484729
2025-06-19 08:51:18,REAL,2899631559,486,2899632045,2923485215
2025-06-19 08:51:20,FAKE,2899632045,244,2899632289,2923485700
2025-06-19 08:51:22,FAKE,2899632289,244,2899632533,2923486183
2025-06-19 08:51:24,REAL,2899632533,486,2899633019,2923486669
2025-06-19 08:51:26,FAKE,2899633019,241,2899633260,2923493306
2025-06-19 08:51:28,REAL,2899633260,13682,2899646942,2923506988
2025-06-19 08:51:30,REAL,2899646942,10252,2899657194,2923517240
2025-06-19 08:51:32,REAL,2899657194,10256,2899667450,2923527496
2025-06-19 08:51:34,REAL,2899667450,10313,2899677763,2923537809
2025-06-19 08:51:36,FAKE,2899677763,243,2899678006,2923548059
2025-06-19 08:51:38,REAL,2899678006,10259,2899688265,2923558318
2025-06-19 08:51:40,FAKE,2899688265,241,2899688506,2923568639
2025-06-19 08:51:42,FAKE,2899688506,244,2899688750,2923569318
2025-06-19 08:51:44,FAKE,2899688750,243,2899688993,2923569806
2025-06-19 08:51:46,FAKE,2899688993,238,2899689231,2923570291
2025-06-19 08:51:48,REAL,2899689231,540,2899689771,2923570831
2025-06-19 08:51:50,REAL,2899689771,491,2899690262,2923571322
2025-06-19 08:51:52,FAKE,2899690262,241,2899690503,2923571806
2025-06-19 08:51:54,REAL,2899690503,480,2899690983,2923572286
2025-06-19 08:51:56,REAL,2899690983,488,2899691471,2923572774
2025-06-19 08:51:58,FAKE,2899691471,243,2899691714,2923579667
2025-06-19 08:52:00,REAL,2899691714,10905,2899702619,2923590572
2025-06-19 08:52:02,REAL,2899702619,10245,2899712864,2923600817
2025-06-19 08:52:04,FAKE,2899712864,244,2899713108,2923611068
2025-06-19 08:52:06,REAL,2899713108,10319,2899723427,2923621387
2025-06-19 08:52:08,FAKE,2899723427,241,2899723668,2923631646
2025-06-19 08:52:10,REAL,2899723668,10309,2899733977,2923641955
2025-06-19 08:52:12,REAL,2899733977,9921,2899743898,2923651876
2025-06-19 08:52:14,REAL,2899743898,482,2899744380,2923652358
2025-06-19 08:52:16,REAL,2899744380,485,2899744865,2923652843
2025-06-19 08:52:18,REAL,2899744865,488,2899745353,2923653331
2025-06-19 08:52:20,REAL,2899745353,542,2899745895,2923653873
2025-06-19 08:52:22,FAKE,2899745895,238,2899746133,2923654351
2025-06-19 08:52:24,REAL,2899746133,481,2899746614,2923654832
2025-06-19 08:52:26,REAL,2899746614,492,2899747106,2923655324
2025-06-19 08:52:28,REAL,2899747106,483,2899747589,2923655807
2025-06-19 08:52:30,REAL,2899747589,483,2899748072,2923656290
2025-06-19 08:52:32,FAKE,2899748072,238,2899748310,2923656772
2025-06-19 08:52:34,REAL,2899748310,483,2899748793,2923657255
2025-06-19 08:52:36,FAKE,2899748793,243,2899749036,2923657739
2025-06-19 08:52:38,REAL,2899749036,483,2899749519,2923658222
2025-06-19 08:52:40,REAL,2899749519,491,2899750010,2923658713
2025-06-19 08:52:42,FAKE,2899750010,244,2899750254,2923659192
2025-06-19 08:52:44,REAL,2899750254,540,2899750794,2923659732
2025-06-19 08:52:46,REAL,2899750794,484,2899751278,2923660216
2025-06-19 08:52:48,FAKE,2899751278,243,2899751521,2923660703
2025-06-19 08:52:50,FAKE,2899751521,244,2899751765,2923661183
2025-06-19 08:52:52,FAKE,2899751765,241,2899752006,2923661664
2025-06-19 08:52:54,REAL,2899752006,536,2899752542,2923662200
2025-06-19 08:52:56,FAKE,2899752542,243,2899752785,2923669884
2025-06-19 08:52:58,FAKE,2899752785,243,2899753028,2923680598
2025-06-19 08:53:00,REAL,2899753028,10252,2899763280,2923690850
2025-06-19 08:53:02,FAKE,2899763280,243,2899763523,2923701097
2025-06-19 08:53:04,REAL,2899763523,10310,2899773833,2923711407
2025-06-19 08:53:06,FAKE,2899773833,241,2899774074,2923721667
2025-06-19 08:53:08,FAKE,2899774074,238,2899774312,2923731918
2025-06-19 08:53:10,REAL,2899774312,9000,2899783312,2923740918
2025-06-19 08:53:12,REAL,2899783312,488,2899783800,2923741406
2025-06-19 08:53:14,REAL,2899783800,490,2899784290,2923741896
2025-06-19 08:53:16,FAKE,2899784290,243,2899784533,2923742381
2025-06-19 08:53:18,REAL,2899784533,542,2899785075,2923742923
2025-06-19 08:53:20,REAL,2899785075,485,2899785560,2923743408
2025-06-19 08:53:22,REAL,2899785560,484,2899786044,2923743892
2025-06-19 08:53:24,FAKE,2899786044,241,2899786285,2923744381
2025-06-19 08:53:26,REAL,2899786285,491,2899786776,2923744872
2025-06-19 08:53:28,REAL,2899786776,8936,2899795712,2923753808
2025-06-19 08:53:30,REAL,2899795712,10774,2899806486,2923764582
2025-06-19 08:53:32,REAL,2899806486,10246,2899816732,2923774828
2025-06-19 08:53:34,REAL,2899816732,10313,2899827045,2923785141
2025-06-19 08:53:36,REAL,2899827045,10314,2899837359,2923795455
2025-06-19 08:53:38,REAL,2899837359,10243,2899847602,2923805698
2025-06-19 08:53:40,FAKE,2899847602,241,2899847843,2923816008
2025-06-19 08:53:42,REAL,2899847843,8336,2899856179,2923824344
2025-06-19 08:53:44,REAL,2899856179,487,2899856666,2923824831
2025-06-19 08:53:46,REAL,2899856666,487,2899857153,2923825318
2025-06-19 08:53:48,REAL,2899857153,484,2899857637,2923825802
2025-06-19 08:53:50,REAL,2899857637,548,2899858185,2923826350
2025-06-19 08:53:52,FAKE,2899858185,241,2899858426,2923826828
2025-06-19 08:53:54,REAL,2899858426,487,2899858913,2923827315
2025-06-19 08:53:56,REAL,2899858913,487,2899859400,2923827802
2025-06-19 08:53:58,REAL,2899859400,481,2899859881,2923828283
2025-06-19 08:54:00,REAL,2899859881,491,2899860372,2923828774
2025-06-19 08:54:02,REAL,2899860372,486,2899860858,2923829260
2025-06-19 08:54:04,FAKE,2899860858,238,2899861096,2923829743
2025-06-19 08:54:06,FAKE,2899861096,243,2899861339,2923830231
2025-06-19 08:54:08,FAKE,2899861339,244,2899861583,2923830710
2025-06-19 08:54:10,REAL,2899861583,479,2899862062,2923831189
2025-06-19 08:54:12,FAKE,2899862062,244,2899862306,2923831670
2025-06-19 08:54:14,FAKE,2899862306,244,2899862550,2923832213
2025-06-19 08:54:16,REAL,2899862550,480,2899863030,2923832693
2025-06-19 08:54:18,REAL,2899863030,483,2899863513,2923833176
2025-06-19 08:54:20,REAL,2899863513,3708,2899867221,2923836884
2025-06-19 08:54:22,REAL,2899867221,11113,2899878334,2923847997
2025-06-19 08:54:24,FAKE,2899878334,238,2899878572,2923858246
2025-06-19 08:54:26,FAKE,2899878572,244,2899878816,2923868498
2025-06-19 08:54:28,REAL,2899878816,10244,2899889060,2923878742
2025-06-19 08:54:30,REAL,2899889060,10250,2899899310,2923888992
2025-06-19 08:54:32,REAL,2899899310,10255,2899909565,2923899247
2025-06-19 08:54:34,FAKE,2899909565,238,2899909803,2923909504
2025-06-19 08:54:36,REAL,2899909803,2597,2899912400,2923912101
2025-06-19 08:54:38,FAKE,2899912400,244,2899912644,2923912586
2025-06-19 08:54:40,REAL,2899912644,482,2899913126,2923913068
2025-06-19 08:54:42,FAKE,2899913126,243,2899913369,2923924733
2025-06-19 08:54:44,FAKE,2899913369,243,2899913612,2923935977
2025-06-19 08:54:46,REAL,2899913612,10259,2899923871,2923946236
2025-06-19 08:54:48,REAL,2899923871,10324,2899934195,2923956560
2025-06-19 08:54:50,REAL,2899934195,10254,2899944449,2923966814
2025-06-19 08:54:52,REAL,2899944449,10255,2899954704,2923977069
2025-06-19 08:54:54,FAKE,2899954704,244,2899954948,2923987390
2025-06-19 08:54:56,REAL,2899954948,7209,2899962157,2923994599
2025-06-19 08:54:58,REAL,2899962157,482,2899962639,2923995081
2025-06-19 08:55:00,FAKE,2899962639,244,2899962883,2923995565
2025-06-19 08:55:02,REAL,2899962883,534,2899963417,2923996099
2025-06-19 08:55:04,REAL,2899963417,545,2899963962,2923996644
2025-06-19 08:55:06,REAL,2899963962,481,2899964443,2923997125
2025-06-19 08:55:08,REAL,2899964443,486,2899964929,2923997611
2025-06-19 08:55:10,REAL,2899964929,483,2899965412,2923998094
2025-06-19 08:55:12,FAKE,2899965412,241,2899965653,2923998579
2025-06-19 08:55:14,REAL,2899965653,484,2899966137,2923999063
2025-06-19 08:55:16,FAKE,2899966137,241,2899966378,2923999545
2025-06-19 08:55:18,FAKE,2899966378,244,2899966622,2924000028
2025-06-19 08:55:20,REAL,2899966622,478,2899967100,2924000506
2025-06-19 08:55:22,REAL,2899967100,483,2899967583,2924000989
2025-06-19 08:55:24,FAKE,2899967583,243,2899967826,2924001477
2025-06-19 08:55:26,REAL,2899967826,539,2899968365,2924002016
2025-06-19 08:55:28,REAL,2899968365,482,2899968847,2924002498
2025-06-19 08:55:30,REAL,2899968847,480,2899969327,2924002978
2025-06-19 08:55:32,REAL,2899969327,477,2899969804,2924003455
2025-06-19 08:55:34,FAKE,2899969804,244,2899970048,2924003938
2025-06-19 08:55:36,REAL,2899970048,478,2899970526,2924004416
2025-06-19 08:55:38,REAL,2899970526,481,2899971007,2924004897
2025-06-19 08:55:40,REAL,2899971007,544,2899971551,2924005441
2025-06-19 08:55:42,FAKE,2899971551,243,2899971794,2924005925
2025-06-19 08:55:44,REAL,2899971794,484,2899972278,2924006409
2025-06-19 08:55:46,REAL,2899972278,490,2899972768,2924006899
2025-06-19 08:55:48,FAKE,2899972768,244,2899973012,2924007390
2025-06-19 08:55:50,REAL,2899973012,546,2899973558,2924007936
2025-06-19 08:55:52,REAL,2899973558,479,2899974037,2924008415
2025-06-19 08:55:54,FAKE,2899974037,238,2899974275,2924008899
2025-06-19 08:55:56,REAL,2899974275,485,2899974760,2924009384
2025-06-19 08:55:58,REAL,2899974760,480,2899975240,2924009864
2025-06-19 08:56:00,FAKE,2899975240,241,2899975481,2924010345
2025-06-19 08:56:02,FAKE,2899975481,244,2899975725,2924010831
2025-06-19 08:56:04,REAL,2899975725,482,2899976207,2924011313
2025-06-19 08:56:06,REAL,2899976207,6041,2899982248,2924017354
2025-06-19 08:56:08,REAL,2899982248,11186,2899993434,2924028540
2025-06-19 08:56:10,FAKE,2899993434,244,2899993678,2924038796
2025-06-19 08:56:12,FAKE,2899993678,241,2899993919,2924049104
2025-06-19 08:56:14,FAKE,2899993919,243,2899994162,2924059357
2025-06-19 08:56:16,FAKE,2899994162,241,2899994403,2924069658
2025-06-19 08:56:18,FAKE,2899994403,238,2899994641,2924079972
2025-06-19 08:56:20,REAL,2899994641,10247,2900004888,2924090219
2025-06-19 08:56:22,FAKE,2900004888,243,2900005131,2924090893
2025-06-19 08:56:24,FAKE,2900005131,238,2900005369,2924091384
2025-06-19 08:56:26,REAL,2900005369,491,2900005860,2924091875
2025-06-19 08:56:28,REAL,2900005860,11857,2900017717,2924103732
2025-06-19 08:56:30,REAL,2900017717,10247,2900027964,2924113979
2025-06-19 08:56:32,REAL,2900027964,10253,2900038217,2924124232
2025-06-19 08:56:34,REAL,2900038217,10321,2900048538,2924134553
2025-06-19 08:56:36,REAL,2900048538,10246,2900058784,2924144799
2025-06-19 08:56:38,REAL,2900058784,10246,2900069030,2924155045
2025-06-19 08:56:40,REAL,2900069030,10250,2900079280,2924165295
2025-06-19 08:56:42,FAKE,2900079280,238,2900079518,2924170531
2025-06-19 08:56:44,FAKE,2900079518,244,2900079762,2924171015
2025-06-19 08:56:46,FAKE,2900079762,243,2900080005,2924171494
2025-06-19 08:56:48,REAL,2900080005,477,2900080482,2924171971
2025-06-19 08:56:50,FAKE,2900080482,243,2900080725,2924172457
2025-06-19 08:56:52,REAL,2900080725,537,2900081262,2924172994
2025-06-19 08:56:54,REAL,2900081262,478,2900081740,2924173472
2025-06-19 08:56:56,FAKE,2900081740,243,2900081983,2924173951
2025-06-19 08:56:58,REAL,2900081983,1347,2900083330,2924175298
2025-06-19 08:57:00,REAL,2900083330,11653,2900094983,2924186951
2025-06-19 08:57:02,REAL,2900094983,10320,2900105303,2924197271
2025-06-19 08:57:04,FAKE,2900105303,241,2900105544,2924207525
2025-06-19 08:57:06,REAL,2900105544,10261,2900115805,2924217786
2025-06-19 08:57:08,REAL,2900115805,10255,2900126060,2924228041
2025-06-19 08:57:10,REAL,2900126060,10311,2900136371,2924238352
2025-06-19 08:57:12,REAL,2900136371,10258,2900146629,2924248610
2025-06-19 08:57:14,REAL,2900146629,4639,2900151268,2924253249
2025-06-19 08:57:16,FAKE,2900151268,243,2900151511,2924253742
2025-06-19 08:57:18,REAL,2900151511,481,2900151992,2924254223
2025-06-19 08:57:20,REAL,2900151992,481,2900152473,2924254704
2025-06-19 08:57:22,REAL,2900152473,484,2900152957,2924255188
2025-06-19 08:57:24,REAL,2900152957,488,2900153445,2924255676
2025-06-19 08:57:26,FAKE,2900153445,243,2900153688,2924256162
2025-06-19 08:57:28,REAL,2900153688,475,2900154163,2924256637
2025-06-19 08:57:30,REAL,2900154163,2068,2900156231,2924258705
2025-06-19 08:57:32,REAL,2900156231,11577,2900167808,2924270282
2025-06-19 08:57:34,REAL,2900167808,10178,2900177986,2924280460
2025-06-19 08:57:36,FAKE,2900177986,238,2900178224,2924290776
2025-06-19 08:57:38,REAL,2900178224,10251,2900188475,2924301027
2025-06-19 08:57:40,REAL,2900188475,10245,2900198720,2924311272
2025-06-19 08:57:42,REAL,2900198720,10320,2900209040,2924321592
2025-06-19 08:57:44,REAL,2900209040,10254,2900219294,2924331846
2025-06-19 08:57:46,REAL,2900219294,4049,2900223343,2924335895
2025-06-19 08:57:48,REAL,2900223343,475,2900223818,2924336370
2025-06-19 08:57:50,REAL,2900223818,480,2900224298,2924336850
2025-06-19 08:57:52,FAKE,2900224298,243,2900224541,2924337339
2025-06-19 08:57:54,FAKE,2900224541,238,2900224779,2924337824
2025-06-19 08:57:56,REAL,2900224779,483,2900225262,2924338307
2025-06-19 08:57:58,REAL,2900225262,494,2900225756,2924338801
2025-06-19 08:58:00,REAL,2900225756,481,2900226237,2924339282
2025-06-19 08:58:02,FAKE,2900226237,238,2900226475,2924339764
2025-06-19 08:58:04,FAKE,2900226475,241,2900226716,2924340252
2025-06-19 08:58:06,REAL,2900226716,543,2900227259,2924340795
2025-06-19 08:58:08,REAL,2900227259,540,2900227799,2924341335
2025-06-19 08:58:10,REAL,2900227799,475,2900228274,2924341810
2025-06-19 08:58:12,REAL,2900228274,490,2900228764,2924342300
2025-06-19 08:58:14,REAL,2900228764,490,2900229254,2924342790
2025-06-19 08:58:16,REAL,2900229254,488,2900229742,2924343278
2025-06-19 08:58:18,FAKE,2900229742,241,2900229983,2924343759
2025-06-19 08:58:20,REAL,2900229983,488,2900230471,2924344247
2025-06-19 08:58:22,FAKE,2900230471,244,2900230715,2924344732
2025-06-19 08:58:24,FAKE,2900230715,243,2900230958,2924345225
2025-06-19 08:58:26,REAL,2900230958,482,2900231440,2924345707
2025-06-19 08:58:28,REAL,2900231440,483,2900231923,2924346190
2025-06-19 08:58:30,FAKE,2900231923,243,2900232166,2924346675
2025-06-19 08:58:32,REAL,2900232166,485,2900232651,2924347160
2025-06-19 08:58:34,REAL,2900232651,481,2900233132,2924347641
2025-06-19 08:58:36,REAL,2900233132,479,2900233611,2924348120
2025-06-19 08:58:38,REAL,2900233611,479,2900234090,2924348599
2025-06-19 08:58:40,REAL,2900234090,481,2900234571,2924349080
2025-06-19 08:58:42,REAL,2900234571,486,2900235057,2924349566
2025-06-19 08:58:44,REAL,2900235057,591,2900235648,2924350157
2025-06-19 08:58:46,REAL,2900235648,490,2900236138,2924350647
2025-06-19 08:58:48,REAL,2900236138,485,2900236623,2924351132
2025-06-19 08:58:50,REAL,2900236623,485,2900237108,2924351617
2025-06-19 08:58:52,FAKE,2900237108,243,2900237351,2924352102
2025-06-19 08:58:54,FAKE,2900237351,238,2900237589,2924352591
2025-06-19 08:58:56,REAL,2900237589,11646,2900249235,2924364237
2025-06-19 08:58:58,REAL,2900249235,11246,2900260481,2924375483
2025-06-19 08:59:00,FAKE,2900260481,244,2900260725,2924385734
2025-06-19 08:59:02,REAL,2900260725,10245,2900270970,2924395979
2025-06-19 08:59:04,REAL,2900270970,10317,2900281287,2924406296
2025-06-19 08:59:06,REAL,2900281287,10243,2900291530,2924416539
2025-06-19 08:59:08,FAKE,2900291530,238,2900291768,2924426856
2025-06-19 08:59:10,FAKE,2900291768,238,2900292006,2924434136
2025-06-19 08:59:12,FAKE,2900292006,241,2900292247,2924434622
2025-06-19 08:59:14,FAKE,2900292247,243,2900292490,2924435106
2025-06-19 08:59:16,FAKE,2900292490,243,2900292733,2924435586
2025-06-19 08:59:18,FAKE,2900292733,241,2900292974,2924436069
2025-06-19 08:59:20,REAL,2900292974,540,2900293514,2924436609
2025-06-19 08:59:22,REAL,2900293514,488,2900294002,2924437097
2025-06-19 08:59:24,FAKE,2900294002,243,2900294245,2924437574
2025-06-19 08:59:26,REAL,2900294245,483,2900294728,2924438057
2025-06-19 08:59:28,FAKE,2900294728,238,2900294966,2924448450
2025-06-19 08:59:30,REAL,2900294966,10520,2900305486,2924458970
2025-06-19 08:59:32,FAKE,2900305486,238,2900305724,2924469284
2025-06-19 08:59:34,REAL,2900305724,10246,2900315970,2924479530
2025-06-19 08:59:36,REAL,2900315970,10324,2900326294,2924489854
2025-06-19 08:59:38,REAL,2900326294,10251,2900336545,2924500105
2025-06-19 08:59:40,REAL,2900336545,10326,2900346871,2924510431
2025-06-19 08:59:42,REAL,2900346871,6626,2900353497,2924517057
2025-06-19 08:59:44,REAL,2900353497,486,2900353983,2924517543
2025-06-19 08:59:46,FAKE,2900353983,243,2900354226,2924518025
2025-06-19 08:59:48,REAL,2900354226,492,2900354718,2924518517
2025-06-19 08:59:50,FAKE,2900354718,238,2900354956,2924518996
2025-06-19 08:59:52,REAL,2900354956,479,2900355435,2924519475
2025-06-19 08:59:54,FAKE,2900355435,241,2900355676,2924519952
2025-06-19 08:59:56,REAL,2900355676,488,2900356164,2924520440
2025-06-19 08:59:58,REAL,2900356164,488,2900356652,2924520928
2025-06-19 09:00:00,REAL,2900356652,480,2900357132,2924521408
2025-06-19 09:00:02,REAL,2900357132,480,2900357612,2924521888
2025-06-19 09:00:04,REAL,2900357612,534,2900358146,2924522422
2025-06-19 09:00:06,FAKE,2900358146,238,2900358384,2924522969
2025-06-19 09:00:08,REAL,2900358384,485,2900358869,2924523454
2025-06-19 09:00:10,FAKE,2900358869,238,2900359107,2924523935
2025-06-19 09:00:12,FAKE,2900359107,241,2900359348,2924524416
2025-06-19 09:00:14,REAL,2900359348,485,2900359833,2924524901
2025-06-19 09:00:16,REAL,2900359833,483,2900360316,2924525384
2025-06-19 09:00:18,REAL,2900360316,486,2900360802,2924525870
2025-06-19 09:00:20,REAL,2900360802,7682,2900368484,2924533552
2025-06-19 09:00:22,REAL,2900368484,9613,2900378097,2924543165
2025-06-19 09:00:24,REAL,2900378097,10250,2900388347,2924553415
2025-06-19 09:00:26,REAL,2900388347,10249,2900398596,2924563664
2025-06-19 09:00:28,FAKE,2900398596,238,2900398834,2924573926
2025-06-19 09:00:30,REAL,2900398834,10318,2900409152,2924584244
2025-06-19 09:00:32,REAL,2900409152,10255,2900419407,2924594499
2025-06-19 09:00:34,REAL,2900419407,10250,2900429657,2924604749
2025-06-19 09:00:36,REAL,2900429657,816,2900430473,2924605565
2025-06-19 09:00:38,FAKE,2900430473,241,2900430714,2924606056
2025-06-19 09:00:40,FAKE,2900430714,238,2900430952,2924606541
2025-06-19 09:00:42,REAL,2900430952,485,2900431437,2924607026
2025-06-19 09:00:44,REAL,2900431437,490,2900431927,2924607516
2025-06-19 09:00:46,REAL,2900431927,488,2900432415,2924608004
2025-06-19 09:00:48,REAL,2900432415,494,2900432909,2924608498
2025-06-19 09:00:50,REAL,2900432909,534,2900433443,2924609032
2025-06-19 09:00:52,REAL,2900433443,480,2900433923,2924609512
2025-06-19 09:00:54,REAL,2900433923,478,2900434401,2924609990
2025-06-19 09:00:56,FAKE,2900434401,243,2900434644,2924610532
2025-06-19 09:00:58,FAKE,2900434644,241,2900434885,2924611013
2025-06-19 09:01:00,REAL,2900434885,484,2900435369,2924611497
2025-06-19 09:01:02,REAL,2900435369,480,2900435849,2924611977
2025-06-19 09:01:04,REAL,2900435849,485,2900436334,2924612462
2025-06-19 09:01:06,FAKE,2900436334,241,2900436575,2924612948
2025-06-19 09:01:08,REAL,2900436575,485,2900437060,2924613433
2025-06-19 09:01:10,FAKE,2900437060,238,2900437298,2924613920
2025-06-19 09:01:12,REAL,2900437298,891,2900438189,2924614811
2025-06-19 09:01:14,FAKE,2900438189,244,2900438433,2924629610
2025-06-19 09:01:16,REAL,2900438433,10312,2900448745,2924639922
2025-06-19 09:01:18,REAL,2900448745,10320,2900459065,2924650242
2025-06-19 09:01:20,FAKE,2900459065,244,2900459309,2924660490
2025-06-19 09:01:22,REAL,2900459309,10320,2900469629,2924670810
2025-06-19 09:01:24,REAL,2900469629,10247,2900479876,2924681057
2025-06-19 09:01:26,REAL,2900479876,10319,2900490195,2924691376
2025-06-19 09:01:28,REAL,2900490195,4704,2900494899,2924696080
2025-06-19 09:01:30,FAKE,2900494899,241,2900495140,2924696563
2025-06-19 09:01:32,REAL,2900495140,491,2900495631,2924697054
2025-06-19 09:01:34,FAKE,2900495631,244,2900495875,2924697537
2025-06-19 09:01:36,REAL,2900495875,533,2900496408,2924698070
2025-06-19 09:01:38,FAKE,2900496408,238,2900496646,2924698557
2025-06-19 09:01:40,REAL,2900496646,479,2900497125,2924699036
2025-06-19 09:01:42,FAKE,2900497125,243,2900497368,2924699522
2025-06-19 09:01:44,FAKE,2900497368,244,2900497612,2924701528
2025-06-19 09:01:46,FAKE,2900497612,241,2900497853,2924713558
2025-06-19 09:01:48,REAL,2900497853,10319,2900508172,2924723877
2025-06-19 09:01:50,FAKE,2900508172,238,2900508410,2924734127
2025-06-19 09:01:52,REAL,2900508410,10246,2900518656,2924744373
2025-06-19 09:01:54,REAL,2900518656,10316,2900528972,2924754689
2025-06-19 09:01:56,FAKE,2900528972,241,2900529213,2924764944
2025-06-19 09:01:58,FAKE,2900529213,243,2900529456,2924775261
2025-06-19 09:02:00,REAL,2900529456,4055,2900533511,2924779316
2025-06-19 09:02:02,REAL,2900533511,482,2900533993,2924779798
2025-06-19 09:02:04,FAKE,2900533993,243,2900534236,2924780276
2025-06-19 09:02:06,REAL,2900534236,482,2900534718,2924780758
2025-06-19 09:02:08,FAKE,2900534718,241,2900534959,2924781241
2025-06-19 09:02:10,FAKE,2900534959,238,2900535197,2924781725
2025-06-19 09:02:12,REAL,2900535197,484,2900535681,2924782209
2025-06-19 09:02:14,REAL,2900535681,482,2900536163,2924782691
2025-06-19 09:02:16,REAL,2900536163,2740,2900538903,2924785431
2025-06-19 09:02:18,REAL,2900538903,14548,2900553451,2924799979
2025-06-19 09:02:20,REAL,2900553451,10374,2900563825,2924810353
2025-06-19 09:02:22,REAL,2900563825,10252,2900574077,2924820605
2025-06-19 09:02:24,REAL,2900574077,10243,2900584320,2924830848
2025-06-19 09:02:26,REAL,2900584320,10256,2900594576,2924841104
2025-06-19 09:02:28,REAL,2900594576,10312,2900604888,2924851416
2025-06-19 09:02:30,REAL,2900604888,10247,2900615135,2924861663
2025-06-19 09:02:32,FAKE,2900615135,243,2900615378,2924865124
2025-06-19 09:02:34,REAL,2900615378,483,2900615861,2924865607
2025-06-19 09:02:36,REAL,2900615861,488,2900616349,2924866095
2025-06-19 09:02:38,REAL,2900616349,487,2900616836,2924866582
2025-06-19 09:02:40,FAKE,2900616836,243,2900617079,2924867066
2025-06-19 09:02:42,REAL,2900617079,483,2900617562,2924867549
2025-06-19 09:02:44,REAL,2900617562,476,2900618038,2924868025
2025-06-19 09:02:46,REAL,2900618038,488,2900618526,2924868513
2025-06-19 09:02:48,REAL,2900618526,486,2900619012,2924868999
2025-06-19 09:02:50,REAL,2900619012,484,2900619496,2924869483
2025-06-19 09:02:52,REAL,2900619496,480,2900619976,2924869963
2025-06-19 09:02:54,REAL,2900619976,475,2900620451,2924870438
2025-06-19 09:02:56,FAKE,2900620451,243,2900620694,2924870916
2025-06-19 09:02:58,FAKE,2900620694,243,2900620937,2924871400
2025-06-19 09:03:00,REAL,2900620937,478,2900621415,2924871878
2025-06-19 09:03:02,REAL,2900621415,487,2900621902,2924872365
2025-06-19 09:03:04,REAL,2900621902,540,2900622442,2924872905
2025-06-19 09:03:06,FAKE,2900622442,243,2900622685,2924873441
2025-06-19 09:03:08,FAKE,2900622685,244,2900622929,2924873923
2025-06-19 09:03:10,REAL,2900622929,9609,2900632538,2924883532
2025-06-19 09:03:12,REAL,2900632538,10446,2900642984,2924893978
2025-06-19 09:03:14,REAL,2900642984,10253,2900653237,2924904231
2025-06-19 09:03:16,REAL,2900653237,10317,2900663554,2924914548
2025-06-19 09:03:18,REAL,2900663554,10253,2900673807,2924924801
2025-06-19 09:03:20,REAL,2900673807,10317,2900684124,2924935118
2025-06-19 09:03:22,REAL,2900684124,10254,2900694378,2924945372
2025-06-19 09:03:24,REAL,2900694378,7357,2900701735,2924952729
2025-06-19 09:03:26,REAL,2900701735,493,2900702228,2924953222
2025-06-19 09:03:28,REAL,2900702228,483,2900702711,2924953705
2025-06-19 09:03:30,REAL,2900702711,486,2900703197,2924954191
2025-06-19 09:03:32,REAL,2900703197,480,2900703677,2924954671
2025-06-19 09:03:34,FAKE,2900703677,244,2900703921,2924955158
2025-06-19 09:03:36,REAL,2900703921,493,2900704414,2924955651
2025-06-19 09:03:38,REAL,2900704414,480,2900704894,2924956131
2025-06-19 09:03:40,FAKE,2900704894,243,2900705137,2924956625
2025-06-19 09:03:42,REAL,2900705137,10721,2900715858,2924967346
2025-06-19 09:03:44,FAKE,2900715858,238,2900716096,2924977796
2025-06-19 09:03:46,FAKE,2900716096,238,2900716334,2924988113
2025-06-19 09:03:48,REAL,2900716334,10247,2900726581,2924998360
2025-06-19 09:03:50,REAL,2900726581,10260,2900736841,2925008620
2025-06-19 09:03:52,REAL,2900736841,10374,2900747215,2925018994
2025-06-19 09:03:54,FAKE,2900747215,243,2900747458,2925029246
2025-06-19 09:03:56,REAL,2900747458,6751,2900754209,2925035997
2025-06-19 09:03:58,REAL,2900754209,489,2900754698,2925036486
2025-06-19 09:04:00,FAKE,2900754698,238,2900754936,2925036973
2025-06-19 09:04:02,REAL,2900754936,483,2900755419,2925037456
2025-06-19 09:04:04,REAL,2900755419,479,2900755898,2925037935
2025-06-19 09:04:06,FAKE,2900755898,244,2900756142,2925038422
2025-06-19 09:04:08,FAKE,2900756142,241,2900756383,2925038905
2025-06-19 09:04:10,REAL,2900756383,493,2900756876,2925039398
2025-06-19 09:04:12,REAL,2900756876,477,2900757353,2925039875
2025-06-19 09:04:14,FAKE,2900757353,244,2900757597,2925040356
2025-06-19 09:04:16,REAL,2900757597,489,2900758086,2925040845
2025-06-19 09:04:18,FAKE,2900758086,244,2900758330,2925041328
2025-06-19 09:04:20,FAKE,2900758330,243,2900758573,2925041821
2025-06-19 09:04:22,REAL,2900758573,479,2900759052,2925042300
2025-06-19 09:04:24,REAL,2900759052,487,2900759539,2925042787
2025-06-19 09:04:26,REAL,2900759539,483,2900760022,2925043270
2025-06-19 09:04:28,FAKE,2900760022,243,2900760265,2925043811
2025-06-19 09:04:30,FAKE,2900760265,241,2900760506,2925044290
2025-06-19 09:04:32,REAL,2900760506,245,2900760751,2925044535
2025-06-19 09:04:34,REAL,2900760751,485,2900761236,2925045020
2025-06-19 09:04:36,REAL,2900761236,531,2900761767,2925045551
2025-06-19 09:04:38,REAL,2900761767,490,2900762257,2925046041
2025-06-19 09:04:40,REAL,2900762257,489,2900762746,2925046530
2025-06-19 09:04:42,REAL,2900762746,487,2900763233,2925047017
2025-06-19 09:04:44,REAL,2900763233,484,2900763717,2925047501
2025-06-19 09:04:46,REAL,2900763717,491,2900764208,2925047992
2025-06-19 09:04:48,REAL,2900764208,486,2900764694,2925048478
2025-06-19 09:04:50,REAL,2900764694,490,2900765184,2925048968
2025-06-19 09:04:52,REAL,2900765184,730,2900765914,2925049698
2025-06-19 09:04:54,REAL,2900765914,237,2900766151,2925049935
2025-06-19 09:04:56,REAL,2900766151,14221,2900780372,2925064156
2025-06-19 09:04:58,REAL,2900780372,10324,2900790696,2925074480
2025-06-19 09:05:00,REAL,2900790696,10319,2900801015,2925084799
2025-06-19 09:05:02,FAKE,2900801015,243,2900801258,2925095060
2025-06-19 09:05:04,REAL,2900801258,10320,2900811578,2925105380
2025-06-19 09:05:06,REAL,2900811578,10243,2900821821,2925115623
2025-06-19 09:05:08,REAL,2900821821,10253,2900832074,2925125876
2025-06-19 09:05:10,REAL,2900832074,5636,2900837710,2925131512
2025-06-19 09:05:12,FAKE,2900837710,244,2900837954,2925132058
2025-06-19 09:05:14,REAL,2900837954,484,2900838438,2925132542
2025-06-19 09:05:16,FAKE,2900838438,241,2900838679,2925133032
2025-06-19 09:05:18,REAL,2900838679,492,2900839171,2925133524
2025-06-19 09:05:20,REAL,2900839171,494,2900839665,2925134018
2025-06-19 09:05:22,FAKE,2900839665,241,2900839906,2925134510
2025-06-19 09:05:24,REAL,2900839906,486,2900840392,2925134996
2025-06-19 09:05:26,REAL,2900840392,627,2900841019,2925135623
2025-06-19 09:05:28,FAKE,2900841019,243,2900841262,2925150958
2025-06-19 09:05:30,FAKE,2900841262,241,2900841503,2925161206
2025-06-19 09:05:32,REAL,2900841503,10249,2900851752,2925171455
2025-06-19 09:05:34,FAKE,2900851752,244,2900851996,2925181712
2025-06-19 09:05:36,REAL,2900851996,10326,2900862322,2925192038
2025-06-19 09:05:38,REAL,2900862322,10251,2900872573,2925202289
2025-06-19 09:05:40,REAL,2900872573,10251,2900882824,2925212540
2025-06-19 09:05:42,REAL,2900882824,4904,2900887728,2925217444
2025-06-19 09:05:44,REAL,2900887728,485,2900888213,2925217929
2025-06-19 09:05:46,REAL,2900888213,546,2900888759,2925218475
2025-06-19 09:05:48,REAL,2900888759,486,2900889245,2925218961
2025-06-19 09:05:50,REAL,2900889245,478,2900889723,2925219439
2025-06-19 09:05:52,REAL,2900889723,486,2900890209,2925219925
2025-06-19 09:05:54,REAL,2900890209,489,2900890698,2925220414
2025-06-19 09:05:56,FAKE,2900890698,241,2900890939,2925220895
2025-06-19 09:05:58,REAL,2900890939,485,2900891424,2925221380
2025-06-19 09:06:00,REAL,2900891424,488,2900891912,2925221868
2025-06-19 09:06:02,REAL,2900891912,474,2900892386,2925222342
2025-06-19 09:06:04,REAL,2900892386,482,2900892868,2925222824
2025-06-19 09:06:06,REAL,2900892868,490,2900893358,2925223314
2025-06-19 09:06:08,REAL,2900893358,488,2900893846,2925223802
2025-06-19 09:06:10,REAL,2900893846,491,2900894337,2925224293
2025-06-19 09:06:12,REAL,2900894337,480,2900894817,2925224773
2025-06-19 09:06:14,REAL,2900894817,542,2900895359,2925225315
2025-06-19 09:06:16,FAKE,2900895359,238,2900895597,2925225796
2025-06-19 09:06:18,FAKE,2900895597,243,2900895840,2925226277
2025-06-19 09:06:20,REAL,2900895840,545,2900896385,2925226822
2025-06-19 09:06:22,FAKE,2900896385,241,2900896626,2925227308
2025-06-19 09:06:24,FAKE,2900896626,244,2900896870,2925227790
2025-06-19 09:06:26,FAKE,2900896870,244,2900897114,2925228272
2025-06-19 09:06:28,FAKE,2900897114,243,2900897357,2925228762
2025-06-19 09:06:30,REAL,2900897357,2274,2900899631,2925231036
2025-06-19 09:06:32,REAL,2900899631,14271,2900913902,2925245307
2025-06-19 09:06:34,REAL,2900913902,10251,2900924153,2925255558
2025-06-19 09:06:36,FAKE,2900924153,244,2900924397,2925265877
2025-06-19 09:06:38,REAL,2900924397,10254,2900934651,2925276131
2025-06-19 09:06:40,REAL,2900934651,10317,2900944968,2925286448
2025-06-19 09:06:42,REAL,2900944968,10251,2900955219,2925296699
2025-06-19 09:06:44,REAL,2900955219,10246,2900965465,2925306945
2025-06-19 09:06:46,REAL,2900965465,3712,2900969177,2925310657
2025-06-19 09:06:48,FAKE,2900969177,244,2900969421,2925311141
2025-06-19 09:06:50,FAKE,2900969421,244,2900969665,2925311634
2025-06-19 09:06:52,FAKE,2900969665,243,2900969908,2925312117
2025-06-19 09:06:54,REAL,2900969908,484,2900970392,2925312601
2025-06-19 09:06:56,REAL,2900970392,539,2900970931,2925313140
2025-06-19 09:06:58,REAL,2900970931,490,2900971421,2925313630
2025-06-19 09:07:00,REAL,2900971421,489,2900971910,2925314119
2025-06-19 09:07:02,REAL,2900971910,477,2900972387,2925314596
2025-06-19 09:07:04,FAKE,2900972387,244,2900972631,2925315085
2025-06-19 09:07:06,REAL,2900972631,477,2900973108,2925315562
2025-06-19 09:07:08,REAL,2900973108,486,2900973594,2925316048
2025-06-19 09:07:10,REAL,2900973594,484,2900974078,2925316532
2025-06-19 09:07:12,FAKE,2900974078,244,2900974322,2925317014
2025-06-19 09:07:14,FAKE,2900974322,244,2900974566,2925317506
2025-06-19 09:07:16,REAL,2900974566,482,2900975048,2925317988
2025-06-19 09:07:18,REAL,2900975048,539,2900975587,2925318527
2025-06-19 09:07:20,REAL,2900975587,486,2900976073,2925319013
2025-06-19 09:07:22,FAKE,2900976073,243,2900976316,2925319496
2025-06-19 09:07:24,REAL,2900976316,484,2900976800,2925319980
2025-06-19 09:07:26,FAKE,2900976800,241,2900977041,2925320462
2025-06-19 09:07:28,REAL,2900977041,490,2900977531,2925320952
2025-06-19 09:07:30,REAL,2900977531,534,2900978065,2925321486
2025-06-19 09:07:32,REAL,2900978065,484,2900978549,2925321970
2025-06-19 09:07:34,FAKE,2900978549,241,2900978790,2925322457
2025-06-19 09:07:36,REAL,2900978790,491,2900979281,2925322948
2025-06-19 09:07:38,FAKE,2900979281,241,2900979522,2925323429
2025-06-19 09:07:40,REAL,2900979522,479,2900980001,2925323908
2025-06-19 09:07:42,REAL,2900980001,485,2900980486,2925324393
2025-06-19 09:07:44,FAKE,2900980486,241,2900980727,2925328059
2025-06-19 09:07:46,REAL,2900980727,11172,2900991899,2925339231
2025-06-19 09:07:48,REAL,2900991899,10311,2901002210,2925349542
2025-06-19 09:07:50,REAL,2901002210,10253,2901012463,2925359795
2025-06-19 09:07:52,REAL,2901012463,10311,2901022774,2925370106
2025-06-19 09:07:54,REAL,2901022774,10258,2901033032,2925380364
2025-06-19 09:07:56,REAL,2901033032,10320,2901043352,2925390684
2025-06-19 09:07:58,REAL,2901043352,10251,2901053603,2925400935
2025-06-19 09:08:00,FAKE,2901053603,241,2901053844,2925403526
2025-06-19 09:08:02,REAL,2901053844,492,2901054336,2925404018
2025-06-19 09:08:04,REAL,2901054336,532,2901054868,2925404550
2025-06-19 09:08:06,FAKE,2901054868,238,2901055106,2925405035
2025-06-19 09:08:08,FAKE,2901055106,241,2901055347,2925405510
2025-06-19 09:08:10,REAL,2901055347,480,2901055827,2925405990
2025-06-19 09:08:12,REAL,2901055827,483,2901056310,2925406473
2025-06-19 09:08:14,FAKE,2901056310,241,2901056551,2925406959
2025-06-19 09:08:16,FAKE,2901056551,238,2901056789,2925407447
2025-06-19 09:08:18,FAKE,2901056789,243,2901057032,2925407934
2025-06-19 09:08:20,REAL,2901057032,482,2901057514,2925408416
2025-06-19 09:08:22,REAL,2901057514,484,2901057998,2925408900
2025-06-19 09:08:24,REAL,2901057998,485,2901058483,2925409385
2025-06-19 09:08:26,REAL,2901058483,488,2901058971,2925409873
2025-06-19 09:08:28,REAL,2901058971,483,2901059454,2925410356
2025-06-19 09:08:30,REAL,2901059454,548,2901060002,2925410904
2025-06-19 09:08:32,REAL,2901060002,484,2901060486,2925411388
2025-06-19 09:08:34,FAKE,2901060486,238,2901060724,2925411875
2025-06-19 09:08:36,REAL,2901060724,488,2901061212,2925412363
2025-06-19 09:08:38,REAL,2901061212,483,2901061695,2925412846
2025-06-19 09:08:40,REAL,2901061695,534,2901062229,2925413380
2025-06-19 09:08:42,FAKE,2901062229,241,2901062470,2925413862
2025-06-19 09:08:44,FAKE,2901062470,244,2901062714,2925414355
2025-06-19 09:08:46,FAKE,2901062714,238,2901062952,2925414837
2025-06-19 09:08:48,REAL,2901062952,11125,2901074077,2925425962
2025-06-19 09:08:50,REAL,2901074077,10450,2901084527,2925436412
2025-06-19 09:08:52,REAL,2901084527,10323,2901094850,2925446735
2025-06-19 09:08:54,FAKE,2901094850,243,2901095093,2925457125
2025-06-19 09:08:56,REAL,2901095093,10184,2901105277,2925467309
2025-06-19 09:08:58,REAL,2901105277,10251,2901115528,2925477560
2025-06-19 09:09:00,REAL,2901115528,10248,2901125776,2925487808
2025-06-19 09:09:02,REAL,2901125776,6550,2901132326,2925494358
2025-06-19 09:09:04,REAL,2901132326,488,2901132814,2925494846
2025-06-19 09:09:06,REAL,2901132814,479,2901133293,2925495325
2025-06-19 09:09:08,REAL,2901133293,486,2901133779,2925495811
2025-06-19 09:09:10,REAL,2901133779,485,2901134264,2925496296
2025-06-19 09:09:12,REAL,2901134264,491,2901134755,2925496787
2025-06-19 09:09:14,REAL,2901134755,542,2901135297,2925497329
2025-06-19 09:09:16,REAL,2901135297,479,2901135776,2925497808
2025-06-19 09:09:18,REAL,2901135776,480,2901136256,2925498288
2025-06-19 09:09:20,REAL,2901136256,14680,2901150936,2925512968
2025-06-19 09:09:22,REAL,2901150936,10259,2901161195,2925523227
2025-06-19 09:09:24,FAKE,2901161195,238,2901161433,2925533483
2025-06-19 09:09:26,REAL,2901161433,10323,2901171756,2925543806
2025-06-19 09:09:28,FAKE,2901171756,241,2901171997,2925554065
2025-06-19 09:09:30,REAL,2901171997,10313,2901182310,2925564378
2025-06-19 09:09:32,REAL,2901182310,10253,2901192563,2925574631
2025-06-19 09:09:34,REAL,2901192563,5826,2901198389,2925580457
2025-06-19 09:09:36,FAKE,2901198389,243,2901198632,2925580940
2025-06-19 09:09:38,REAL,2901198632,478,2901199110,2925581418
2025-06-19 09:09:40,REAL,2901199110,484,2901199594,2925581902
2025-06-19 09:09:42,REAL,2901199594,484,2901200078,2925582386
2025-06-19 09:09:44,REAL,2901200078,483,2901200561,2925582869
2025-06-19 09:09:46,REAL,2901200561,487,2901201048,2925583356
2025-06-19 09:09:48,REAL,2901201048,490,2901201538,2925583846
2025-06-19 09:09:50,REAL,2901201538,540,2901202078,2925584386
2025-06-19 09:09:52,FAKE,2901202078,238,2901202316,2925596356
2025-06-19 09:09:54,REAL,2901202316,10252,2901212568,2925606608
2025-06-19 09:09:56,REAL,2901212568,10251,2901222819,2925616859
2025-06-19 09:09:58,FAKE,2901222819,241,2901223060,2925627113
2025-06-19 09:10:00,REAL,2901223060,10312,2901233372,2925637425
2025-06-19 09:10:02,REAL,2901233372,10249,2901243621,2925647674
2025-06-19 09:10:04,REAL,2901243621,10253,2901253874,2925657927
2025-06-19 09:10:06,REAL,2901253874,5301,2901259175,2925663228
2025-06-19 09:10:08,FAKE,2901259175,238,2901259413,2925663722
2025-06-19 09:10:10,FAKE,2901259413,244,2901259657,2925664204
2025-06-19 09:10:12,FAKE,2901259657,238,2901259895,2925664688
2025-06-19 09:10:14,REAL,2901259895,486,2901260381,2925665174
2025-06-19 09:10:16,FAKE,2901260381,238,2901260619,2925665664
2025-06-19 09:10:18,REAL,2901260619,483,2901261102,2925666147
2025-06-19 09:10:20,REAL,2901261102,489,2901261591,2925666636
2025-06-19 09:10:22,REAL,2901261591,534,2901262125,2925667170
2025-06-19 09:10:24,FAKE,2901262125,241,2901262366,2925667656
2025-06-19 09:10:26,FAKE,2901262366,243,2901262609,2925668142
2025-06-19 09:10:28,REAL,2901262609,478,2901263087,2925668620
2025-06-19 09:10:30,REAL,2901263087,482,2901263569,2925669102
2025-06-19 09:10:32,FAKE,2901263569,238,2901263807,2925669583
2025-06-19 09:10:34,REAL,2901263807,488,2901264295,2925670071
2025-06-19 09:10:36,FAKE,2901264295,244,2901264539,2925670551
2025-06-19 09:10:38,REAL,2901264539,543,2901265082,2925671094
2025-06-19 09:10:40,REAL,2901265082,481,2901265563,2925671575
2025-06-19 09:10:42,REAL,2901265563,489,2901266052,2925672064
2025-06-19 09:10:44,FAKE,2901266052,238,2901266290,2925672539
2025-06-19 09:10:46,FAKE,2901266290,244,2901266534,2925673025
2025-06-19 09:10:48,FAKE,2901266534,243,2901266777,2925673515
2025-06-19 09:10:50,FAKE,2901266777,241,2901267018,2925674001
2025-06-19 09:10:52,FAKE,2901267018,238,2901267256,2925674486
2025-06-19 09:10:54,REAL,2901267256,535,2901267791,2925675021
2025-06-19 09:10:56,REAL,2901267791,486,2901268277,2925675507
2025-06-19 09:10:58,REAL,2901268277,492,2901268769,2925675999
2025-06-19 09:11:00,REAL,2901268769,482,2901269251,2925676481
2025-06-19 09:11:02,REAL,2901269251,483,2901269734,2925676964
2025-06-19 09:11:04,REAL,2901269734,484,2901270218,2925677448
2025-06-19 09:11:06,REAL,2901270218,486,2901270704,2925677934
2025-06-19 09:11:08,REAL,2901270704,480,2901271184,2925678414
2025-06-19 09:11:10,REAL,2901271184,481,2901271665,2925678895
2025-06-19 09:11:12,FAKE,2901271665,241,2901271906,2925679369
2025-06-19 09:11:14,REAL,2901271906,485,2901272391,2925679854
2025-06-19 09:11:16,REAL,2901272391,484,2901272875,2925680338
2025-06-19 09:11:18,REAL,2901272875,483,2901273358,2925680821
2025-06-19 09:11:20,REAL,2901273358,486,2901273844,2925681307
2025-06-19 09:11:22,REAL,2901273844,479,2901274323,2925681786
2025-06-19 09:11:24,REAL,2901274323,488,2901274811,2925682274
2025-06-19 09:11:26,REAL,2901274811,8540,2901283351,2925690814
2025-06-19 09:11:28,REAL,2901283351,10904,2901294255,2925701718
2025-06-19 09:11:30,FAKE,2901294255,241,2901294496,2925711970
2025-06-19 09:11:32,REAL,2901294496,10315,2901304811,2925722285
2025-06-19 09:11:34,REAL,2901304811,10250,2901315061,2925732535
2025-06-19 09:11:36,FAKE,2901315061,243,2901315304,2925742785
2025-06-19 09:11:38,REAL,2901315304,10248,2901325552,2925753033
2025-06-19 09:11:40,FAKE,2901325552,244,2901325796,2925761705
2025-06-19 09:11:42,REAL,2901325796,487,2901326283,2925762192
2025-06-19 09:11:44,REAL,2901326283,479,2901326762,2925762671
2025-06-19 09:11:46,FAKE,2901326762,244,2901327006,2925763155
2025-06-19 09:11:48,REAL,2901327006,493,2901327499,2925763648
2025-06-19 09:11:50,REAL,2901327499,483,2901327982,2925764131
2025-06-19 09:11:52,REAL,2901327982,488,2901328470,2925764619
2025-06-19 09:11:54,REAL,2901328470,485,2901328955,2925765104
2025-06-19 09:11:56,REAL,2901328955,487,2901329442,2925765591
2025-06-19 09:11:58,REAL,2901329442,478,2901329920,2925766069
2025-06-19 09:12:00,FAKE,2901329920,243,2901330163,2925766609
2025-06-19 09:12:02,REAL,2901330163,480,2901330643,2925767089
2025-06-19 09:12:04,REAL,2901330643,486,2901331129,2925767575
2025-06-19 09:12:06,REAL,2901331129,477,2901331606,2925768052
2025-06-19 09:12:08,FAKE,2901331606,238,2901331844,2925768541
2025-06-19 09:12:10,FAKE,2901331844,243,2901332087,2925769027
2025-06-19 09:12:12,REAL,2901332087,478,2901332565,2925769505
2025-06-19 09:12:14,REAL,2901332565,545,2901333110,2925770050
2025-06-19 09:12:16,REAL,2901333110,483,2901333593,2925770533
2025-06-19 09:12:18,REAL,2901333593,489,2901334082,2925771022
2025-06-19 09:12:20,FAKE,2901334082,241,2901334323,2925771508
2025-06-19 09:12:22,REAL,2901334323,480,2901334803,2925771988
2025-06-19 09:12:24,REAL,2901334803,483,2901335286,2925772471
2025-06-19 09:12:26,REAL,2901335286,479,2901335765,2925772950
2025-06-19 09:12:28,REAL,2901335765,488,2901336253,2925773438
2025-06-19 09:12:30,REAL,2901336253,10339,2901346592,2925783777
2025-06-19 09:12:32,REAL,2901346592,10836,2901357428,2925794613
2025-06-19 09:12:34,REAL,2901357428,10253,2901367681,2925804866
2025-06-19 09:12:36,FAKE,2901367681,241,2901367922,2925815121
2025-06-19 09:12:38,REAL,2901367922,10318,2901378240,2925825439
2025-06-19 09:12:40,FAKE,2901378240,238,2901378478,2925835697
2025-06-19 09:12:42,FAKE,2901378478,244,2901378722,2925846017
2025-06-19 09:12:44,FAKE,2901378722,241,2901378963,2925853357
2025-06-19 09:12:46,REAL,2901378963,488,2901379451,2925853845
2025-06-19 09:12:48,REAL,2901379451,485,2901379936,2925854330
2025-06-19 09:12:50,REAL,2901379936,480,2901380416,2925854810
2025-06-19 09:12:52,REAL,2901380416,484,2901380900,2925855294
2025-06-19 09:12:54,REAL,2901380900,481,2901381381,2925855775
2025-06-19 09:12:56,REAL,2901381381,485,2901381866,2925856260
2025-06-19 09:12:58,REAL,2901381866,492,2901382358,2925856752
2025-06-19 09:13:00,REAL,2901382358,486,2901382844,2925857238
2025-06-19 09:13:02,FAKE,2901382844,241,2901383085,2925857717
2025-06-19 09:13:04,FAKE,2901383085,241,2901383326,2925858206
2025-06-19 09:13:06,REAL,2901383326,546,2901383872,2925858752
2025-06-19 09:13:08,REAL,2901383872,486,2901384358,2925859238
2025-06-19 09:13:10,REAL,2901384358,486,2901384844,2925859724
2025-06-19 09:13:12,REAL,2901384844,485,2901385329,2925860209
2025-06-19 09:13:14,FAKE,2901385329,241,2901385570,2925860698
2025-06-19 09:13:16,FAKE,2901385570,243,2901385813,2925861177
2025-06-19 09:13:18,REAL,2901385813,542,2901386355,2925861719
2025-06-19 09:13:20,REAL,2901386355,484,2901386839,2925862203
2025-06-19 09:13:22,REAL,2901386839,480,2901387319,2925862683
2025-06-19 09:13:24,REAL,2901387319,490,2901387809,2925863173
2025-06-19 09:13:26,REAL,2901387809,474,2901388283,2925863647
2025-06-19 09:13:28,REAL,2901388283,481,2901388764,2925864128
2025-06-19 09:13:30,FAKE,2901388764,244,2901389008,2925864606
2025-06-19 09:13:32,REAL,2901389008,480,2901389488,2925865086
2025-06-19 09:13:34,REAL,2901389488,13890,2901403378,2925878976
2025-06-19 09:13:36,FAKE,2901403378,244,2901403622,2925889294
2025-06-19 09:13:38,REAL,2901403622,10375,2901413997,2925899669
2025-06-19 09:13:40,REAL,2901413997,10255,2901424252,2925909924
2025-06-19 09:13:42,REAL,2901424252,10319,2901434571,2925920243
2025-06-19 09:13:44,REAL,2901434571,10247,2901444818,2925930490
2025-06-19 09:13:46,FAKE,2901444818,238,2901445056,2925940807
2025-06-19 09:13:48,REAL,2901445056,6092,2901451148,2925946899
2025-06-19 09:13:50,REAL,2901451148,484,2901451632,2925947383
2025-06-19 09:13:52,FAKE,2901451632,243,2901451875,2925947869
2025-06-19 09:13:54,REAL,2901451875,480,2901452355,2925948349
2025-06-19 09:13:56,REAL,2901452355,479,2901452834,2925948828
2025-06-19 09:13:58,FAKE,2901452834,238,2901453072,2925949315
2025-06-19 09:14:00,REAL,2901453072,481,2901453553,2925949796
2025-06-19 09:14:02,REAL,2901453553,483,2901454036,2925950279
2025-06-19 09:14:04,REAL,2901454036,484,2901454520,2925950763
2025-06-19 09:14:06,REAL,2901454520,488,2901455008,2925951251
2025-06-19 09:14:08,FAKE,2901455008,241,2901455249,2925951726
2025-06-19 09:14:10,FAKE,2901455249,241,2901455490,2925952212
2025-06-19 09:14:12,REAL,2901455490,544,2901456034,2925952756
2025-06-19 09:14:14,FAKE,2901456034,243,2901456277,2925953243
2025-06-19 09:14:16,REAL,2901456277,480,2901456757,2925953723
2025-06-19 09:14:18,REAL,2901456757,484,2901457241,2925954207
2025-06-19 09:14:20,REAL,2901457241,536,2901457777,2925954743
2025-06-19 09:14:22,REAL,2901457777,480,2901458257,2925955223
2025-06-19 09:14:24,REAL,2901458257,480,2901458737,2925955703
2025-06-19 09:14:26,REAL,2901458737,482,2901459219,2925956185
2025-06-19 09:14:28,FAKE,2901459219,241,2901459460,2925956677
2025-06-19 09:14:30,REAL,2901459460,486,2901459946,2925957163
2025-06-19 09:14:32,REAL,2901459946,492,2901460438,2925957655
2025-06-19 09:14:34,FAKE,2901460438,243,2901460681,2925958141
2025-06-19 09:14:36,REAL,2901460681,490,2901461171,2925958631
2025-06-19 09:14:38,REAL,2901461171,482,2901461653,2925959113
2025-06-19 09:14:40,REAL,2901461653,480,2901462133,2925959593
2025-06-19 09:14:42,REAL,2901462133,482,2901462615,2925960075
2025-06-19 09:14:44,FAKE,2901462615,243,2901462858,2925960617
2025-06-19 09:14:46,FAKE,2901462858,241,2901463099,2925961100
2025-06-19 09:14:48,FAKE,2901463099,244,2901463343,2925961587
2025-06-19 09:14:50,REAL,2901463343,486,2901463829,2925962073
2025-06-19 09:14:52,FAKE,2901463829,244,2901464073,2925963285
2025-06-19 09:14:54,REAL,2901464073,12429,2901476502,2925975714
2025-06-19 09:14:56,REAL,2901476502,10318,2901486820,2925986032
2025-06-19 09:14:58,REAL,2901486820,10249,2901497069,2925996281
2025-06-19 09:15:00,REAL,2901497069,10320,2901507389,2926006601
2025-06-19 09:15:02,REAL,2901507389,10256,2901517645,2926016857
2025-06-19 09:15:04,REAL,2901517645,10253,2901527898,2926027110
2025-06-19 09:15:06,REAL,2901527898,10373,2901538271,2926037483
2025-06-19 09:15:08,REAL,2901538271,4516,2901542787,2926041999
2025-06-19 09:15:10,REAL,2901542787,482,2901543269,2926042481
2025-06-19 09:15:12,FAKE,2901543269,243,2901543512,2926042967
2025-06-19 09:15:14,REAL,2901543512,492,2901544004,2926043459
2025-06-19 09:15:16,FAKE,2901544004,241,2901544245,2926043935
2025-06-19 09:15:18,REAL,2901544245,484,2901544729,2926044419
2025-06-19 09:15:20,FAKE,2901544729,241,2901544970,2926044898
2025-06-19 09:15:22,FAKE,2901544970,238,2901545208,2926045390
2025-06-19 09:15:24,REAL,2901545208,486,2901545694,2926045876
2025-06-19 09:15:26,REAL,2901545694,481,2901546175,2926046357
2025-06-19 09:15:28,FAKE,2901546175,243,2901546418,2926046835
2025-06-19 09:15:30,REAL,2901546418,544,2901546962,2926047379
2025-06-19 09:15:32,REAL,2901546962,483,2901547445,2926047862
2025-06-19 09:15:34,REAL,2901547445,485,2901547930,2926048347
2025-06-19 09:15:36,REAL,2901547930,481,2901548411,2926048828
2025-06-19 09:15:38,FAKE,2901548411,241,2901548652,2926049308
2025-06-19 09:15:40,REAL,2901548652,541,2901549193,2926049849
2025-06-19 09:15:42,REAL,2901549193,482,2901549675,2926050331
2025-06-19 09:15:44,REAL,2901549675,488,2901550163,2926050819
2025-06-19 09:15:46,REAL,2901550163,479,2901550642,2926051298
2025-06-19 09:15:48,REAL,2901550642,485,2901551127,2926051783
2025-06-19 09:15:50,REAL,2901551127,486,2901551613,2926052269
2025-06-19 09:15:52,FAKE,2901551613,244,2901551857,2926052754
2025-06-19 09:15:54,REAL,2901551857,538,2901552395,2926053292
2025-06-19 09:15:56,REAL,2901552395,482,2901552877,2926053774
2025-06-19 09:15:58,REAL,2901552877,492,2901553369,2926054266
2025-06-19 09:16:00,REAL,2901553369,489,2901553858,2926054755
2025-06-19 09:16:02,REAL,2901553858,481,2901554339,2926055236
2025-06-19 09:16:04,REAL,2901554339,483,2901554822,2926055719
2025-06-19 09:16:06,FAKE,2901554822,241,2901555063,2926058453
2025-06-19 09:16:08,REAL,2901555063,14803,2901569866,2926073256
2025-06-19 09:16:10,REAL,2901569866,10255,2901580121,2926083511
2025-06-19 09:16:12,REAL,2901580121,10314,2901590435,2926093825
2025-06-19 09:16:14,REAL,2901590435,10252,2901600687,2926104077
2025-06-19 09:16:16,REAL,2901600687,10311,2901610998,2926114388
2025-06-19 09:16:18,FAKE,2901610998,241,2901611239,2926124698
2025-06-19 09:16:20,REAL,2901611239,10323,2901621562,2926135021
2025-06-19 09:16:22,REAL,2901621562,3326,2901624888,2926138347
2025-06-19 09:16:24,REAL,2901624888,483,2901625371,2926138830
2025-06-19 09:16:26,REAL,2901625371,479,2901625850,2926139309
2025-06-19 09:16:28,REAL,2901625850,10653,2901636503,2926149962
2025-06-19 09:16:30,FAKE,2901636503,238,2901636741,2926161338
2025-06-19 09:16:32,FAKE,2901636741,243,2901636984,2926171647
2025-06-19 09:16:34,REAL,2901636984,10253,2901647237,2926181900
2025-06-19 09:16:36,REAL,2901647237,10318,2901657555,2926192218
2025-06-19 09:16:38,FAKE,2901657555,244,2901657799,2926202463
2025-06-19 09:16:40,REAL,2901657799,10184,2901667983,2926212647
2025-06-19 09:16:42,FAKE,2901667983,244,2901668227,2926220647
2025-06-19 09:16:44,FAKE,2901668227,244,2901668471,2926221128
2025-06-19 09:16:46,FAKE,2901668471,243,2901668714,2926221603
2025-06-19 09:16:48,FAKE,2901668714,241,2901668955,2926225004
2025-06-19 09:16:50,REAL,2901668955,11639,2901680594,2926236643
2025-06-19 09:16:52,REAL,2901680594,10308,2901690902,2926246951
2025-06-19 09:16:54,REAL,2901690902,10256,2901701158,2926257207
2025-06-19 09:16:56,FAKE,2901701158,243,2901701401,2926267452
2025-06-19 09:16:58,REAL,2901701401,10324,2901711725,2926277776
2025-06-19 09:17:00,FAKE,2901711725,243,2901711968,2926288027
2025-06-19 09:17:02,FAKE,2901711968,243,2901712211,2926298271
2025-06-19 09:17:04,REAL,2901712211,2661,2901714872,2926300932
2025-06-19 09:17:06,REAL,2901714872,482,2901715354,2926301414
2025-06-19 09:17:08,REAL,2901715354,547,2901715901,2926301961
2025-06-19 09:17:10,FAKE,2901715901,244,2901716145,2926302443
2025-06-19 09:17:12,REAL,2901716145,489,2901716634,2926302932
2025-06-19 09:17:14,REAL,2901716634,486,2901717120,2926303418
2025-06-19 09:17:16,REAL,2901717120,488,2901717608,2926303906
2025-06-19 09:17:18,REAL,2901717608,483,2901718091,2926304389
2025-06-19 09:17:20,FAKE,2901718091,243,2901718334,2926304874
2025-06-19 09:17:22,FAKE,2901718334,243,2901718577,2926305357
2025-06-19 09:17:24,REAL,2901718577,547,2901719124,2926305904
2025-06-19 09:17:26,REAL,2901719124,484,2901719608,2926306388
2025-06-19 09:17:28,REAL,2901719608,488,2901720096,2926306876
2025-06-19 09:17:30,REAL,2901720096,485,2901720581,2926307361
2025-06-19 09:17:32,REAL,2901720581,541,2901721122,2926307902
2025-06-19 09:17:34,FAKE,2901721122,243,2901721365,2926308382
2025-06-19 09:17:36,REAL,2901721365,487,2901721852,2926308869
2025-06-19 09:17:38,FAKE,2901721852,238,2901722090,2926309351
2025-06-19 09:17:40,REAL,2901722090,484,2901722574,2926309835
2025-06-19 09:17:42,FAKE,2901722574,241,2901722815,2926310323
2025-06-19 09:17:44,REAL,2901722815,487,2901723302,2926310810
2025-06-19 09:17:46,REAL,2901723302,483,2901723785,2926311293
2025-06-19 09:17:48,REAL,2901723785,490,2901724275,2926311783
2025-06-19 09:17:50,FAKE,2901724275,243,2901724518,2926312267
2025-06-19 09:17:52,REAL,2901724518,477,2901724995,2926312744
2025-06-19 09:17:54,REAL,2901724995,536,2901725531,2926313280
2025-06-19 09:17:56,FAKE,2901725531,244,2901725775,2926313765
2025-06-19 09:17:58,FAKE,2901725775,244,2901726019,2926314255
2025-06-19 09:18:00,FAKE,2901726019,241,2901726260,2926314740
2025-06-19 09:18:02,REAL,2901726260,533,2901726793,2926315273
2025-06-19 09:18:04,REAL,2901726793,492,2901727285,2926315765
2025-06-19 09:18:06,REAL,2901727285,487,2901727772,2926316252
2025-06-19 09:18:08,REAL,2901727772,491,2901728263,2926316743
2025-06-19 09:18:10,FAKE,2901728263,241,2901728504,2926317226
2025-06-19 09:18:12,REAL,2901728504,484,2901728988,2926317710
2025-06-19 09:18:14,REAL,2901728988,483,2901729471,2926318193
2025-06-19 09:18:16,REAL,2901729471,480,2901729951,2926318673
2025-06-19 09:18:18,REAL,2901729951,537,2901730488,2926319210
2025-06-19 09:18:20,REAL,2901730488,481,2901730969,2926319691
2025-06-19 09:18:22,REAL,2901730969,486,2901731455,2926320177
2025-06-19 09:18:24,FAKE,2901731455,243,2901731698,2926320657
2025-06-19 09:18:26,REAL,2901731698,479,2901732177,2926321136
2025-06-19 09:18:28,REAL,2901732177,487,2901732664,2926321623
2025-06-19 09:18:30,FAKE,2901732664,244,2901732908,2926322105
2025-06-19 09:18:32,REAL,2901732908,484,2901733392,2926322589
2025-06-19 09:18:34,REAL,2901733392,5828,2901739220,2926328417
2025-06-19 09:18:36,REAL,2901739220,10977,2901750197,2926339394
2025-06-19 09:18:38,FAKE,2901750197,243,2901750440,2926349712
2025-06-19 09:18:40,FAKE,2901750440,238,2901750678,2926359967
2025-06-19 09:18:42,REAL,2901750678,10307,2901760985,2926370274
2025-06-19 09:18:44,FAKE,2901760985,241,2901761226,2926380598
2025-06-19 09:18:46,FAKE,2901761226,243,2901761469,2926390847
2025-06-19 09:18:48,REAL,2901761469,10250,2901771719,2926401097
2025-06-19 09:18:50,FAKE,2901771719,243,2901771962,2926401975
2025-06-19 09:18:52,REAL,2901771962,479,2901772441,2926402454
2025-06-19 09:18:54,REAL,2901772441,487,2901772928,2926402941
2025-06-19 09:18:56,REAL,2901772928,491,2901773419,2926403432
2025-06-19 09:18:58,REAL,2901773419,493,2901773912,2926403925
2025-06-19 09:19:00,FAKE,2901773912,244,2901774156,2926404412
2025-06-19 09:19:02,FAKE,2901774156,241,2901774397,2926404899
2025-06-19 09:19:04,REAL,2901774397,485,2901774882,2926405384
2025-06-19 09:19:06,FAKE,2901774882,244,2901775126,2926412135
2025-06-19 09:19:08,REAL,2901775126,11300,2901786426,2926423435
2025-06-19 09:19:10,FAKE,2901786426,243,2901786669,2926433745
2025-06-19 09:19:12,FAKE,2901786669,243,2901786912,2926444003
2025-06-19 09:19:14,REAL,2901786912,10256,2901797168,2926454259
2025-06-19 09:19:16,REAL,2901797168,10246,2901807414,2926464505
2025-06-19 09:19:18,REAL,2901807414,10250,2901817664,2926474755
2025-06-19 09:19:20,REAL,2901817664,10049,2901827713,2926484804
2025-06-19 09:19:22,FAKE,2901827713,244,2901827957,2926485295
2025-06-19 09:19:24,FAKE,2901827957,243,2901828200,2926485776
2025-06-19 09:19:26,FAKE,2901828200,243,2901828443,2926486597
2025-06-19 09:19:28,REAL,2901828443,13173,2901841616,2926499770
2025-06-19 09:19:30,FAKE,2901841616,238,2901841854,2926510078
2025-06-19 09:19:32,REAL,2901841854,10255,2901852109,2926520333
2025-06-19 09:19:34,REAL,2901852109,10250,2901862359,2926530583
2025-06-19 09:19:36,REAL,2901862359,10321,2901872680,2926540904
2025-06-19 09:19:38,REAL,2901872680,10257,2901882937,2926551161
2025-06-19 09:19:40,REAL,2901882937,10260,2901893197,2926561421
2025-06-19 09:19:42,REAL,2901893197,4777,2901897974,2926566198
2025-06-19 09:19:44,REAL,2901897974,481,2901898455,2926566679
2025-06-19 09:19:46,FAKE,2901898455,244,2901898699,2926567171
2025-06-19 09:19:48,FAKE,2901898699,241,2901898940,2926567650
2025-06-19 09:19:50,REAL,2901898940,482,2901899422,2926568132
2025-06-19 09:19:52,REAL,2901899422,482,2901899904,2926568614
2025-06-19 09:19:54,REAL,2901899904,535,2901900439,2926569149
2025-06-19 09:19:56,REAL,2901900439,485,2901900924,2926569634
2025-06-19 09:19:58,FAKE,2901900924,241,2901901165,2926570116
2025-06-19 09:20:00,REAL,2901901165,486,2901901651,2926570602
2025-06-19 09:20:02,REAL,2901901651,484,2901902135,2926571086
2025-06-19 09:20:04,REAL,2901902135,475,2901902610,2926571561
2025-06-19 09:20:06,FAKE,2901902610,241,2901902851,2926572098
2025-06-19 09:20:08,REAL,2901902851,481,2901903332,2926572579
2025-06-19 09:20:10,REAL,2901903332,484,2901903816,2926573063
2025-06-19 09:20:12,REAL,2901903816,487,2901904303,2926573550
2025-06-19 09:20:14,REAL,2901904303,488,2901904791,2926574038
2025-06-19 09:20:16,FAKE,2901904791,241,2901905032,2926574527
2025-06-19 09:20:18,REAL,2901905032,493,2901905525,2926575020
2025-06-19 09:20:20,FAKE,2901905525,238,2901905763,2926575509
2025-06-19 09:20:22,REAL,2901905763,534,2901906297,2926576043
2025-06-19 09:20:24,REAL,2901906297,485,2901906782,2926576528
2025-06-19 09:20:26,REAL,2901906782,488,2901907270,2926577016
2025-06-19 09:20:28,REAL,2901907270,488,2901907758,2926577504
2025-06-19 09:20:30,REAL,2901907758,483,2901908241,2926577987
2025-06-19 09:20:32,FAKE,2901908241,243,2901908484,2926578465
2025-06-19 09:20:34,FAKE,2901908484,238,2901908722,2926578954
2025-06-19 09:20:36,REAL,2901908722,492,2901909214,2926579446
2025-06-19 09:20:38,FAKE,2901909214,241,2901909455,2926579929
2025-06-19 09:20:40,REAL,2901909455,479,2901909934,2926580408
2025-06-19 09:20:42,FAKE,2901909934,244,2901910178,2926580956
2025-06-19 09:20:44,REAL,2901910178,478,2901910656,2926581434
2025-06-19 09:20:46,REAL,2901910656,481,2901911137,2926581915
2025-06-19 09:20:48,REAL,2901911137,484,2901911621,2926582399
2025-06-19 09:20:50,REAL,2901911621,540,2901912161,2926582939
2025-06-19 09:20:52,REAL,2901912161,475,2901912636,2926583414
2025-06-19 09:20:54,REAL,2901912636,491,2901913127,2926583905
2025-06-19 09:20:56,REAL,2901913127,487,2901913614,2926584392
2025-06-19 09:20:58,REAL,2901913614,488,2901914102,2926584880
2025-06-19 09:21:00,REAL,2901914102,493,2901914595,2926585373
2025-06-19 09:21:02,REAL,2901914595,485,2901915080,2926585858
2025-06-19 09:21:04,REAL,2901915080,483,2901915563,2926586341
2025-06-19 09:21:06,REAL,2901915563,478,2901916041,2926586819
2025-06-19 09:21:08,REAL,2901916041,480,2901916521,2926587299
2025-06-19 09:21:10,FAKE,2901916521,241,2901916762,2926587786
2025-06-19 09:21:12,REAL,2901916762,484,2901917246,2926588270
2025-06-19 09:21:14,REAL,2901917246,486,2901917732,2926588756
2025-06-19 09:21:16,REAL,2901917732,538,2901918270,2926589294
2025-06-19 09:21:18,REAL,2901918270,482,2901918752,2926589776
2025-06-19 09:21:20,REAL,2901918752,550,2901919302,2926590326
2025-06-19 09:21:22,REAL,2901919302,237,2901919539,2926590563
2025-06-19 09:21:24,REAL,2901919539,479,2901920018,2926591042
2025-06-19 09:21:26,REAL,2901920018,478,2901920496,2926591520
2025-06-19 09:21:28,REAL,2901920496,477,2901920973,2926591997
2025-06-19 09:21:30,REAL,2901920973,485,2901921458,2926592482
2025-06-19 09:21:32,REAL,2901921458,479,2901921937,2926592961
2025-06-19 09:21:34,REAL,2901921937,481,2901922418,2926593442
2025-06-19 09:21:36,REAL,2901922418,481,2901922899,2926593923
2025-06-19 09:21:38,REAL,2901922899,489,2901923388,2926594412
2025-06-19 09:21:40,FAKE,2901923388,244,2901923632,2926594886
2025-06-19 09:21:42,REAL,2901923632,593,2901924225,2926595479
2025-06-19 09:21:44,REAL,2901924225,483,2901924708,2926595962
2025-06-19 09:21:46,FAKE,2901924708,238,2901924946,2926596449
2025-06-19 09:21:48,REAL,2901924946,476,2901925422,2926596925
2025-06-19 09:21:50,REAL,2901925422,12369,2901937791,2926609294
2025-06-19 09:21:52,FAKE,2901937791,243,2901938034,2926620674
2025-06-19 09:21:54,REAL,2901938034,10326,2901948360,2926631000
2025-06-19 09:21:56,REAL,2901948360,10245,2901958605,2926641245
2025-06-19 09:21:58,REAL,2901958605,10310,2901968915,2926651555
2025-06-19 09:22:00,FAKE,2901968915,241,2901969156,2926661806
2025-06-19 09:22:02,REAL,2901969156,10318,2901979474,2926672124
2025-06-19 09:22:04,FAKE,2901979474,244,2901979718,2926679337
2025-06-19 09:22:06,REAL,2901979718,481,2901980199,2926679818
2025-06-19 09:22:08,REAL,2901980199,539,2901980738,2926680357
2025-06-19 09:22:10,REAL,2901980738,480,2901981218,2926680837
2025-06-19 09:22:12,REAL,2901981218,543,2901981761,2926681380
2025-06-19 09:22:14,FAKE,2901981761,244,2901982005,2926681868
2025-06-19 09:22:16,REAL,2901982005,486,2901982491,2926682354
2025-06-19 09:22:18,REAL,2901982491,491,2901982982,2926682845
2025-06-19 09:22:20,REAL,2901982982,487,2901983469,2926683332
2025-06-19 09:22:22,REAL,2901983469,491,2901983960,2926683823
2025-06-19 09:22:24,REAL,2901983960,479,2901984439,2926684302
2025-06-19 09:22:26,REAL,2901984439,486,2901984925,2926684788
2025-06-19 09:22:28,REAL,2901984925,492,2901985417,2926685280
2025-06-19 09:22:30,REAL,2901985417,720,2901986137,2926686000
2025-06-19 09:22:32,FAKE,2901986137,244,2901986381,2926686246
2025-06-19 09:22:34,REAL,2901986381,542,2901986923,2926686788
2025-06-19 09:22:36,REAL,2901986923,540,2901987463,2926687328
2025-06-19 09:22:38,FAKE,2901987463,238,2901987701,2926687806
2025-06-19 09:22:40,REAL,2901987701,483,2901988184,2926688289
2025-06-19 09:22:42,REAL,2901988184,480,2901988664,2926688769
2025-06-19 09:22:44,FAKE,2901988664,244,2901988908,2926689259
2025-06-19 09:22:46,REAL,2901988908,476,2901989384,2926689735
2025-06-19 09:22:48,REAL,2901989384,488,2901989872,2926690223
2025-06-19 09:22:50,REAL,2901989872,483,2901990355,2926690706
2025-06-19 09:22:52,FAKE,2901990355,244,2901990599,2926691187
2025-06-19 09:22:54,REAL,2901990599,492,2901991091,2926691679
2025-06-19 09:22:56,FAKE,2901991091,243,2901991334,2926692156
2025-06-19 09:22:58,REAL,2901991334,541,2901991875,2926692697
2025-06-19 09:23:00,REAL,2901991875,483,2901992358,2926693180
2025-06-19 09:23:02,REAL,2901992358,532,2901992890,2926693712
2025-06-19 09:23:04,REAL,2901992890,487,2901993377,2926694199
2025-06-19 09:23:06,REAL,2901993377,477,2901993854,2926694676
2025-06-19 09:23:08,REAL,2901993854,489,2901994343,2926695165
2025-06-19 09:23:10,FAKE,2901994343,244,2901994587,2926695646
2025-06-19 09:23:12,REAL,2901994587,484,2901995071,2926696130
2025-06-19 09:23:14,REAL,2901995071,484,2901995555,2926696614
2025-06-19 09:23:16,REAL,2901995555,481,2901996036,2926697095
2025-06-19 09:23:18,REAL,2901996036,488,2901996524,2926697583
2025-06-19 09:23:20,REAL,2901996524,548,2901997072,2926698131
2025-06-19 09:23:22,FAKE,2901997072,243,2901997315,2926698612
2025-06-19 09:23:24,FAKE,2901997315,244,2901997559,2926699098
2025-06-19 09:23:26,REAL,2901997559,483,2901998042,2926699581
2025-06-19 09:23:28,REAL,2901998042,541,2901998583,2926700122
2025-06-19 09:23:30,FAKE,2901998583,244,2901998827,2926700603
2025-06-19 09:23:32,REAL,2901998827,484,2901999311,2926701087
2025-06-19 09:23:34,REAL,2901999311,6570,2902005881,2926707657
2025-06-19 09:23:36,FAKE,2902005881,243,2902006124,2926721355
2025-06-19 09:23:38,FAKE,2902006124,241,2902006365,2926731614
2025-06-19 09:23:40,REAL,2902006365,10259,2902016624,2926741873
2025-06-19 09:23:42,REAL,2902016624,10316,2902026940,2926752189
2025-06-19 09:23:44,REAL,2902026940,10258,2902037198,2926762447
2025-06-19 09:23:46,REAL,2902037198,10248,2902047446,2926772695
2025-06-19 09:23:48,REAL,2902047446,10257,2902057703,2926782952
2025-06-19 09:23:50,REAL,2902057703,878,2902058581,2926783830
2025-06-19 09:23:52,REAL,2902058581,478,2902059059,2926784308
2025-06-19 09:23:54,FAKE,2902059059,244,2902059303,2926784792
2025-06-19 09:23:56,REAL,2902059303,596,2902059899,2926785388
2025-06-19 09:23:58,REAL,2902059899,478,2902060377,2926785866
2025-06-19 09:24:00,REAL,2902060377,492,2902060869,2926786358
2025-06-19 09:24:02,REAL,2902060869,492,2902061361,2926786850
2025-06-19 09:24:04,REAL,2902061361,494,2902061855,2926787344
2025-06-19 09:24:06,REAL,2902061855,475,2902062330,2926787819
2025-06-19 09:24:08,FAKE,2902062330,243,2902062573,2926788297
2025-06-19 09:24:10,REAL,2902062573,484,2902063057,2926788781
2025-06-19 09:24:12,FAKE,2902063057,244,2902063301,2926789265
2025-06-19 09:24:14,FAKE,2902063301,238,2902063539,2926789741
2025-06-19 09:24:16,REAL,2902063539,482,2902064021,2926790223
2025-06-19 09:24:18,FAKE,2902064021,243,2902064264,2926790709
2025-06-19 09:24:20,REAL,2902064264,542,2902064806,2926791251
2025-06-19 09:24:22,FAKE,2902064806,243,2902065049,2926791789
2025-06-19 09:24:24,FAKE,2902065049,238,2902065287,2926792281
2025-06-19 09:24:26,REAL,2902065287,491,2902065778,2926792772
2025-06-19 09:24:28,FAKE,2902065778,238,2902066016,2926793251
2025-06-19 09:24:30,REAL,2902066016,485,2902066501,2926793736
2025-06-19 09:24:32,REAL,2902066501,486,2902066987,2926794222
2025-06-19 09:24:34,REAL,2902066987,487,2902067474,2926794709
2025-06-19 09:24:36,REAL,2902067474,484,2902067958,2926795193
2025-06-19 09:24:38,REAL,2902067958,484,2902068442,2926795677
2025-06-19 09:24:40,FAKE,2902068442,238,2902068680,2926796163
2025-06-19 09:24:42,REAL,2902068680,538,2902069218,2926796701
2025-06-19 09:24:44,FAKE,2902069218,241,2902069459,2926797186
2025-06-19 09:24:46,REAL,2902069459,484,2902069943,2926797670
2025-06-19 09:24:48,FAKE,2902069943,243,2902070186,2926798201
2025-06-19 09:24:50,REAL,2902070186,481,2902070667,2926798682
2025-06-19 09:24:52,REAL,2902070667,488,2902071155,2926799170
2025-06-19 09:24:54,FAKE,2902071155,243,2902071398,2926799652
2025-06-19 09:24:56,FAKE,2902071398,241,2902071639,2926800130
2025-06-19 09:24:58,FAKE,2902071639,244,2902071883,2926801944
2025-06-19 09:25:00,REAL,2902071883,15201,2902087084,2926817145
2025-06-19 09:25:02,REAL,2902087084,10254,2902097338,2926827399
2025-06-19 09:25:04,FAKE,2902097338,241,2902097579,2926837776
2025-06-19 09:25:06,FAKE,2902097579,243,2902097822,2926848025
2025-06-19 09:25:08,REAL,2902097822,10317,2902108139,2926858342
2025-06-19 09:25:10,REAL,2902108139,10249,2902118388,2926868591
2025-06-19 09:25:12,REAL,2902118388,10320,2902128708,2926878911
2025-06-19 09:25:14,REAL,2902128708,4110,2902132818,2926883021
2025-06-19 09:25:16,FAKE,2902132818,241,2902133059,2926883569
2025-06-19 09:25:18,REAL,2902133059,481,2902133540,2926884050
2025-06-19 09:25:20,REAL,2902133540,479,2902134019,2926884529
2025-06-19 09:25:22,REAL,2902134019,485,2902134504,2926885014
2025-06-19 09:25:24,REAL,2902134504,489,2902134993,2926885503
2025-06-19 09:25:26,FAKE,2902134993,238,2902135231,2926886045
2025-06-19 09:25:28,REAL,2902135231,484,2902135715,2926886529
2025-06-19 09:25:30,REAL,2902135715,2415,2902138130,2926888944
2025-06-19 09:25:32,FAKE,2902138130,238,2902138368,2926904212
2025-06-19 09:25:34,REAL,2902138368,10317,2902148685,2926914529
2025-06-19 09:25:36,FAKE,2902148685,238,2902148923,2926924775
2025-06-19 09:25:38,FAKE,2902148923,244,2902149167,2926935089
2025-06-19 09:25:40,REAL,2902149167,10257,2902159424,2926945346
2025-06-19 09:25:42,FAKE,2902159424,243,2902159667,2926955603
2025-06-19 09:25:44,REAL,2902159667,10313,2902169980,2926965916
2025-06-19 09:25:46,REAL,2902169980,3591,2902173571,2926969507
2025-06-19 09:25:48,REAL,2902173571,481,2902174052,2926969988
2025-06-19 09:25:50,REAL,2902174052,487,2902174539,2926970475
2025-06-19 09:25:52,REAL,2902174539,540,2902175079,2926971015
2025-06-19 09:25:54,REAL,2902175079,486,2902175565,2926971501
2025-06-19 09:25:56,FAKE,2902175565,244,2902175809,2926971985
2025-06-19 09:25:58,REAL,2902175809,485,2902176294,2926972470
2025-06-19 09:26:00,REAL,2902176294,489,2902176783,2926972959
2025-06-19 09:26:02,FAKE,2902176783,238,2902177021,2926973438
2025-06-19 09:26:04,REAL,2902177021,480,2902177501,2926973918
2025-06-19 09:26:06,REAL,2902177501,483,2902177984,2926974401
2025-06-19 09:26:08,FAKE,2902177984,244,2902178228,2926974880
2025-06-19 09:26:10,REAL,2902178228,548,2902178776,2926975428
2025-06-19 09:26:12,REAL,2902178776,3123,2902181899,2926978551
2025-06-19 09:26:14,REAL,2902181899,11453,2902193352,2926990004
2025-06-19 09:26:16,FAKE,2902193352,241,2902193593,2927000324
2025-06-19 09:26:18,REAL,2902193593,10252,2902203845,2927010576
2025-06-19 09:26:20,REAL,2902203845,10312,2902214157,2927020888
2025-06-19 09:26:22,REAL,2902214157,10251,2902224408,2927031139
2025-06-19 09:26:24,REAL,2902224408,10311,2902234719,2927041450
2025-06-19 09:26:26,FAKE,2902234719,238,2902234957,2927051700
2025-06-19 09:26:28,REAL,2902234957,2988,2902237945,2927054688
2025-06-19 09:26:30,REAL,2902237945,479,2902238424,2927055167
2025-06-19 09:26:32,REAL,2902238424,480,2902238904,2927055647
2025-06-19 09:26:34,REAL,2902238904,481,2902239385,2927056128
2025-06-19 09:26:36,FAKE,2902239385,238,2902239623,2927056607
2025-06-19 09:26:38,REAL,2902239623,533,2902240156,2927057140
2025-06-19 09:26:40,REAL,2902240156,486,2902240642,2927057626
2025-06-19 09:26:42,REAL,2902240642,486,2902241128,2927058112
2025-06-19 09:26:44,FAKE,2902241128,243,2902241371,2927058590
2025-06-19 09:26:46,FAKE,2902241371,241,2902241612,2927059084
2025-06-19 09:26:48,REAL,2902241612,488,2902242100,2927059572
2025-06-19 09:26:50,REAL,2902242100,478,2902242578,2927060050
2025-06-19 09:26:52,REAL,2902242578,481,2902243059,2927060531
2025-06-19 09:26:54,FAKE,2902243059,238,2902243297,2927061014
2025-06-19 09:26:56,REAL,2902243297,478,2902243775,2927061492
2025-06-19 09:26:58,REAL,2902243775,544,2902244319,2927062036
2025-06-19 09:27:00,REAL,2902244319,484,2902244803,2927062520
2025-06-19 09:27:02,FAKE,2902244803,241,2902245044,2927063011
2025-06-19 09:27:04,REAL,2902245044,480,2902245524,2927063491
2025-06-19 09:27:06,REAL,2902245524,539,2902246063,2927064030
2025-06-19 09:27:08,REAL,2902246063,483,2902246546,2927064513
2025-06-19 09:27:10,REAL,2902246546,484,2902247030,2927064997
2025-06-19 09:27:12,REAL,2902247030,481,2902247511,2927065478
2025-06-19 09:27:14,REAL,2902247511,491,2902248002,2927065969
2025-06-19 09:27:16,REAL,2902248002,480,2902248482,2927066449
2025-06-19 09:27:18,REAL,2902248482,486,2902248968,2927066935
2025-06-19 09:27:20,REAL,2902248968,489,2902249457,2927067424
2025-06-19 09:27:22,REAL,2902249457,486,2902249943,2927067910
2025-06-19 09:27:24,REAL,2902249943,482,2902250425,2927068392
2025-06-19 09:27:26,REAL,2902250425,4913,2902255338,2927073305
2025-06-19 09:27:28,FAKE,2902255338,243,2902255581,2927084616
2025-06-19 09:27:30,FAKE,2902255581,238,2902255819,2927094938
2025-06-19 09:27:32,FAKE,2902255819,244,2902256063,2927105241
2025-06-19 09:27:34,REAL,2902256063,10321,2902266384,2927115562
2025-06-19 09:27:36,REAL,2902266384,10326,2902276710,2927125888
2025-06-19 09:27:38,FAKE,2902276710,243,2902276953,2927136146
2025-06-19 09:27:40,REAL,2902276953,10313,2902287266,2927146459
2025-06-19 09:27:42,FAKE,2902287266,241,2902287507,2927148265
2025-06-19 09:27:44,REAL,2902287507,483,2902287990,2927148748
2025-06-19 09:27:46,REAL,2902287990,481,2902288471,2927149229
2025-06-19 09:27:48,FAKE,2902288471,244,2902288715,2927149717
2025-06-19 09:27:50,REAL,2902288715,476,2902289191,2927150193
2025-06-19 09:27:52,REAL,2902289191,479,2902289670,2927150672
2025-06-19 09:27:54,FAKE,2902289670,238,2902289908,2927151153
2025-06-19 09:27:56,REAL,2902289908,485,2902290393,2927151638
2025-06-19 09:27:58,FAKE,2902290393,241,2902290634,2927152123
2025-06-19 09:28:00,FAKE,2902290634,238,2902290872,2927152658
2025-06-19 09:28:02,FAKE,2902290872,244,2902291116,2927153144
2025-06-19 09:28:04,REAL,2902291116,482,2902291598,2927153626
2025-06-19 09:28:06,REAL,2902291598,481,2902292079,2927154107
2025-06-19 09:28:08,REAL,2902292079,486,2902292565,2927154593
2025-06-19 09:28:10,REAL,2902292565,488,2902293053,2927155081
2025-06-19 09:28:12,REAL,2902293053,545,2902293598,2927155626
2025-06-19 09:28:14,REAL,2902293598,487,2902294085,2927156113
2025-06-19 09:28:16,REAL,2902294085,485,2902294570,2927156598
2025-06-19 09:28:18,REAL,2902294570,479,2902295049,2927157077
2025-06-19 09:28:20,REAL,2902295049,489,2902295538,2927157566
2025-06-19 09:28:22,REAL,2902295538,484,2902296022,2927158050
2025-06-19 09:28:24,REAL,2902296022,477,2902296499,2927158527
2025-06-19 09:28:26,REAL,2902296499,484,2902296983,2927159011
2025-06-19 09:28:28,REAL,2902296983,540,2902297523,2927159551
2025-06-19 09:28:30,REAL,2902297523,493,2902298016,2927160044
2025-06-19 09:28:32,REAL,2902298016,489,2902298505,2927160533
2025-06-19 09:28:34,REAL,2902298505,488,2902298993,2927161021
2025-06-19 09:28:36,REAL,2902298993,487,2902299480,2927161508
2025-06-19 09:28:38,REAL,2902299480,489,2902299969,2927161997
2025-06-19 09:28:40,REAL,2902299969,474,2902300443,2927162471
2025-06-19 09:28:42,FAKE,2902300443,243,2902300686,2927162961
2025-06-19 09:28:44,REAL,2902300686,484,2902301170,2927163445
2025-06-19 09:28:46,REAL,2902301170,488,2902301658,2927163933
2025-06-19 09:28:48,FAKE,2902301658,243,2902301901,2927164418
2025-06-19 09:28:50,REAL,2902301901,481,2902302382,2927164899
2025-06-19 09:28:52,REAL,2902302382,489,2902302871,2927165388
2025-06-19 09:28:54,FAKE,2902302871,241,2902303112,2927165921
2025-06-19 09:28:56,FAKE,2902303112,244,2902303356,2927166399
2025-06-19 09:28:58,REAL,2902303356,487,2902303843,2927166886
2025-06-19 09:29:00,REAL,2902303843,546,2902304389,2927167432
2025-06-19 09:29:02,REAL,2902304389,491,2902304880,2927167923
2025-06-19 09:29:04,FAKE,2902304880,238,2902305118,2927168405
2025-06-19 09:29:06,FAKE,2902305118,238,2902305356,2927168883
2025-06-19 09:29:08,REAL,2902305356,492,2902305848,2927169375
2025-06-19 09:29:10,FAKE,2902305848,241,2902306089,2927169862
2025-06-19 09:29:12,REAL,2902306089,483,2902306572,2927170345
2025-06-19 09:29:14,REAL,2902306572,478,2902307050,2927170823
2025-06-19 09:29:16,REAL,2902307050,477,2902307527,2927171300
2025-06-19 09:29:18,REAL,2902307527,487,2902308014,2927171787
2025-06-19 09:29:20,FAKE,2902308014,238,2902308252,2927172328
2025-06-19 09:29:22,REAL,2902308252,487,2902308739,2927172815
2025-06-19 09:29:24,REAL,2902308739,484,2902309223,2927173299
2025-06-19 09:29:26,REAL,2902309223,487,2902309710,2927173786
2025-06-19 09:29:28,REAL,2902309710,479,2902310189,2927174265
2025-06-19 09:29:30,FAKE,2902310189,243,2902310432,2927174751
2025-06-19 09:29:32,REAL,2902310432,480,2902310912,2927175231
2025-06-19 09:29:34,REAL,2902310912,478,2902311390,2927175709
2025-06-19 09:29:36,FAKE,2902311390,238,2902311628,2927176192
2025-06-19 09:29:38,REAL,2902311628,8608,2902320236,2927184800
2025-06-19 09:29:40,FAKE,2902320236,241,2902320477,2927197298
2025-06-19 09:29:42,REAL,2902320477,10253,2902330730,2927207551
2025-06-19 09:29:44,REAL,2902330730,10248,2902340978,2927217799
2025-06-19 09:29:46,REAL,2902340978,10314,2902351292,2927228113
2025-06-19 09:29:48,REAL,2902351292,10306,2902361598,2927238419
2025-06-19 09:29:50,REAL,2902361598,10246,2902371844,2927248665
2025-06-19 09:29:52,REAL,2902371844,9530,2902381374,2927258195
2025-06-19 09:29:54,FAKE,2902381374,238,2902381612,2927258678
2025-06-19 09:29:56,REAL,2902381612,484,2902382096,2927259162
2025-06-19 09:29:58,FAKE,2902382096,241,2902382337,2927259645
2025-06-19 09:30:00,REAL,2902382337,487,2902382824,2927260132
2025-06-19 09:30:02,REAL,2902382824,486,2902383310,2927260618
2025-06-19 09:30:04,REAL,2902383310,485,2902383795,2927261103
2025-06-19 09:30:06,REAL,2902383795,488,2902384283,2927261591
2025-06-19 09:30:08,FAKE,2902384283,244,2902384527,2927262074
2025-06-19 09:30:10,FAKE,2902384527,243,2902384770,2927262557
2025-06-19 09:30:12,REAL,2902384770,489,2902385259,2927263046
2025-06-19 09:30:14,REAL,2902385259,487,2902385746,2927263533
2025-06-19 09:30:16,REAL,2902385746,493,2902386239,2927264026
2025-06-19 09:30:18,FAKE,2902386239,241,2902386480,2927264504
2025-06-19 09:30:20,FAKE,2902386480,244,2902386724,2927264989
2025-06-19 09:30:22,FAKE,2902386724,241,2902386965,2927265531
2025-06-19 09:30:24,REAL,2902386965,547,2902387512,2927266078
2025-06-19 09:30:26,REAL,2902387512,482,2902387994,2927266560
2025-06-19 09:30:28,FAKE,2902387994,241,2902388235,2927267046
2025-06-19 09:30:30,REAL,2902388235,486,2902388721,2927267532
2025-06-19 09:30:32,REAL,2902388721,482,2902389203,2927268014
2025-06-19 09:30:34,REAL,2902389203,487,2902389690,2927268501
2025-06-19 09:30:36,REAL,2902389690,477,2902390167,2927268978
2025-06-19 09:30:38,REAL,2902390167,480,2902390647,2927269458
2025-06-19 09:30:40,REAL,2902390647,479,2902391126,2927269937
2025-06-19 09:30:42,FAKE,2902391126,238,2902391364,2927278632
2025-06-19 09:30:44,REAL,2902391364,10773,2902402137,2927289405
2025-06-19 09:30:46,REAL,2902402137,10250,2902412387,2927299655
2025-06-19 09:30:48,FAKE,2902412387,243,2902412630,2927309972
2025-06-19 09:30:50,FAKE,2902412630,241,2902412871,2927320218
2025-06-19 09:30:52,FAKE,2902412871,238,2902413109,2927330465
2025-06-19 09:30:54,REAL,2902413109,10252,2902423361,2927340717
2025-06-19 09:30:56,REAL,2902423361,8265,2902431626,2927348982
2025-06-19 09:30:58,FAKE,2902431626,241,2902431867,2927349520
2025-06-19 09:31:00,REAL,2902431867,481,2902432348,2927350001
2025-06-19 09:31:02,REAL,2902432348,493,2902432841,2927350494
2025-06-19 09:31:04,REAL,2902432841,483,2902433324,2927350977
2025-06-19 09:31:06,REAL,2902433324,487,2902433811,2927351464
2025-06-19 09:31:08,REAL,2902433811,476,2902434287,2927351940
2025-06-19 09:31:10,FAKE,2902434287,241,2902434528,2927352427
2025-06-19 09:31:12,REAL,2902434528,492,2902435020,2927352919
2025-06-19 09:31:14,FAKE,2902435020,243,2902435263,2927362063
2025-06-19 09:31:16,REAL,2902435263,10519,2902445782,2927372582
2025-06-19 09:31:18,REAL,2902445782,10256,2902456038,2927382838
2025-06-19 09:31:20,REAL,2902456038,10320,2902466358,2927393158
2025-06-19 09:31:22,REAL,2902466358,10256,2902476614,2927403414
2025-06-19 09:31:24,FAKE,2902476614,238,2902476852,2927413674
2025-06-19 09:31:26,FAKE,2902476852,244,2902477096,2927423927
2025-06-19 09:31:28,REAL,2902477096,7670,2902484766,2927431597
2025-06-19 09:31:30,REAL,2902484766,479,2902485245,2927432076
2025-06-19 09:31:32,REAL,2902485245,487,2902485732,2927432563
2025-06-19 09:31:34,REAL,2902485732,481,2902486213,2927433044
2025-06-19 09:31:36,REAL,2902486213,537,2902486750,2927433581
2025-06-19 09:31:38,REAL,2902486750,478,2902487228,2927434059
2025-06-19 09:31:40,REAL,2902487228,541,2902487769,2927434600
2025-06-19 09:31:42,FAKE,2902487769,243,2902488012,2927435077
2025-06-19 09:31:44,FAKE,2902488012,241,2902488253,2927435562
2025-06-19 09:31:46,REAL,2902488253,481,2902488734,2927436043
2025-06-19 09:31:48,FAKE,2902488734,244,2902488978,2927436533
2025-06-19 09:31:50,FAKE,2902488978,244,2902489222,2927437016
2025-06-19 09:31:52,REAL,2902489222,484,2902489706,2927437500
2025-06-19 09:31:54,REAL,2902489706,477,2902490183,2927437977
2025-06-19 09:31:56,FAKE,2902490183,241,2902490424,2927438457
2025-06-19 09:31:58,FAKE,2902490424,241,2902490665,2927438949
2025-06-19 09:32:00,REAL,2902490665,484,2902491149,2927439433
2025-06-19 09:32:02,FAKE,2902491149,243,2902491392,2927439919
2025-06-19 09:32:04,REAL,2902491392,477,2902491869,2927440396
2025-06-19 09:32:06,FAKE,2902491869,238,2902492107,2927440938
2025-06-19 09:32:08,FAKE,2902492107,244,2902492351,2927441427
2025-06-19 09:32:10,FAKE,2902492351,243,2902492594,2927441910
2025-06-19 09:32:12,FAKE,2902492594,241,2902492835,2927442446
2025-06-19 09:32:14,FAKE,2902492835,238,2902493073,2927442937
2025-06-19 09:32:16,FAKE,2902493073,243,2902493316,2927447124
2025-06-19 09:32:18,REAL,2902493316,11182,2902504498,2927458306
2025-06-19 09:32:20,REAL,2902504498,10321,2902514819,2927468627
2025-06-19 09:32:22,REAL,2902514819,10256,2902525075,2927478883
2025-06-19 09:32:24,REAL,2902525075,10252,2902535327,2927489135
2025-06-19 09:32:26,FAKE,2902535327,238,2902535565,2927499394
2025-06-19 09:32:28,FAKE,2902535565,244,2902535809,2927509639
2025-06-19 09:32:30,REAL,2902535809,10250,2902546059,2927519889
2025-06-19 09:32:32,REAL,2902546059,2070,2902548129,2927521959
2025-06-19 09:32:34,REAL,2902548129,480,2902548609,2927522439
2025-06-19 09:32:36,REAL,2902548609,480,2902549089,2927522919
2025-06-19 09:32:38,REAL,2902549089,481,2902549570,2927523400
2025-06-19 09:32:40,REAL,2902549570,481,2902550051,2927523881
2025-06-19 09:32:42,REAL,2902550051,534,2902550585,2927524415
2025-06-19 09:32:44,REAL,2902550585,487,2902551072,2927524902
2025-06-19 09:32:46,REAL,2902551072,476,2902551548,2927525378
2025-06-19 09:32:48,REAL,2902551548,490,2902552038,2927525868
2025-06-19 09:32:50,REAL,2902552038,540,2902552578,2927526408
2025-06-19 09:32:52,REAL,2902552578,474,2902553052,2927526882
2025-06-19 09:32:54,REAL,2902553052,485,2902553537,2927527367
2025-06-19 09:32:56,FAKE,2902553537,241,2902553778,2927527852
2025-06-19 09:32:58,REAL,2902553778,487,2902554265,2927528339
2025-06-19 09:33:00,FAKE,2902554265,244,2902554509,2927528817
2025-06-19 09:33:02,REAL,2902554509,484,2902554993,2927529301
2025-06-19 09:33:04,REAL,2902554993,488,2902555481,2927529789
2025-06-19 09:33:06,REAL,2902555481,478,2902555959,2927530267
2025-06-19 09:33:08,FAKE,2902555959,238,2902556197,2927530815
2025-06-19 09:33:10,REAL,2902556197,487,2902556684,2927531302
2025-06-19 09:33:12,REAL,2902556684,487,2902557171,2927531789
2025-06-19 09:33:14,REAL,2902557171,481,2902557652,2927532270
2025-06-19 09:33:16,FAKE,2902557652,244,2902557896,2927532744
2025-06-19 09:33:18,REAL,2902557896,482,2902558378,2927533226
2025-06-19 09:33:20,REAL,2902558378,484,2902558862,2927533710
2025-06-19 09:33:22,REAL,2902558862,482,2902559344,2927534192
2025-06-19 09:33:24,REAL,2902559344,485,2902559829,2927534677
2025-06-19 09:33:26,REAL,2902559829,546,2902560375,2927535223
2025-06-19 09:33:28,REAL,2902560375,484,2902560859,2927535707
2025-06-19 09:33:30,REAL,2902560859,490,2902561349,2927536197
2025-06-19 09:33:32,FAKE,2902561349,238,2902561587,2927536686
2025-06-19 09:33:34,REAL,2902561587,534,2902562121,2927537220
2025-06-19 09:33:36,REAL,2902562121,485,2902562606,2927537705
2025-06-19 09:33:38,REAL,2902562606,481,2902563087,2927538186
2025-06-19 09:33:40,FAKE,2902563087,244,2902563331,2927538668
2025-06-19 09:33:42,REAL,2902563331,489,2902563820,2927539157
2025-06-19 09:33:44,REAL,2902563820,483,2902564303,2927539640
2025-06-19 09:33:46,REAL,2902564303,481,2902564784,2927540121
2025-06-19 09:33:48,REAL,2902564784,484,2902565268,2927540605
2025-06-19 09:33:50,REAL,2902565268,482,2902565750,2927541087
2025-06-19 09:33:52,FAKE,2902565750,238,2902565988,2927541573
2025-06-19 09:33:54,REAL,2902565988,479,2902566467,2927542052
2025-06-19 09:33:56,REAL,2902566467,481,2902566948,2927542533
2025-06-19 09:33:58,REAL,2902566948,491,2902567439,2927543024
2025-06-19 09:34:00,REAL,2902567439,544,2902567983,2927543568
2025-06-19 09:34:02,FAKE,2902567983,244,2902568227,2927544105
2025-06-19 09:34:04,REAL,2902568227,488,2902568715,2927544593
2025-06-19 09:34:06,REAL,2902568715,483,2902569198,2927545076
2025-06-19 09:34:08,REAL,2902569198,479,2902569677,2927545555
2025-06-19 09:34:10,REAL,2902569677,474,2902570151,2927546029
2025-06-19 09:34:12,REAL,2902570151,479,2902570630,2927546508
2025-06-19 09:34:14,REAL,2902570630,481,2902571111,2927546989
2025-06-19 09:34:16,FAKE,2902571111,244,2902571355,2927547474
2025-06-19 09:34:18,REAL,2902571355,484,2902571839,2927547958
2025-06-19 09:34:20,FAKE,2902571839,241,2902572080,2927548437
2025-06-19 09:34:22,REAL,2902572080,474,2902572554,2927548911
2025-06-19 09:34:24,REAL,2902572554,484,2902573038,2927549395
2025-06-19 09:34:26,REAL,2902573038,537,2902573575,2927549932
2025-06-19 09:34:28,FAKE,2902573575,238,2902573813,2927550413
2025-06-19 09:34:30,REAL,2902573813,482,2902574295,2927550895
2025-06-19 09:34:32,REAL,2902574295,487,2902574782,2927551382
2025-06-19 09:34:34,FAKE,2902574782,243,2902575025,2927551865
2025-06-19 09:34:36,FAKE,2902575025,244,2902575269,2927552353
2025-06-19 09:34:38,REAL,2902575269,1412,2902576681,2927553765
2025-06-19 09:34:40,REAL,2902576681,12364,2902589045,2927566129
2025-06-19 09:34:42,REAL,2902589045,10252,2902599297,2927576381
2025-06-19 09:34:44,REAL,2902599297,10315,2902609612,2927586696
2025-06-19 09:34:46,REAL,2902609612,10251,2902619863,2927596947
2025-06-19 09:34:48,REAL,2902619863,10256,2902630119,2927607203
2025-06-19 09:34:50,REAL,2902630119,10243,2902640362,2927617446
2025-06-19 09:34:52,REAL,2902640362,10323,2902650685,2927627769
2025-06-19 09:34:54,FAKE,2902650685,241,2902650926,2927632208
2025-06-19 09:34:56,REAL,2902650926,488,2902651414,2927632696
2025-06-19 09:34:58,REAL,2902651414,482,2902651896,2927633178
2025-06-19 09:35:00,REAL,2902651896,485,2902652381,2927633663
2025-06-19 09:35:02,FAKE,2902652381,241,2902652622,2927634152
2025-06-19 09:35:04,REAL,2902652622,536,2902653158,2927634688
2025-06-19 09:35:06,FAKE,2902653158,241,2902653399,2927635169
2025-06-19 09:35:08,FAKE,2902653399,244,2902653643,2927635653
2025-06-19 09:35:10,REAL,2902653643,2346,2902655989,2927637999
2025-06-19 09:35:12,FAKE,2902655989,244,2902656233,2927649634
2025-06-19 09:35:14,FAKE,2902656233,238,2902656471,2927659952
2025-06-19 09:35:16,FAKE,2902656471,243,2902656714,2927670257
2025-06-19 09:35:18,FAKE,2902656714,243,2902656957,2927680509
2025-06-19 09:35:20,REAL,2902656957,10318,2902667275,2927690827
2025-06-19 09:35:22,FAKE,2902667275,243,2902667518,2927701075
2025-06-19 09:35:24,REAL,2902667518,10250,2902677768,2927711325
2025-06-19 09:35:26,FAKE,2902677768,238,2902678006,2927715176
2025-06-19 09:35:28,REAL,2902678006,483,2902678489,2927715659
2025-06-19 09:35:30,REAL,2902678489,477,2902678966,2927716136
2025-06-19 09:35:32,REAL,2902678966,474,2902679440,2927716610
2025-06-19 09:35:34,FAKE,2902679440,243,2902679683,2927717095
2025-06-19 09:35:36,REAL,2902679683,539,2902680222,2927717634
2025-06-19 09:35:38,REAL,2902680222,484,2902680706,2927718118
2025-06-19 09:35:40,REAL,2902680706,485,2902681191,2927718603
2025-06-19 09:35:42,REAL,2902681191,491,2902681682,2927719094
2025-06-19 09:35:44,FAKE,2902681682,243,2902681925,2927719640
2025-06-19 09:35:46,REAL,2902681925,485,2902682410,2927720125
2025-06-19 09:35:48,REAL,2902682410,474,2902682884,2927720599
2025-06-19 09:35:50,REAL,2902682884,486,2902683370,2927721085
2025-06-19 09:35:52,REAL,2902683370,483,2902683853,2927721568
2025-06-19 09:35:54,FAKE,2902683853,238,2902684091,2927722042
2025-06-19 09:35:56,REAL,2902684091,481,2902684572,2927722523
2025-06-19 09:35:58,FAKE,2902684572,244,2902684816,2927723006
2025-06-19 09:36:00,REAL,2902684816,541,2902685357,2927723547
2025-06-19 09:36:02,FAKE,2902685357,238,2902685595,2927724034
2025-06-19 09:36:04,REAL,2902685595,488,2902686083,2927724522
2025-06-19 09:36:06,FAKE,2902686083,243,2902686326,2927725005
2025-06-19 09:36:08,REAL,2902686326,492,2902686818,2927725497
2025-06-19 09:36:10,FAKE,2902686818,244,2902687062,2927725981
2025-06-19 09:36:12,FAKE,2902687062,238,2902687300,2927726473
2025-06-19 09:36:14,REAL,2902687300,3459,2902690759,2927729932
2025-06-19 09:36:16,REAL,2902690759,11578,2902702337,2927741510
2025-06-19 09:36:18,REAL,2902702337,10253,2902712590,2927751763
2025-06-19 09:36:20,REAL,2902712590,10314,2902722904,2927762077
2025-06-19 09:36:22,FAKE,2902722904,244,2902723148,2927772330
2025-06-19 09:36:24,FAKE,2902723148,243,2902723391,2927782656
2025-06-19 09:36:26,REAL,2902723391,10254,2902733645,2927792910
2025-06-19 09:36:28,REAL,2902733645,10321,2902743966,2927803231
2025-06-19 09:36:30,FAKE,2902743966,238,2902744204,2927805817
2025-06-19 09:36:32,REAL,2902744204,487,2902744691,2927806304
2025-06-19 09:36:34,REAL,2902744691,482,2902745173,2927806786
2025-06-19 09:36:36,REAL,2902745173,484,2902745657,2927807270
2025-06-19 09:36:38,FAKE,2902745657,244,2902745901,2927807762
2025-06-19 09:36:40,REAL,2902745901,487,2902746388,2927808249
2025-06-19 09:36:42,REAL,2902746388,540,2902746928,2927808789
2025-06-19 09:36:44,FAKE,2902746928,243,2902747171,2927809332
2025-06-19 09:36:46,FAKE,2902747171,241,2902747412,2927809811
2025-06-19 09:36:48,REAL,2902747412,481,2902747893,2927810292
2025-06-19 09:36:50,REAL,2902747893,486,2902748379,2927810778
2025-06-19 09:36:52,REAL,2902748379,475,2902748854,2927811253
2025-06-19 09:36:54,REAL,2902748854,487,2902749341,2927811740
2025-06-19 09:36:56,REAL,2902749341,484,2902749825,2927812224
2025-06-19 09:36:58,FAKE,2902749825,243,2902750068,2927812701
2025-06-19 09:37:00,REAL,2902750068,491,2902750559,2927813192
2025-06-19 09:37:02,FAKE,2902750559,243,2902750802,2927813678
2025-06-19 09:37:04,REAL,2902750802,483,2902751285,2927814161
2025-06-19 09:37:06,REAL,2902751285,487,2902751772,2927814648
2025-06-19 09:37:08,FAKE,2902751772,244,2902752016,2927815127
2025-06-19 09:37:10,REAL,2902752016,487,2902752503,2927815614
2025-06-19 09:37:12,FAKE,2902752503,238,2902752741,2927816211
2025-06-19 09:37:14,REAL,2902752741,482,2902753223,2927816693
2025-06-19 09:37:16,FAKE,2902753223,243,2902753466,2927817175
2025-06-19 09:37:18,REAL,2902753466,478,2902753944,2927817653
2025-06-19 09:37:20,FAKE,2902753944,244,2902754188,2927818141
2025-06-19 09:37:22,FAKE,2902754188,238,2902754426,2927818629
2025-06-19 09:37:24,FAKE,2902754426,238,2902754664,2927830009
2025-06-19 09:37:26,FAKE,2902754664,243,2902754907,2927840329
2025-06-19 09:37:28,FAKE,2902754907,241,2902755148,2927850587
2025-06-19 09:37:30,REAL,2902755148,10252,2902765400,2927860839
2025-06-19 09:37:32,REAL,2902765400,10317,2902775717,2927871156
2025-06-19 09:37:34,REAL,2902775717,10251,2902785968,2927881407
2025-06-19 09:37:36,FAKE,2902785968,238,2902786206,2927891656
2025-06-19 09:37:38,FAKE,2902786206,238,2902786444,2927897886
2025-06-19 09:37:40,REAL,2902786444,477,2902786921,2927898363
2025-06-19 09:37:42,REAL,2902786921,541,2902787462,2927898904
2025-06-19 09:37:44,FAKE,2902787462,244,2902787706,2927899385
2025-06-19 09:37:46,REAL,2902787706,477,2902788183,2927899862
2025-06-19 09:37:48,REAL,2902788183,481,2902788664,2927900343
2025-06-19 09:37:50,FAKE,2902788664,241,2902788905,2927900834
2025-06-19 09:37:52,REAL,2902788905,539,2902789444,2927901373
2025-06-19 09:37:54,REAL,2902789444,483,2902789927,2927901856
2025-06-19 09:37:56,REAL,2902789927,489,2902790416,2927902345
2025-06-19 09:37:58,REAL,2902790416,484,2902790900,2927902829
2025-06-19 09:38:00,FAKE,2902790900,244,2902791144,2927903307
2025-06-19 09:38:02,REAL,2902791144,489,2902791633,2927903796
2025-06-19 09:38:04,FAKE,2902791633,241,2902791874,2927904277
2025-06-19 09:38:06,REAL,2902791874,490,2902792364,2927904767
2025-06-19 09:38:08,FAKE,2902792364,238,2902792602,2927905242
2025-06-19 09:38:10,REAL,2902792602,486,2902793088,2927905728
2025-06-19 09:38:12,FAKE,2902793088,244,2902793332,2927906268
2025-06-19 09:38:14,REAL,2902793332,242,2902793574,2927906510
2025-06-19 09:38:16,FAKE,2902793574,238,2902793812,2927906989
2025-06-19 09:38:18,REAL,2902793812,485,2902794297,2927907474
2025-06-19 09:38:20,REAL,2902794297,540,2902794837,2927908014
2025-06-19 09:38:22,REAL,2902794837,489,2902795326,2927908503
2025-06-19 09:38:24,FAKE,2902795326,244,2902795570,2927908986
2025-06-19 09:38:26,FAKE,2902795570,243,2902795813,2927909467
2025-06-19 09:38:28,FAKE,2902795813,241,2902796054,2927909952
2025-06-19 09:38:30,FAKE,2902796054,241,2902796295,2927910434
2025-06-19 09:38:32,REAL,2902796295,485,2902796780,2927910919
2025-06-19 09:38:34,REAL,2902796780,488,2902797268,2927911407
2025-06-19 09:38:36,FAKE,2902797268,244,2902797512,2927911896
2025-06-19 09:38:38,REAL,2902797512,735,2902798247,2927912631
2025-06-19 09:38:40,FAKE,2902798247,241,2902798488,2927912924
2025-06-19 09:38:42,REAL,2902798488,484,2902798972,2927913408
2025-06-19 09:38:44,REAL,2902798972,491,2902799463,2927913899
2025-06-19 09:38:46,REAL,2902799463,485,2902799948,2927914384
2025-06-19 09:38:48,REAL,2902799948,532,2902800480,2927914916
2025-06-19 09:38:50,REAL,2902800480,487,2902800967,2927915403
2025-06-19 09:38:52,FAKE,2902800967,243,2902801210,2927915886
2025-06-19 09:38:54,REAL,2902801210,477,2902801687,2927916363
2025-06-19 09:38:56,REAL,2902801687,478,2902802165,2927916841
2025-06-19 09:38:58,FAKE,2902802165,244,2902802409,2927917321
2025-06-19 09:39:00,FAKE,2902802409,243,2902802652,2927917805
2025-06-19 09:39:02,REAL,2902802652,481,2902803133,2927918286
2025-06-19 09:39:04,FAKE,2902803133,238,2902803371,2927918773
2025-06-19 09:39:06,REAL,2902803371,486,2902803857,2927919259
2025-06-19 09:39:08,REAL,2902803857,479,2902804336,2927919738
2025-06-19 09:39:10,REAL,2902804336,540,2902804876,2927920278
2025-06-19 09:39:12,REAL,2902804876,483,2902805359,2927920761
2025-06-19 09:39:14,REAL,2902805359,484,2902805843,2927921245
2025-06-19 09:39:16,REAL,2902805843,541,2902806384,2927921786
2025-06-19 09:39:18,REAL,2902806384,488,2902806872,2927922274
2025-06-19 09:39:20,FAKE,2902806872,243,2902807115,2927922765
2025-06-19 09:39:22,REAL,2902807115,476,2902807591,2927923241
2025-06-19 09:39:24,REAL,2902807591,2339,2902809930,2927925580
2025-06-19 09:39:26,REAL,2902809930,12163,2902822093,2927937743
2025-06-19 09:39:28,FAKE,2902822093,238,2902822331,2927947992
2025-06-19 09:39:30,FAKE,2902822331,238,2902822569,2927958303
2025-06-19 09:39:32,REAL,2902822569,10243,2902832812,2927968546
2025-06-19 09:39:34,REAL,2902832812,10256,2902843068,2927978802
2025-06-19 09:39:36,REAL,2902843068,10251,2902853319,2927989053
2025-06-19 09:39:38,REAL,2902853319,10252,2902863571,2927999305
2025-06-19 09:39:40,REAL,2902863571,3973,2902867544,2928003278
2025-06-19 09:39:42,FAKE,2902867544,238,2902867782,2928003760
2025-06-19 09:39:44,FAKE,2902867782,243,2902868025,2928004250
2025-06-19 09:39:46,REAL,2902868025,480,2902868505,2928004730
2025-06-19 09:39:48,REAL,2902868505,487,2902868992,2928005217
2025-06-19 09:39:50,REAL,2902868992,485,2902869477,2928005702
2025-06-19 09:39:52,REAL,2902869477,545,2902870022,2928006247
2025-06-19 09:39:54,FAKE,2902870022,241,2902870263,2928006732
2025-06-19 09:39:56,REAL,2902870263,486,2902870749,2928007218
2025-06-19 09:39:58,FAKE,2902870749,243,2902870992,2928007698
2025-06-19 09:40:00,REAL,2902870992,477,2902871469,2928008175
2025-06-19 09:40:02,REAL,2902871469,489,2902871958,2928008664
2025-06-19 09:40:04,REAL,2902871958,491,2902872449,2928009155
2025-06-19 09:40:06,FAKE,2902872449,243,2902872692,2928009634
2025-06-19 09:40:08,REAL,2902872692,479,2902873171,2928010113
2025-06-19 09:40:10,REAL,2902873171,484,2902873655,2928010597
2025-06-19 09:40:12,REAL,2902873655,537,2902874192,2928011134
2025-06-19 09:40:14,REAL,2902874192,486,2902874678,2928011620
2025-06-19 09:40:16,REAL,2902874678,485,2902875163,2928012105
2025-06-19 09:40:18,REAL,2902875163,483,2902875646,2928012588
2025-06-19 09:40:20,REAL,2902875646,487,2902876133,2928013075
2025-06-19 09:40:22,FAKE,2902876133,238,2902876371,2928013614
2025-06-19 09:40:24,REAL,2902876371,481,2902876852,2928014095
2025-06-19 09:40:26,REAL,2902876852,2670,2902879522,2928016765
2025-06-19 09:40:28,REAL,2902879522,11647,2902891169,2928028412
2025-06-19 09:40:30,REAL,2902891169,10312,2902901481,2928038724
2025-06-19 09:40:32,FAKE,2902901481,241,2902901722,2928048975
2025-06-19 09:40:34,REAL,2902901722,10321,2902912043,2928059296
2025-06-19 09:40:36,REAL,2902912043,10249,2902922292,2928069545
2025-06-19 09:40:38,REAL,2902922292,10245,2902932537,2928079790
2025-06-19 09:40:40,REAL,2902932537,10325,2902942862,2928090115
2025-06-19 09:40:42,FAKE,2902942862,244,2902943106,2928093632
2025-06-19 09:40:44,FAKE,2902943106,238,2902943344,2928094115
2025-06-19 09:40:46,FAKE,2902943344,244,2902943588,2928094649
2025-06-19 09:40:48,REAL,2902943588,482,2902944070,2928095131
2025-06-19 09:40:50,FAKE,2902944070,241,2902944311,2928095614
2025-06-19 09:40:52,REAL,2902944311,483,2902944794,2928096097
2025-06-19 09:40:54,FAKE,2902944794,244,2902945038,2928096634
2025-06-19 09:40:56,REAL,2902945038,483,2902945521,2928097117
2025-06-19 09:40:58,FAKE,2902945521,238,2902945759,2928100376
2025-06-19 09:41:00,REAL,2902945759,11709,2902957468,2928112085
2025-06-19 09:41:02,REAL,2902957468,10248,2902967716,2928122333
2025-06-19 09:41:04,REAL,2902967716,10247,2902977963,2928132580
2025-06-19 09:41:06,REAL,2902977963,10320,2902988283,2928142900
2025-06-19 09:41:08,FAKE,2902988283,243,2902988526,2928153152
2025-06-19 09:41:10,FAKE,2902988526,244,2902988770,2928163471
2025-06-19 09:41:12,FAKE,2902988770,244,2902989014,2928173727
2025-06-19 09:41:14,REAL,2902989014,2930,2902991944,2928176657
2025-06-19 09:41:16,REAL,2902991944,485,2902992429,2928177142
2025-06-19 09:41:18,REAL,2902992429,490,2902992919,2928177632
2025-06-19 09:41:20,FAKE,2902992919,244,2902993163,2928178112
2025-06-19 09:41:22,REAL,2902993163,548,2902993711,2928178660
2025-06-19 09:41:24,FAKE,2902993711,243,2902993954,2928179140
2025-06-19 09:41:26,REAL,2902993954,546,2902994500,2928179686
2025-06-19 09:41:28,REAL,2902994500,483,2902994983,2928180169
2025-06-19 09:41:30,REAL,2902994983,487,2902995470,2928180656
2025-06-19 09:41:32,FAKE,2902995470,243,2902995713,2928181139
2025-06-19 09:41:34,REAL,2902995713,483,2902996196,2928181622
2025-06-19 09:41:36,REAL,2902996196,478,2902996674,2928182100
2025-06-19 09:41:38,FAKE,2902996674,241,2902996915,2928182585
2025-06-19 09:41:40,FAKE,2902996915,238,2902997153,2928183072
2025-06-19 09:41:42,REAL,2902997153,491,2902997644,2928183563
2025-06-19 09:41:44,REAL,2902997644,489,2902998133,2928184052
2025-06-19 09:41:46,REAL,2902998133,488,2902998621,2928184540
2025-06-19 09:41:48,FAKE,2902998621,244,2902998865,2928185017
2025-06-19 09:41:50,FAKE,2902998865,244,2902999109,2928185508
2025-06-19 09:41:52,REAL,2902999109,481,2902999590,2928185989
2025-06-19 09:41:54,REAL,2902999590,537,2903000127,2928186526
2025-06-19 09:41:56,REAL,2903000127,537,2903000664,2928187063
2025-06-19 09:41:58,REAL,2903000664,484,2903001148,2928187547
2025-06-19 09:42:00,REAL,2903001148,476,2903001624,2928188023
2025-06-19 09:42:02,REAL,2903001624,489,2903002113,2928188512
2025-06-19 09:42:04,REAL,2903002113,487,2903002600,2928188999
2025-06-19 09:42:06,REAL,2903002600,483,2903003083,2928189482
2025-06-19 09:42:08,REAL,2903003083,486,2903003569,2928189968
2025-06-19 09:42:10,REAL,2903003569,476,2903004045,2928190444
2025-06-19 09:42:12,FAKE,2903004045,241,2903004286,2928190928
2025-06-19 09:42:14,REAL,2903004286,483,2903004769,2928191411
2025-06-19 09:42:16,FAKE,2903004769,238,2903005007,2928191893
2025-06-19 09:42:18,FAKE,2903005007,244,2903005251,2928197001
2025-06-19 09:42:20,REAL,2903005251,11329,2903016580,2928208330
2025-06-19 09:42:22,REAL,2903016580,10318,2903026898,2928218648
2025-06-19 09:42:24,REAL,2903026898,10259,2903037157,2928228907
2025-06-19 09:42:26,FAKE,2903037157,241,2903037398,2928239164
2025-06-19 09:42:28,REAL,2903037398,10256,2903047654,2928249420
2025-06-19 09:42:30,REAL,2903047654,10249,2903057903,2928259669
2025-06-19 09:42:32,REAL,2903057903,10376,2903068279,2928270045
2025-06-19 09:42:34,REAL,2903068279,1277,2903069556,2928271322
2025-06-19 09:42:36,REAL,2903069556,487,2903070043,2928271809
2025-06-19 09:42:38,FAKE,2903070043,243,2903070286,2928272294
2025-06-19 09:42:40,REAL,2903070286,481,2903070767,2928272775
2025-06-19 09:42:42,FAKE,2903070767,238,2903071005,2928273262
2025-06-19 09:42:44,REAL,2903071005,489,2903071494,2928273751
2025-06-19 09:42:46,FAKE,2903071494,244,2903071738,2928274226
2025-06-19 09:42:48,REAL,2903071738,544,2903072282,2928274770
2025-06-19 09:42:50,FAKE,2903072282,238,2903072520,2928280605
2025-06-19 09:42:52,FAKE,2903072520,241,2903072761,2928291918
2025-06-19 09:42:54,REAL,2903072761,10250,2903083011,2928302168
2025-06-19 09:42:56,REAL,2903083011,10253,2903093264,2928312421
2025-06-19 09:42:58,FAKE,2903093264,238,2903093502,2928322737
2025-06-19 09:43:00,FAKE,2903093502,244,2903093746,2928332990
2025-06-19 09:43:02,REAL,2903093746,10249,2903103995,2928343239
2025-06-19 09:43:04,FAKE,2903103995,244,2903104239,2928353495
2025-06-19 09:43:06,REAL,2903104239,812,2903105051,2928354307
2025-06-19 09:43:08,REAL,2903105051,480,2903105531,2928354787
2025-06-19 09:43:10,FAKE,2903105531,241,2903105772,2928355275
2025-06-19 09:43:12,FAKE,2903105772,243,2903106015,2928355763
2025-06-19 09:43:14,REAL,2903106015,486,2903106501,2928356249
2025-06-19 09:43:16,FAKE,2903106501,243,2903106744,2928356733
2025-06-19 09:43:18,FAKE,2903106744,243,2903106987,2928357267
2025-06-19 09:43:20,FAKE,2903106987,241,2903107228,2928357747
2025-06-19 09:43:22,REAL,2903107228,7955,2903115183,2928365702
2025-06-19 09:43:24,REAL,2903115183,11112,2903126295,2928376814
2025-06-19 09:43:26,REAL,2903126295,10317,2903136612,2928387131
2025-06-19 09:43:28,REAL,2903136612,10251,2903146863,2928397382
2025-06-19 09:43:30,REAL,2903146863,10244,2903157107,2928407626
2025-06-19 09:43:32,REAL,2903157107,10318,2903167425,2928417944
2025-06-19 09:43:34,FAKE,2903167425,244,2903167669,2928428193
2025-06-19 09:43:36,REAL,2903167669,9921,2903177590,2928438114
2025-06-19 09:43:38,REAL,2903177590,493,2903178083,2928438607
2025-06-19 09:43:40,FAKE,2903178083,241,2903178324,2928439142
2025-06-19 09:43:42,FAKE,2903178324,243,2903178567,2928439628
2025-06-19 09:43:44,REAL,2903178567,481,2903179048,2928440109
2025-06-19 09:43:46,REAL,2903179048,481,2903179529,2928440590
2025-06-19 09:43:48,FAKE,2903179529,241,2903179770,2928441068
2025-06-19 09:43:50,FAKE,2903179770,243,2903180013,2928441612
2025-06-19 09:43:52,REAL,2903180013,486,2903180499,2928442098
2025-06-19 09:43:54,REAL,2903180499,7955,2903188454,2928450053
2025-06-19 09:43:56,FAKE,2903188454,238,2903188692,2928460894
2025-06-19 09:43:58,REAL,2903188692,10260,2903198952,2928471154
2025-06-19 09:44:00,FAKE,2903198952,243,2903199195,2928481402
2025-06-19 09:44:02,REAL,2903199195,10318,2903209513,2928491720
2025-06-19 09:44:04,FAKE,2903209513,241,2903209754,2928501964
2025-06-19 09:44:06,REAL,2903209754,10257,2903220011,2928512221
2025-06-19 09:44:08,FAKE,2903220011,244,2903220255,2928521421
2025-06-19 09:44:10,REAL,2903220255,487,2903220742,2928521908
2025-06-19 09:44:12,REAL,2903220742,486,2903221228,2928522394
2025-06-19 09:44:14,REAL,2903221228,476,2903221704,2928522870
2025-06-19 09:44:16,REAL,2903221704,534,2903222238,2928523404
2025-06-19 09:44:18,REAL,2903222238,486,2903222724,2928523890
2025-06-19 09:44:20,FAKE,2903222724,238,2903222962,2928524374
2025-06-19 09:44:22,FAKE,2903222962,243,2903223205,2928524915
2025-06-19 09:44:24,REAL,2903223205,487,2903223692,2928525402
2025-06-19 09:44:26,FAKE,2903223692,244,2903223936,2928533418
2025-06-19 09:44:28,REAL,2903223936,10781,2903234717,2928544199
2025-06-19 09:44:30,FAKE,2903234717,238,2903234955,2928554512
2025-06-19 09:44:32,REAL,2903234955,10246,2903245201,2928564758
2025-06-19 09:44:34,REAL,2903245201,10248,2903255449,2928575006
2025-06-19 09:44:36,REAL,2903255449,10257,2903265706,2928585263
2025-06-19 09:44:38,FAKE,2903265706,238,2903265944,2928595513
2025-06-19 09:44:40,FAKE,2903265944,243,2903266187,2928604175
2025-06-19 09:44:42,REAL,2903266187,480,2903266667,2928604655
2025-06-19 09:44:44,REAL,2903266667,485,2903267152,2928605140
2025-06-19 09:44:46,FAKE,2903267152,244,2903267396,2928605628
2025-06-19 09:44:48,REAL,2903267396,488,2903267884,2928606116
2025-06-19 09:44:50,REAL,2903267884,537,2903268421,2928606653
2025-06-19 09:44:52,REAL,2903268421,546,2903268967,2928607199
2025-06-19 09:44:54,FAKE,2903268967,244,2903269211,2928607679
2025-06-19 09:44:56,REAL,2903269211,483,2903269694,2928608162
2025-06-19 09:44:58,REAL,2903269694,9302,2903278996,2928617464
2025-06-19 09:45:00,FAKE,2903278996,241,2903279237,2928628178
2025-06-19 09:45:02,REAL,2903279237,10252,2903289489,2928638430
2025-06-19 09:45:04,REAL,2903289489,10251,2903299740,2928648681
2025-06-19 09:45:06,REAL,2903299740,10261,2903310001,2928658942
2025-06-19 09:45:08,REAL,2903310001,10317,2903320318,2928669259
2025-06-19 09:45:10,FAKE,2903320318,241,2903320559,2928679511
2025-06-19 09:45:12,REAL,2903320559,8015,2903328574,2928687526
2025-06-19 09:45:14,REAL,2903328574,485,2903329059,2928688011
2025-06-19 09:45:16,REAL,2903329059,484,2903329543,2928688495
2025-06-19 09:45:18,FAKE,2903329543,243,2903329786,2928688976
2025-06-19 09:45:20,FAKE,2903329786,241,2903330027,2928689460
2025-06-19 09:45:22,FAKE,2903330027,243,2903330270,2928689939
2025-06-19 09:45:24,REAL,2903330270,542,2903330812,2928690481
2025-06-19 09:45:26,FAKE,2903330812,243,2903331055,2928691023
2025-06-19 09:45:28,FAKE,2903331055,241,2903331296,2928691509
2025-06-19 09:45:30,REAL,2903331296,11576,2903342872,2928703085
2025-06-19 09:45:32,FAKE,2903342872,241,2903343113,2928713929
2025-06-19 09:45:34,FAKE,2903343113,241,2903343354,2928724238
2025-06-19 09:45:36,REAL,2903343354,10254,2903353608,2928734492
2025-06-19 09:45:38,REAL,2903353608,10252,2903363860,2928744744
2025-06-19 09:45:40,REAL,2903363860,10247,2903374107,2928754991
2025-06-19 09:45:42,FAKE,2903374107,241,2903374348,2928765239
2025-06-19 09:45:44,REAL,2903374348,7344,2903381692,2928772583
2025-06-19 09:45:46,REAL,2903381692,482,2903382174,2928773065
2025-06-19 09:45:48,REAL,2903382174,475,2903382649,2928773540
2025-06-19 09:45:50,REAL,2903382649,4259,2903386908,2928777799
2025-06-19 09:45:52,REAL,2903386908,11237,2903398145,2928789036
2025-06-19 09:45:54,REAL,2903398145,10322,2903408467,2928799358
2025-06-19 09:45:56,REAL,2903408467,10249,2903418716,2928809607
2025-06-19 09:45:58,REAL,2903418716,10254,2903428970,2928819861
2025-06-19 09:46:00,REAL,2903428970,10311,2903439281,2928830172
2025-06-19 09:46:02,FAKE,2903439281,243,2903439524,2928840421
2025-06-19 09:46:04,REAL,2903439524,10304,2903449828,2928850725
2025-06-19 09:46:06,FAKE,2903449828,243,2903450071,2928852852
2025-06-19 09:46:08,REAL,2903450071,483,2903450554,2928853335
2025-06-19 09:46:10,REAL,2903450554,490,2903451044,2928853825
2025-06-19 09:46:12,REAL,2903451044,488,2903451532,2928854313
2025-06-19 09:46:14,REAL,2903451532,478,2903452010,2928854791
2025-06-19 09:46:16,FAKE,2903452010,241,2903452251,2928855271
2025-06-19 09:46:18,FAKE,2903452251,241,2903452492,2928855810
2025-06-19 09:46:20,REAL,2903452492,485,2903452977,2928856295
2025-06-19 09:46:22,REAL,2903452977,478,2903453455,2928856773
2025-06-19 09:46:24,FAKE,2903453455,244,2903453699,2928857253
2025-06-19 09:46:26,REAL,2903453699,486,2903454185,2928857739
2025-06-19 09:46:28,FAKE,2903454185,241,2903454426,2928858222
2025-06-19 09:46:30,FAKE,2903454426,241,2903454667,2928858707
2025-06-19 09:46:32,REAL,2903454667,491,2903455158,2928859198
2025-06-19 09:46:34,FAKE,2903455158,241,2903455399,2928859678
2025-06-19 09:46:36,REAL,2903455399,484,2903455883,2928860162
2025-06-19 09:46:38,REAL,2903455883,484,2903456367,2928860646
2025-06-19 09:46:40,FAKE,2903456367,238,2903456605,2928861190
2025-06-19 09:46:42,REAL,2903456605,476,2903457081,2928861666
2025-06-19 09:46:44,REAL,2903457081,15015,2903472096,2928876681
2025-06-19 09:46:46,FAKE,2903472096,238,2903472334,2928886996
2025-06-19 09:46:48,FAKE,2903472334,238,2903472572,2928897312
2025-06-19 09:46:50,FAKE,2903472572,238,2903472810,2928907556
2025-06-19 09:46:52,REAL,2903472810,10308,2903483118,2928917864
2025-06-19 09:46:54,FAKE,2903483118,244,2903483362,2928928113
2025-06-19 09:46:56,FAKE,2903483362,238,2903483600,2928938433
2025-06-19 09:46:58,FAKE,2903483600,238,2903483838,2928944595
2025-06-19 09:47:00,REAL,2903483838,482,2903484320,2928945077
2025-06-19 09:47:02,REAL,2903484320,483,2903484803,2928945560
2025-06-19 09:47:04,REAL,2903484803,485,2903485288,2928946045
2025-06-19 09:47:06,REAL,2903485288,480,2903485768,2928946525
2025-06-19 09:47:08,FAKE,2903485768,241,2903486009,2928947009
2025-06-19 09:47:10,FAKE,2903486009,244,2903486253,2928947492
2025-06-19 09:47:12,REAL,2903486253,489,2903486742,2928947981
2025-06-19 09:47:14,REAL,2903486742,484,2903487226,2928948465
2025-06-19 09:47:16,REAL,2903487226,484,2903487710,2928948949
2025-06-19 09:47:18,REAL,2903487710,542,2903488252,2928949491
2025-06-19 09:47:20,REAL,2903488252,481,2903488733,2928949972
2025-06-19 09:47:22,FAKE,2903488733,238,2903488971,2928950455
2025-06-19 09:47:24,REAL,2903488971,475,2903489446,2928950930
2025-06-19 09:47:26,REAL,2903489446,491,2903489937,2928951421
2025-06-19 09:47:28,REAL,2903489937,490,2903490427,2928951911
2025-06-19 09:47:30,REAL,2903490427,480,2903490907,2928952391
2025-06-19 09:47:32,REAL,2903490907,490,2903491397,2928952881
2025-06-19 09:47:34,REAL,2903491397,540,2903491937,2928953421
2025-06-19 09:47:36,REAL,2903491937,483,2903492420,2928953904
2025-06-19 09:47:38,REAL,2903492420,483,2903492903,2928954387
2025-06-19 09:47:40,FAKE,2903492903,238,2903493141,2928954878
2025-06-19 09:47:42,REAL,2903493141,482,2903493623,2928955360
2025-06-19 09:47:44,FAKE,2903493623,244,2903493867,2928955834
2025-06-19 09:47:46,REAL,2903493867,486,2903494353,2928956320
2025-06-19 09:47:48,REAL,2903494353,476,2903494829,2928956796
2025-06-19 09:47:50,REAL,2903494829,484,2903495313,2928957280
2025-06-19 09:47:52,REAL,2903495313,486,2903495799,2928957766
2025-06-19 09:47:54,REAL,2903495799,538,2903496337,2928958304
2025-06-19 09:47:56,REAL,2903496337,481,2903496818,2928958785
2025-06-19 09:47:58,REAL,2903496818,477,2903497295,2928959262
2025-06-19 09:48:00,REAL,2903497295,476,2903497771,2928959738
2025-06-19 09:48:02,FAKE,2903497771,243,2903498014,2928960220
2025-06-19 09:48:04,REAL,2903498014,476,2903498490,2928960696
2025-06-19 09:48:06,REAL,2903498490,476,2903498966,2928961172
2025-06-19 09:48:08,REAL,2903498966,489,2903499455,2928961661
2025-06-19 09:48:10,FAKE,2903499455,244,2903499699,2928962137
2025-06-19 09:48:12,REAL,2903499699,483,2903500182,2928962620
2025-06-19 09:48:14,REAL,2903500182,483,2903500665,2928963103
2025-06-19 09:48:16,REAL,2903500665,494,2903501159,2928963597
2025-06-19 09:48:18,FAKE,2903501159,241,2903501400,2928964083
2025-06-19 09:48:20,REAL,2903501400,481,2903501881,2928964564
2025-06-19 09:48:22,REAL,2903501881,484,2903502365,2928965048
2025-06-19 09:48:24,FAKE,2903502365,243,2903502608,2928965595
2025-06-19 09:48:26,FAKE,2903502608,238,2903502846,2928966088
2025-06-19 09:48:28,REAL,2903502846,7166,2903510012,2928973254
2025-06-19 09:48:30,REAL,2903510012,11049,2903521061,2928984303
2025-06-19 09:48:32,FAKE,2903521061,238,2903521299,2928994611
2025-06-19 09:48:34,REAL,2903521299,10325,2903531624,2929004936
2025-06-19 09:48:36,REAL,2903531624,10247,2903541871,2929015183
2025-06-19 09:48:38,REAL,2903541871,10257,2903552128,2929025440
2025-06-19 09:48:40,FAKE,2903552128,243,2903552371,2929035693
2025-06-19 09:48:42,REAL,2903552371,9651,2903562022,2929045344
2025-06-19 09:48:44,REAL,2903562022,485,2903562507,2929045829
2025-06-19 09:48:46,FAKE,2903562507,243,2903562750,2929046308
2025-06-19 09:48:48,FAKE,2903562750,241,2903562991,2929046797
2025-06-19 09:48:50,REAL,2903562991,476,2903563467,2929047273
2025-06-19 09:48:52,REAL,2903563467,485,2903563952,2929047758
2025-06-19 09:48:54,REAL,2903563952,487,2903564439,2929048245
2025-06-19 09:48:56,REAL,2903564439,491,2903564930,2929048736
2025-06-19 09:48:58,FAKE,2903564930,241,2903565171,2929049216
2025-06-19 09:49:00,REAL,2903565171,486,2903565657,2929049702
2025-06-19 09:49:02,REAL,2903565657,484,2903566141,2929050186
2025-06-19 09:49:04,REAL,2903566141,481,2903566622,2929050667
2025-06-19 09:49:06,FAKE,2903566622,241,2903566863,2929051142
2025-06-19 09:49:08,REAL,2903566863,542,2903567405,2929051684
2025-06-19 09:49:10,REAL,2903567405,489,2903567894,2929052173
2025-06-19 09:49:12,REAL,2903567894,488,2903568382,2929052661
2025-06-19 09:49:14,REAL,2903568382,475,2903568857,2929053136
2025-06-19 09:49:16,REAL,2903568857,487,2903569344,2929053623
2025-06-19 09:49:18,REAL,2903569344,548,2903569892,2929054171
2025-06-19 09:49:20,REAL,2903569892,486,2903570378,2929054657
2025-06-19 09:49:22,REAL,2903570378,483,2903570861,2929055140
2025-06-19 09:49:24,REAL,2903570861,491,2903571352,2929055631
2025-06-19 09:49:26,REAL,2903571352,475,2903571827,2929056106
2025-06-19 09:49:28,REAL,2903571827,487,2903572314,2929056593
2025-06-19 09:49:30,FAKE,2903572314,238,2903572552,2929057081
2025-06-19 09:49:32,FAKE,2903572552,241,2903572793,2929057562
2025-06-19 09:49:34,REAL,2903572793,485,2903573278,2929058047
2025-06-19 09:49:36,REAL,2903573278,488,2903573766,2929058535
2025-06-19 09:49:38,REAL,2903573766,488,2903574254,2929059023
2025-06-19 09:49:40,REAL,2903574254,476,2903574730,2929059499
2025-06-19 09:49:42,REAL,2903574730,480,2903575210,2929059979
2025-06-19 09:49:44,REAL,2903575210,486,2903575696,2929060465
2025-06-19 09:49:46,REAL,2903575696,541,2903576237,2929061006
2025-06-19 09:49:48,REAL,2903576237,491,2903576728,2929061497
2025-06-19 09:49:50,FAKE,2903576728,238,2903576966,2929061981
2025-06-19 09:49:52,REAL,2903576966,486,2903577452,2929062467
2025-06-19 09:49:54,FAKE,2903577452,241,2903577693,2929062957
2025-06-19 09:49:56,FAKE,2903577693,244,2903577937,2929063438
2025-06-19 09:49:58,REAL,2903577937,483,2903578420,2929063921
2025-06-19 09:50:00,REAL,2903578420,486,2903578906,2929064407
2025-06-19 09:50:02,FAKE,2903578906,241,2903579147,2929064890
2025-06-19 09:50:04,REAL,2903579147,484,2903579631,2929065374
2025-06-19 09:50:06,FAKE,2903579631,238,2903579869,2929065858
2025-06-19 09:50:08,REAL,2903579869,541,2903580410,2929066399
2025-06-19 09:50:10,REAL,2903580410,479,2903580889,2929066878
2025-06-19 09:50:12,REAL,2903580889,485,2903581374,2929067363
2025-06-19 09:50:14,REAL,2903581374,483,2903581857,2929067846
2025-06-19 09:50:16,FAKE,2903581857,244,2903582101,2929068331
2025-06-19 09:50:18,REAL,2903582101,482,2903582583,2929068813
2025-06-19 09:50:20,REAL,2903582583,488,2903583071,2929069301
2025-06-19 09:50:22,REAL,2903583071,541,2903583612,2929069842
2025-06-19 09:50:24,REAL,2903583612,485,2903584097,2929070327
2025-06-19 09:50:26,REAL,2903584097,485,2903584582,2929070812
2025-06-19 09:50:28,REAL,2903584582,487,2903585069,2929071299
2025-06-19 09:50:30,REAL,2903585069,483,2903585552,2929071782
2025-06-19 09:50:32,FAKE,2903585552,241,2903585793,2929072258
2025-06-19 09:50:34,FAKE,2903585793,238,2903586031,2929072740
2025-06-19 09:50:36,REAL,2903586031,487,2903586518,2929073227
2025-06-19 09:50:38,REAL,2903586518,488,2903587006,2929073715
2025-06-19 09:50:40,FAKE,2903587006,241,2903587247,2929074193
2025-06-19 09:50:42,REAL,2903587247,480,2903587727,2929074673
2025-06-19 09:50:44,FAKE,2903587727,243,2903587970,2929075157
2025-06-19 09:50:46,REAL,2903587970,485,2903588455,2929075642
2025-06-19 09:50:48,REAL,2903588455,538,2903588993,2929076180
2025-06-19 09:50:50,FAKE,2903588993,238,2903589231,2929080100
2025-06-19 09:50:52,REAL,2903589231,13876,2903603107,2929093976
2025-06-19 09:50:54,FAKE,2903603107,241,2903603348,2929104224
2025-06-19 09:50:56,REAL,2903603348,10320,2903613668,2929114544
2025-06-19 09:50:58,REAL,2903613668,10253,2903623921,2929124797
2025-06-19 09:51:00,FAKE,2903623921,243,2903624164,2929135052
2025-06-19 09:51:02,REAL,2903624164,10322,2903634486,2929145374
2025-06-19 09:51:04,REAL,2903634486,10252,2903644738,2929155626
2025-06-19 09:51:06,FAKE,2903644738,241,2903644979,2929157889
2025-06-19 09:51:08,FAKE,2903644979,241,2903645220,2929158372
2025-06-19 09:51:10,FAKE,2903645220,244,2903645464,2929158858
2025-06-19 09:51:12,FAKE,2903645464,244,2903645708,2929168939
2025-06-19 09:51:14,FAKE,2903645708,243,2903645951,2929179526
2025-06-19 09:51:16,FAKE,2903645951,238,2903646189,2929189838
2025-06-19 09:51:18,REAL,2903646189,10315,2903656504,2929200153
2025-06-19 09:51:20,FAKE,2903656504,241,2903656745,2929210411
2025-06-19 09:51:22,REAL,2903656745,10316,2903667061,2929220727
2025-06-19 09:51:24,FAKE,2903667061,244,2903667305,2929230980
2025-06-19 09:51:26,FAKE,2903667305,243,2903667548,2929237802
2025-06-19 09:51:28,FAKE,2903667548,238,2903667786,2929238285
2025-06-19 09:51:30,FAKE,2903667786,243,2903668029,2929238767
2025-06-19 09:51:32,FAKE,2903668029,238,2903668267,2929239254
2025-06-19 09:51:34,FAKE,2903668267,241,2903668508,2929239740
2025-06-19 09:51:36,FAKE,2903668508,243,2903668751,2929240221
2025-06-19 09:51:38,REAL,2903668751,480,2903669231,2929240701
2025-06-19 09:51:40,REAL,2903669231,481,2903669712,2929241182
2025-06-19 09:51:42,REAL,2903669712,482,2903670194,2929241664
2025-06-19 09:51:44,FAKE,2903670194,241,2903670435,2929252972
2025-06-19 09:51:46,FAKE,2903670435,244,2903670679,2929263362
2025-06-19 09:51:48,FAKE,2903670679,241,2903670920,2929273614
2025-06-19 09:51:50,FAKE,2903670920,244,2903671164,2929283933
2025-06-19 09:51:52,REAL,2903671164,10250,2903681414,2929294183
2025-06-19 09:51:54,FAKE,2903681414,241,2903681655,2929304430
2025-06-19 09:51:56,REAL,2903681655,10314,2903691969,2929314744
2025-06-19 09:51:58,REAL,2903691969,6159,2903698128,2929320903
2025-06-19 09:52:00,REAL,2903698128,484,2903698612,2929321387
2025-06-19 09:52:02,FAKE,2903698612,241,2903698853,2929321872
2025-06-19 09:52:04,REAL,2903698853,476,2903699329,2929322348
2025-06-19 09:52:06,REAL,2903699329,476,2903699805,2929322824
2025-06-19 09:52:08,REAL,2903699805,489,2903700294,2929323313
2025-06-19 09:52:10,REAL,2903700294,491,2903700785,2929323804
2025-06-19 09:52:12,FAKE,2903700785,238,2903701023,2929324349
2025-06-19 09:52:14,REAL,2903701023,477,2903701500,2929324826
2025-06-19 09:52:16,REAL,2903701500,11242,2903712742,2929336068
2025-06-19 09:52:18,FAKE,2903712742,238,2903712980,2929346387
2025-06-19 09:52:20,REAL,2903712980,10245,2903723225,2929356632
2025-06-19 09:52:22,FAKE,2903723225,238,2903723463,2929366955
2025-06-19 09:52:24,REAL,2903723463,10260,2903733723,2929377215
2025-06-19 09:52:26,REAL,2903733723,10317,2903744040,2929387532
2025-06-19 09:52:28,FAKE,2903744040,241,2903744281,2929397850
2025-06-19 09:52:30,REAL,2903744281,5566,2903749847,2929403416
2025-06-19 09:52:32,FAKE,2903749847,238,2903750085,2929403896
2025-06-19 09:52:34,REAL,2903750085,483,2903750568,2929404379
2025-06-19 09:52:36,REAL,2903750568,544,2903751112,2929404923
2025-06-19 09:52:38,REAL,2903751112,480,2903751592,2929405403
2025-06-19 09:52:40,REAL,2903751592,486,2903752078,2929405889
2025-06-19 09:52:42,REAL,2903752078,483,2903752561,2929406372
2025-06-19 09:52:44,REAL,2903752561,477,2903753038,2929406849
2025-06-19 09:52:46,REAL,2903753038,624,2903753662,2929407473
2025-06-19 09:52:48,FAKE,2903753662,238,2903753900,2929422349
2025-06-19 09:52:50,FAKE,2903753900,238,2903754138,2929432604
2025-06-19 09:52:52,FAKE,2903754138,244,2903754382,2929442917
2025-06-19 09:52:54,FAKE,2903754382,244,2903754626,2929453175
2025-06-19 09:52:56,REAL,2903754626,10257,2903764883,2929463432
2025-06-19 09:52:58,REAL,2903764883,10257,2903775140,2929473689
2025-06-19 09:53:00,FAKE,2903775140,243,2903775383,2929484003
2025-06-19 09:53:02,FAKE,2903775383,244,2903775627,2929488975
2025-06-19 09:53:04,REAL,2903775627,535,2903776162,2929489510
2025-06-19 09:53:06,FAKE,2903776162,241,2903776403,2929489985
2025-06-19 09:53:08,FAKE,2903776403,238,2903776641,2929490461
2025-06-19 09:53:10,REAL,2903776641,477,2903777118,2929490938
2025-06-19 09:53:12,FAKE,2903777118,241,2903777359,2929491420
2025-06-19 09:53:14,FAKE,2903777359,238,2903777597,2929491902
2025-06-19 09:53:16,FAKE,2903777597,244,2903777841,2929492386
2025-06-19 09:53:18,FAKE,2903777841,244,2903778085,2929494204
2025-06-19 09:53:20,REAL,2903778085,11905,2903789990,2929506109
2025-06-19 09:53:22,REAL,2903789990,10253,2903800243,2929516362
2025-06-19 09:53:24,FAKE,2903800243,238,2903800481,2929526685
2025-06-19 09:53:26,FAKE,2903800481,241,2903800722,2929536936
2025-06-19 09:53:28,REAL,2903800722,10246,2903810968,2929547182
2025-06-19 09:53:30,REAL,2903810968,10371,2903821339,2929557553
2025-06-19 09:53:32,REAL,2903821339,10255,2903831594,2929567808
2025-06-19 09:53:34,REAL,2903831594,4311,2903835905,2929572119
2025-06-19 09:53:36,REAL,2903835905,482,2903836387,2929572601
2025-06-19 09:53:38,FAKE,2903836387,243,2903836630,2929573085
2025-06-19 09:53:40,FAKE,2903836630,243,2903836873,2929573574
2025-06-19 09:53:42,REAL,2903836873,482,2903837355,2929574056
2025-06-19 09:53:44,FAKE,2903837355,243,2903837598,2929574541
2025-06-19 09:53:46,FAKE,2903837598,238,2903837836,2929575026
2025-06-19 09:53:48,FAKE,2903837836,238,2903838074,2929575501
2025-06-19 09:53:50,REAL,2903838074,2479,2903840553,2929577980
2025-06-19 09:53:52,REAL,2903840553,11241,2903851794,2929589221
2025-06-19 09:53:54,REAL,2903851794,10316,2903862110,2929599537
2025-06-19 09:53:56,REAL,2903862110,10256,2903872366,2929609793
2025-06-19 09:53:58,REAL,2903872366,10307,2903882673,2929620100
2025-06-19 09:54:00,REAL,2903882673,10249,2903892922,2929630349
2025-06-19 09:54:02,REAL,2903892922,10316,2903903238,2929640665
2025-06-19 09:54:04,REAL,2903903238,10254,2903913492,2929650919
2025-06-19 09:54:06,FAKE,2903913492,241,2903913733,2929654566
2025-06-19 09:54:08,FAKE,2903913733,238,2903913971,2929655051
2025-06-19 09:54:10,REAL,2903913971,481,2903914452,2929655532
2025-06-19 09:54:12,REAL,2903914452,482,2903914934,2929656014
2025-06-19 09:54:14,FAKE,2903914934,241,2903915175,2929656495
2025-06-19 09:54:16,REAL,2903915175,494,2903915669,2929656989
2025-06-19 09:54:18,REAL,2903915669,489,2903916158,2929657478
2025-06-19 09:54:20,REAL,2903916158,482,2903916640,2929657960
2025-06-19 09:54:22,REAL,2903916640,482,2903917122,2929658442
2025-06-19 09:54:24,FAKE,2903917122,241,2903917363,2929658984
2025-06-19 09:54:26,FAKE,2903917363,244,2903917607,2929659519
2025-06-19 09:54:28,REAL,2903917607,484,2903918091,2929660003
2025-06-19 09:54:30,FAKE,2903918091,238,2903918329,2929660480
2025-06-19 09:54:32,REAL,2903918329,488,2903918817,2929660968
2025-06-19 09:54:34,REAL,2903918817,492,2903919309,2929661460
2025-06-19 09:54:36,REAL,2903919309,478,2903919787,2929661938
2025-06-19 09:54:38,REAL,2903919787,483,2903920270,2929662421
2025-06-19 09:54:40,REAL,2903920270,484,2903920754,2929662905
2025-06-19 09:54:42,REAL,2903920754,486,2903921240,2929663391
2025-06-19 09:54:44,REAL,2903921240,484,2903921724,2929663875
2025-06-19 09:54:46,FAKE,2903921724,238,2903921962,2929664360
2025-06-19 09:54:48,REAL,2903921962,490,2903922452,2929664850
2025-06-19 09:54:50,REAL,2903922452,536,2903922988,2929665386
2025-06-19 09:54:52,REAL,2903922988,493,2903923481,2929665879
2025-06-19 09:54:54,REAL,2903923481,482,2903923963,2929666361
2025-06-19 09:54:56,FAKE,2903923963,238,2903924201,2929666848
2025-06-19 09:54:58,FAKE,2903924201,243,2903924444,2929667333
2025-06-19 09:55:00,REAL,2903924444,9803,2903934247,2929677136
2025-06-19 09:55:02,REAL,2903934247,10520,2903944767,2929687656
2025-06-19 09:55:04,FAKE,2903944767,244,2903945011,2929697898
2025-06-19 09:55:06,REAL,2903945011,10319,2903955330,2929708217
2025-06-19 09:55:08,FAKE,2903955330,241,2903955571,2929718229
2025-06-19 09:55:10,FAKE,2903955571,238,2903955809,2929728485
2025-06-19 09:55:12,REAL,2903955809,10317,2903966126,2929738802
2025-06-19 09:55:14,REAL,2903966126,7287,2903973413,2929746089
2025-06-19 09:55:16,REAL,2903973413,483,2903973896,2929746572
2025-06-19 09:55:18,REAL,2903973896,492,2903974388,2929747064
2025-06-19 09:55:20,FAKE,2903974388,243,2903974631,2929747599
2025-06-19 09:55:22,REAL,2903974631,488,2903975119,2929748087
2025-06-19 09:55:24,REAL,2903975119,492,2903975611,2929748579
2025-06-19 09:55:26,REAL,2903975611,478,2903976089,2929749057
2025-06-19 09:55:28,REAL,2903976089,483,2903976572,2929749540
2025-06-19 09:55:30,REAL,2903976572,488,2903977060,2929750028
2025-06-19 09:55:32,FAKE,2903977060,241,2903977301,2929763259
2025-06-19 09:55:34,REAL,2903977301,10313,2903987614,2929773572
2025-06-19 09:55:36,REAL,2903987614,10262,2903997876,2929783834
2025-06-19 09:55:38,REAL,2903997876,10322,2904008198,2929794156
2025-06-19 09:55:40,FAKE,2904008198,238,2904008436,2929804412
2025-06-19 09:55:42,FAKE,2904008436,244,2904008680,2929814674
2025-06-19 09:55:44,REAL,2904008680,10251,2904018931,2929824925
2025-06-19 09:55:46,REAL,2904018931,6690,2904025621,2929831615
2025-06-19 09:55:48,REAL,2904025621,492,2904026113,2929832107
2025-06-19 09:55:50,REAL,2904026113,483,2904026596,2929832590
2025-06-19 09:55:52,REAL,2904026596,535,2904027131,2929833125
2025-06-19 09:55:54,FAKE,2904027131,241,2904027372,2929833601
2025-06-19 09:55:56,REAL,2904027372,486,2904027858,2929834087
2025-06-19 09:55:58,REAL,2904027858,490,2904028348,2929834577
2025-06-19 09:56:00,REAL,2904028348,486,2904028834,2929835063
2025-06-19 09:56:02,REAL,2904028834,484,2904029318,2929835547
2025-06-19 09:56:04,REAL,2904029318,487,2904029805,2929836034
2025-06-19 09:56:06,REAL,2904029805,538,2904030343,2929836572
2025-06-19 09:56:08,FAKE,2904030343,241,2904030584,2929837055
2025-06-19 09:56:10,REAL,2904030584,484,2904031068,2929837539
2025-06-19 09:56:12,REAL,2904031068,484,2904031552,2929838023
2025-06-19 09:56:14,REAL,2904031552,482,2904032034,2929838505
2025-06-19 09:56:16,FAKE,2904032034,241,2904032275,2929838989
2025-06-19 09:56:18,REAL,2904032275,483,2904032758,2929839472
2025-06-19 09:56:20,REAL,2904032758,485,2904033243,2929839957
2025-06-19 09:56:22,REAL,2904033243,538,2904033781,2929840495
2025-06-19 09:56:24,FAKE,2904033781,238,2904034019,2929840979
2025-06-19 09:56:26,REAL,2904034019,492,2904034511,2929841471
2025-06-19 09:56:28,FAKE,2904034511,244,2904034755,2929841960
2025-06-19 09:56:30,FAKE,2904034755,243,2904034998,2929842449
2025-06-19 09:56:32,REAL,2904034998,488,2904035486,2929842937
2025-06-19 09:56:34,REAL,2904035486,487,2904035973,2929843424
2025-06-19 09:56:36,REAL,2904035973,480,2904036453,2929843904
2025-06-19 09:56:38,REAL,2904036453,482,2904036935,2929844386
2025-06-19 09:56:40,REAL,2904036935,539,2904037474,2929844925
2025-06-19 09:56:42,FAKE,2904037474,243,2904037717,2929845405
2025-06-19 09:56:44,FAKE,2904037717,244,2904037961,2929845893
2025-06-19 09:56:46,FAKE,2904037961,243,2904038204,2929858067
2025-06-19 09:56:48,FAKE,2904038204,238,2904038442,2929868319
2025-06-19 09:56:50,REAL,2904038442,10262,2904048704,2929878581
2025-06-19 09:56:52,FAKE,2904048704,241,2904048945,2929888833
2025-06-19 09:56:54,REAL,2904048945,10377,2904059322,2929899210
2025-06-19 09:56:56,FAKE,2904059322,238,2904059560,2929909457
2025-06-19 09:56:58,REAL,2904059560,10249,2904069809,2929919706
2025-06-19 09:57:00,REAL,2904069809,5372,2904075181,2929925078
2025-06-19 09:57:02,REAL,2904075181,486,2904075667,2929925564
2025-06-19 09:57:04,REAL,2904075667,484,2904076151,2929926048
2025-06-19 09:57:06,FAKE,2904076151,241,2904076392,2929926535
2025-06-19 09:57:08,REAL,2904076392,486,2904076878,2929927021
2025-06-19 09:57:10,REAL,2904076878,475,2904077353,2929927496
2025-06-19 09:57:12,FAKE,2904077353,244,2904077597,2929927982
2025-06-19 09:57:14,REAL,2904077597,489,2904078086,2929928471
2025-06-19 09:57:16,REAL,2904078086,1086,2904079172,2929929557
2025-06-19 09:57:18,FAKE,2904079172,243,2904079415,2929944235
2025-06-19 09:57:20,FAKE,2904079415,238,2904079653,2929954493
2025-06-19 09:57:22,REAL,2904079653,10250,2904089903,2929964743
2025-06-19 09:57:24,REAL,2904089903,10305,2904100208,2929975048
2025-06-19 09:57:26,REAL,2904100208,10326,2904110534,2929985374
2025-06-19 09:57:28,REAL,2904110534,10253,2904120787,2929995627
2025-06-19 09:57:30,REAL,2904120787,10258,2904131045,2930005885
2025-06-19 09:57:32,FAKE,2904131045,244,2904131289,2930010590
2025-06-19 09:57:34,FAKE,2904131289,241,2904131530,2930011081
2025-06-19 09:57:36,REAL,2904131530,482,2904132012,2930011563
2025-06-19 09:57:38,FAKE,2904132012,244,2904132256,2930012047
2025-06-19 09:57:40,REAL,2904132256,487,2904132743,2930012534
2025-06-19 09:57:42,REAL,2904132743,485,2904133228,2930013019
2025-06-19 09:57:44,REAL,2904133228,484,2904133712,2930013503
2025-06-19 09:57:46,REAL,2904133712,482,2904134194,2930013985
2025-06-19 09:57:48,FAKE,2904134194,241,2904134435,2930015935
2025-06-19 09:57:50,REAL,2904134435,11704,2904146139,2930027639
2025-06-19 09:57:52,FAKE,2904146139,243,2904146382,2930037890
2025-06-19 09:57:54,REAL,2904146382,10257,2904156639,2930048147
2025-06-19 09:57:56,REAL,2904156639,10310,2904166949,2930058457
2025-06-19 09:57:58,REAL,2904166949,10252,2904177201,2930068709
2025-06-19 09:58:00,REAL,2904177201,10320,2904187521,2930079029
2025-06-19 09:58:02,FAKE,2904187521,243,2904187764,2930089283
2025-06-19 09:58:04,FAKE,2904187764,244,2904188008,2930093393
2025-06-19 09:58:06,FAKE,2904188008,244,2904188252,2930093874
2025-06-19 09:58:08,REAL,2904188252,486,2904188738,2930094360
2025-06-19 09:58:10,REAL,2904188738,9199,2904197937,2930103559
2025-06-19 09:58:12,REAL,2904197937,12102,2904210039,2930115661
2025-06-19 09:58:14,REAL,2904210039,10313,2904220352,2930125974
2025-06-19 09:58:16,REAL,2904220352,10253,2904230605,2930136227
2025-06-19 09:58:18,REAL,2904230605,11550,2904242155,2930147777
2025-06-19 09:58:20,REAL,2904242155,9025,2904251180,2930156802
2025-06-19 09:58:22,REAL,2904251180,10248,2904261428,2930167050
2025-06-19 09:58:24,FAKE,2904261428,243,2904261671,2930175848
2025-06-19 09:58:26,REAL,2904261671,532,2904262203,2930176380
2025-06-19 09:58:28,FAKE,2904262203,241,2904262444,2930176869
2025-06-19 09:58:30,REAL,2904262444,485,2904262929,2930177354
2025-06-19 09:58:32,REAL,2904262929,476,2904263405,2930177830
2025-06-19 09:58:34,FAKE,2904263405,241,2904263646,2930178307
2025-06-19 09:58:36,REAL,2904263646,486,2904264132,2930178793
2025-06-19 09:58:38,REAL,2904264132,484,2904264616,2930179277
2025-06-19 09:58:40,REAL,2904264616,486,2904265102,2930179763
2025-06-19 09:58:42,FAKE,2904265102,241,2904265343,2930188635
2025-06-19 09:58:44,FAKE,2904265343,243,2904265586,2930199075
2025-06-19 09:58:46,REAL,2904265586,10253,2904275839,2930209328
2025-06-19 09:58:48,REAL,2904275839,10309,2904286148,2930219637
2025-06-19 09:58:50,REAL,2904286148,10248,2904296396,2930229885
2025-06-19 09:58:52,REAL,2904296396,10320,2904306716,2930240205
2025-06-19 09:58:54,FAKE,2904306716,238,2904306954,2930250457
2025-06-19 09:58:56,REAL,2904306954,8194,2904315148,2930258651
2025-06-19 09:58:58,REAL,2904315148,484,2904315632,2930259135
2025-06-19 09:59:00,REAL,2904315632,492,2904316124,2930259627
2025-06-19 09:59:02,REAL,2904316124,490,2904316614,2930260117
2025-06-19 09:59:04,REAL,2904316614,487,2904317101,2930260604
2025-06-19 09:59:06,REAL,2904317101,480,2904317581,2930261084
2025-06-19 09:59:08,REAL,2904317581,483,2904318064,2930261567
2025-06-19 09:59:10,REAL,2904318064,489,2904318553,2930262056
2025-06-19 09:59:12,REAL,2904318553,485,2904319038,2930262541
2025-06-19 09:59:14,FAKE,2904319038,238,2904319276,2930263027
2025-06-19 09:59:16,REAL,2904319276,542,2904319818,2930263569
2025-06-19 09:59:18,REAL,2904319818,481,2904320299,2930264050
2025-06-19 09:59:20,REAL,2904320299,475,2904320774,2930264525
2025-06-19 09:59:22,REAL,2904320774,479,2904321253,2930265004
2025-06-19 09:59:24,REAL,2904321253,476,2904321729,2930265480
2025-06-19 09:59:26,FAKE,2904321729,243,2904321972,2930265973
2025-06-19 09:59:28,REAL,2904321972,541,2904322513,2930266514
2025-06-19 09:59:30,REAL,2904322513,482,2904322995,2930266996
2025-06-19 09:59:32,REAL,2904322995,479,2904323474,2930267475
2025-06-19 09:59:34,REAL,2904323474,489,2904323963,2930267964
2025-06-19 09:59:36,FAKE,2904323963,238,2904324201,2930268449
2025-06-19 09:59:38,REAL,2904324201,489,2904324690,2930268938
2025-06-19 09:59:40,FAKE,2904324690,243,2904324933,2930269415
2025-06-19 09:59:42,REAL,2904324933,481,2904325414,2930269896
2025-06-19 09:59:44,REAL,2904325414,484,2904325898,2930270380
2025-06-19 09:59:46,REAL,2904325898,10189,2904336087,2930280569
2025-06-19 09:59:48,REAL,2904336087,10517,2904346604,2930291086
2025-06-19 09:59:50,REAL,2904346604,10306,2904356910,2930301392
2025-06-19 09:59:52,REAL,2904356910,10249,2904367159,2930311641
2025-06-19 09:59:54,REAL,2904367159,10317,2904377476,2930321958
2025-06-19 09:59:56,REAL,2904377476,10257,2904387733,2930332215
2025-06-19 09:59:58,FAKE,2904387733,244,2904387977,2930342585
2025-06-19 10:00:00,REAL,2904387977,6884,2904394861,2930349469
2025-06-19 10:00:02,REAL,2904394861,479,2904395340,2930349948
2025-06-19 10:00:04,REAL,2904395340,487,2904395827,2930350435
2025-06-19 10:00:06,REAL,2904395827,486,2904396313,2930350921
2025-06-19 10:00:08,REAL,2904396313,484,2904396797,2930351405
2025-06-19 10:00:10,REAL,2904396797,484,2904397281,2930351889
2025-06-19 10:00:12,REAL,2904397281,482,2904397763,2930352371
2025-06-19 10:00:14,REAL,2904397763,482,2904398245,2930352853
2025-06-19 10:00:16,REAL,2904398245,488,2904398733,2930353341
2025-06-19 10:00:18,FAKE,2904398733,243,2904398976,2930366387
2025-06-19 10:00:20,FAKE,2904398976,241,2904399217,2930376702
2025-06-19 10:00:22,REAL,2904399217,10311,2904409528,2930387013
2025-06-19 10:00:24,FAKE,2904409528,243,2904409771,2930397261
2025-06-19 10:00:26,REAL,2904409771,10314,2904420085,2930407575
2025-06-19 10:00:28,REAL,2904420085,10308,2904430393,2930417883
2025-06-19 10:00:30,REAL,2904430393,10253,2904440646,2930428136
2025-06-19 10:00:32,REAL,2904440646,6294,2904446940,2930434430
2025-06-19 10:00:34,FAKE,2904446940,243,2904447183,2930434907
2025-06-19 10:00:36,FAKE,2904447183,244,2904447427,2930435383
2025-06-19 10:00:38,REAL,2904447427,489,2904447916,2930435872
2025-06-19 10:00:40,REAL,2904447916,478,2904448394,2930436350
2025-06-19 10:00:42,REAL,2904448394,492,2904448886,2930436842
2025-06-19 10:00:44,FAKE,2904448886,241,2904449127,2930437331
2025-06-19 10:00:46,REAL,2904449127,492,2904449619,2930437823
2025-06-19 10:00:48,FAKE,2904449619,241,2904449860,2930438303
2025-06-19 10:00:50,REAL,2904449860,544,2904450404,2930438847
2025-06-19 10:00:52,REAL,2904450404,542,2904450946,2930439389
2025-06-19 10:00:54,REAL,2904450946,483,2904451429,2930439872
2025-06-19 10:00:56,REAL,2904451429,490,2904451919,2930440362
2025-06-19 10:00:58,REAL,2904451919,484,2904452403,2930440846
2025-06-19 10:01:00,FAKE,2904452403,238,2904452641,2930441323
2025-06-19 10:01:02,FAKE,2904452641,238,2904452879,2930441811
2025-06-19 10:01:04,REAL,2904452879,479,2904453358,2930442290
2025-06-19 10:01:06,FAKE,2904453358,241,2904453599,2930442776
2025-06-19 10:01:08,FAKE,2904453599,241,2904453840,2930443262
2025-06-19 10:01:10,REAL,2904453840,486,2904454326,2930443748
2025-06-19 10:01:12,REAL,2904454326,487,2904454813,2930444235
2025-06-19 10:01:14,FAKE,2904454813,241,2904455054,2930444715
2025-06-19 10:01:16,FAKE,2904455054,241,2904455295,2930445259
2025-06-19 10:01:18,REAL,2904455295,493,2904455788,2930445752
2025-06-19 10:01:20,REAL,2904455788,557,2904456345,2930446309
2025-06-19 10:01:22,FAKE,2904456345,243,2904456588,2930462169
2025-06-19 10:01:24,FAKE,2904456588,243,2904456831,2930472481
2025-06-19 10:01:26,REAL,2904456831,10253,2904467084,2930482734
2025-06-19 10:01:28,REAL,2904467084,10259,2904477343,2930492993
2025-06-19 10:01:30,REAL,2904477343,10257,2904487600,2930503250
2025-06-19 10:01:32,REAL,2904487600,10322,2904497922,2930513572
2025-06-19 10:01:34,REAL,2904497922,10258,2904508180,2930523830
2025-06-19 10:01:36,FAKE,2904508180,243,2904508423,2930528799
2025-06-19 10:01:38,REAL,2904508423,543,2904508966,2930529342
2025-06-19 10:01:40,FAKE,2904508966,244,2904509210,2930529826
2025-06-19 10:01:42,REAL,2904509210,8353,2904517563,2930538179
2025-06-19 10:01:44,REAL,2904517563,12695,2904530258,2930550874
2025-06-19 10:01:46,REAL,2904530258,10312,2904540570,2930561186
2025-06-19 10:01:48,FAKE,2904540570,244,2904540814,2930571441
2025-06-19 10:01:50,REAL,2904540814,10258,2904551072,2930581699
2025-06-19 10:01:52,FAKE,2904551072,244,2904551316,2930592009
2025-06-19 10:01:54,FAKE,2904551316,244,2904551560,2930602267
2025-06-19 10:01:56,REAL,2904551560,9591,2904561151,2930611858
2025-06-19 10:01:58,FAKE,2904561151,243,2904561394,2930612342
2025-06-19 10:02:00,REAL,2904561394,489,2904561883,2930612831
2025-06-19 10:02:02,FAKE,2904561883,241,2904562124,2930613374
2025-06-19 10:02:04,FAKE,2904562124,238,2904562362,2930613858
2025-06-19 10:02:06,REAL,2904562362,478,2904562840,2930614336
2025-06-19 10:02:08,FAKE,2904562840,238,2904563078,2930614875
2025-06-19 10:02:10,REAL,2904563078,491,2904563569,2930615366
2025-06-19 10:02:12,REAL,2904563569,483,2904564052,2930615849
2025-06-19 10:02:14,REAL,2904564052,482,2904564534,2930616331
2025-06-19 10:02:16,REAL,2904564534,486,2904565020,2930616817
2025-06-19 10:02:18,REAL,2904565020,485,2904565505,2930617302
2025-06-19 10:02:20,REAL,2904565505,477,2904565982,2930617779
2025-06-19 10:02:22,REAL,2904565982,486,2904566468,2930618265
2025-06-19 10:02:24,REAL,2904566468,482,2904566950,2930618747
2025-06-19 10:02:26,REAL,2904566950,540,2904567490,2930619287
2025-06-19 10:02:28,FAKE,2904567490,238,2904567728,2930619762
2025-06-19 10:02:30,REAL,2904567728,489,2904568217,2930620251
2025-06-19 10:02:32,REAL,2904568217,484,2904568701,2930620735
2025-06-19 10:02:34,REAL,2904568701,484,2904569185,2930621219
2025-06-19 10:02:36,REAL,2904569185,549,2904569734,2930621768
2025-06-19 10:02:38,REAL,2904569734,479,2904570213,2930622247
2025-06-19 10:02:40,FAKE,2904570213,241,2904570454,2930622735
2025-06-19 10:02:42,FAKE,2904570454,243,2904570697,2930623216
2025-06-19 10:02:44,REAL,2904570697,478,2904571175,2930623694
2025-06-19 10:02:46,REAL,2904571175,10329,2904581504,2930634023
2025-06-19 10:02:48,FAKE,2904581504,243,2904581747,2930645527
2025-06-19 10:02:50,REAL,2904581747,10962,2904592709,2930656489
2025-06-19 10:02:52,REAL,2904592709,9648,2904602357,2930666137
2025-06-19 10:02:54,FAKE,2904602357,244,2904602601,2930676391
2025-06-19 10:02:56,REAL,2904602601,10244,2904612845,2930686635
2025-06-19 10:02:58,REAL,2904612845,10255,2904623100,2930696890
2025-06-19 10:03:00,REAL,2904623100,8340,2904631440,2930705230
2025-06-19 10:03:02,FAKE,2904631440,244,2904631684,2930705710
2025-06-19 10:03:04,REAL,2904631684,484,2904632168,2930706194
2025-06-19 10:03:06,FAKE,2904632168,238,2904632406,2930706670
2025-06-19 10:03:08,REAL,2904632406,492,2904632898,2930707162
2025-06-19 10:03:10,FAKE,2904632898,243,2904633141,2930707644
2025-06-19 10:03:12,FAKE,2904633141,241,2904633382,2930708236
2025-06-19 10:03:14,REAL,2904633382,485,2904633867,2930708721
2025-06-19 10:03:16,REAL,2904633867,2740,2904636607,2930711461
2025-06-19 10:03:18,REAL,2904636607,14943,2904651550,2930726404
2025-06-19 10:03:20,FAKE,2904651550,244,2904651794,2930736715
2025-06-19 10:03:22,REAL,2904651794,10258,2904662052,2930746973
2025-06-19 10:03:24,REAL,2904662052,10250,2904672302,2930757223
2025-06-19 10:03:26,REAL,2904672302,10261,2904682563,2930767484
2025-06-19 10:03:28,REAL,2904682563,10249,2904692812,2930777733
2025-06-19 10:03:30,FAKE,2904692812,241,2904693053,2930788049
2025-06-19 10:03:32,FAKE,2904693053,241,2904693294,2930791109
2025-06-19 10:03:34,REAL,2904693294,485,2904693779,2930791594
2025-06-19 10:03:36,REAL,2904693779,536,2904694315,2930792130
2025-06-19 10:03:38,FAKE,2904694315,238,2904694553,2930792616
2025-06-19 10:03:40,FAKE,2904694553,243,2904694796,2930793097
2025-06-19 10:03:42,REAL,2904694796,487,2904695283,2930793584
2025-06-19 10:03:44,REAL,2904695283,543,2904695826,2930794127
2025-06-19 10:03:46,REAL,2904695826,477,2904696303,2930794604
2025-06-19 10:03:48,REAL,2904696303,490,2904696793,2930795094
2025-06-19 10:03:50,FAKE,2904696793,241,2904697034,2930795580
2025-06-19 10:03:52,FAKE,2904697034,241,2904697275,2930796060
2025-06-19 10:03:54,REAL,2904697275,489,2904697764,2930796549
2025-06-19 10:03:56,FAKE,2904697764,244,2904698008,2930797038
2025-06-19 10:03:58,REAL,2904698008,475,2904698483,2930797513
2025-06-19 10:04:00,REAL,2904698483,537,2904699020,2930798050
2025-06-19 10:04:02,REAL,2904699020,490,2904699510,2930798540
2025-06-19 10:04:04,REAL,2904699510,484,2904699994,2930799024
2025-06-19 10:04:06,REAL,2904699994,482,2904700476,2930799506
2025-06-19 10:04:08,FAKE,2904700476,243,2904700719,2930799991
2025-06-19 10:04:10,FAKE,2904700719,238,2904700957,2930800534
2025-06-19 10:04:12,REAL,2904700957,491,2904701448,2930801025
2025-06-19 10:04:14,FAKE,2904701448,241,2904701689,2930801508
2025-06-19 10:04:16,REAL,2904701689,482,2904702171,2930801990
2025-06-19 10:04:18,REAL,2904702171,481,2904702652,2930802471
2025-06-19 10:04:20,FAKE,2904702652,244,2904702896,2930802949
2025-06-19 10:04:22,REAL,2904702896,484,2904703380,2930803433
2025-06-19 10:04:24,FAKE,2904703380,244,2904703624,2930803969
2025-06-19 10:04:26,REAL,2904703624,487,2904704111,2930804456
2025-06-19 10:04:28,FAKE,2904704111,241,2904704352,2930804944
2025-06-19 10:04:30,FAKE,2904704352,243,2904704595,2930805430
2025-06-19 10:04:32,FAKE,2904704595,238,2904704833,2930805924
2025-06-19 10:04:34,REAL,2904704833,481,2904705314,2930806405
2025-06-19 10:04:36,FAKE,2904705314,243,2904705557,2930811273
2025-06-19 10:04:38,REAL,2904705557,11177,2904716734,2930822450
2025-06-19 10:04:40,REAL,2904716734,10255,2904726989,2930832705
2025-06-19 10:04:42,FAKE,2904726989,243,2904727232,2930842949
2025-06-19 10:04:44,FAKE,2904727232,243,2904727475,2930853204
2025-06-19 10:04:46,REAL,2904727475,10370,2904737845,2930863574
2025-06-19 10:04:48,FAKE,2904737845,244,2904738089,2930873832
2025-06-19 10:04:50,FAKE,2904738089,243,2904738332,2930884083
2025-06-19 10:04:52,REAL,2904738332,1608,2904739940,2930885691
2025-06-19 10:04:54,REAL,2904739940,488,2904740428,2930886179
2025-06-19 10:04:56,REAL,2904740428,486,2904740914,2930886665
2025-06-19 10:04:58,REAL,2904740914,482,2904741396,2930887147
2025-06-19 10:05:00,REAL,2904741396,490,2904741886,2930887637
2025-06-19 10:05:02,REAL,2904741886,485,2904742371,2930888122
2025-06-19 10:05:04,FAKE,2904742371,238,2904742609,2930888656
2025-06-19 10:05:06,FAKE,2904742609,244,2904742853,2930889139
2025-06-19 10:05:08,REAL,2904742853,485,2904743338,2930889624
2025-06-19 10:05:10,REAL,2904743338,540,2904743878,2930890164
2025-06-19 10:05:12,REAL,2904743878,487,2904744365,2930890651
2025-06-19 10:05:14,REAL,2904744365,484,2904744849,2930891135
2025-06-19 10:05:16,FAKE,2904744849,243,2904745092,2930891609
2025-06-19 10:05:18,REAL,2904745092,491,2904745583,2930892100
2025-06-19 10:05:20,REAL,2904745583,491,2904746074,2930892591
2025-06-19 10:05:22,FAKE,2904746074,243,2904746317,2930893069
2025-06-19 10:05:24,REAL,2904746317,480,2904746797,2930893549
2025-06-19 10:05:26,FAKE,2904746797,243,2904747040,2930894030
2025-06-19 10:05:28,FAKE,2904747040,241,2904747281,2930894514
2025-06-19 10:05:30,REAL,2904747281,476,2904747757,2930894990
2025-06-19 10:05:32,REAL,2904747757,545,2904748302,2930895535
2025-06-19 10:05:34,REAL,2904748302,484,2904748786,2930896019
2025-06-19 10:05:36,REAL,2904748786,492,2904749278,2930896511
2025-06-19 10:05:38,REAL,2904749278,554,2904749832,2930897065
2025-06-19 10:05:40,FAKE,2904749832,244,2904750076,2930897541
2025-06-19 10:05:42,REAL,2904750076,480,2904750556,2930898021
2025-06-19 10:05:44,REAL,2904750556,482,2904751038,2930898503
2025-06-19 10:05:46,REAL,2904751038,485,2904751523,2930898988
2025-06-19 10:05:48,FAKE,2904751523,238,2904751761,2930899531
2025-06-19 10:05:50,REAL,2904751761,478,2904752239,2930900009
2025-06-19 10:05:52,FAKE,2904752239,243,2904752482,2930900497
2025-06-19 10:05:54,FAKE,2904752482,238,2904752720,2930900984
2025-06-19 10:05:56,REAL,2904752720,482,2904753202,2930901466
2025-06-19 10:05:58,REAL,2904753202,478,2904753680,2930901944
2025-06-19 10:06:00,REAL,2904753680,544,2904754224,2930902488
2025-06-19 10:06:02,REAL,2904754224,490,2904754714,2930902978
2025-06-19 10:06:04,REAL,2904754714,475,2904755189,2930903453
2025-06-19 10:06:06,FAKE,2904755189,244,2904755433,2930903944
2025-06-19 10:06:08,FAKE,2904755433,244,2904755677,2930904423
2025-06-19 10:06:10,REAL,2904755677,481,2904756158,2930904904
2025-06-19 10:06:12,REAL,2904756158,16264,2904772422,2930921168
2025-06-19 10:06:14,REAL,2904772422,10255,2904782677,2930931423
2025-06-19 10:06:16,FAKE,2904782677,241,2904782918,2930941667
2025-06-19 10:06:18,REAL,2904782918,10319,2904793237,2930951986
2025-06-19 10:06:20,REAL,2904793237,10255,2904803492,2930962241
2025-06-19 10:06:22,REAL,2904803492,10256,2904813748,2930972497
2025-06-19 10:06:24,REAL,2904813748,10316,2904824064,2930982813
2025-06-19 10:06:26,REAL,2904824064,5088,2904829152,2930987901
2025-06-19 10:06:28,FAKE,2904829152,241,2904829393,2930988385
2025-06-19 10:06:30,REAL,2904829393,477,2904829870,2930988862
2025-06-19 10:06:32,FAKE,2904829870,244,2904830114,2930989338
2025-06-19 10:06:34,FAKE,2904830114,244,2904830358,2930989823
2025-06-19 10:06:36,FAKE,2904830358,243,2904830601,2930990303
2025-06-19 10:06:38,REAL,2904830601,540,2904831141,2930990843
2025-06-19 10:06:40,FAKE,2904831141,241,2904831382,2930991330
2025-06-19 10:06:42,FAKE,2904831382,243,2904831625,2930991815
2025-06-19 10:06:44,REAL,2904831625,478,2904832103,2930992293
2025-06-19 10:06:46,REAL,2904832103,475,2904832578,2930992768
2025-06-19 10:06:48,REAL,2904832578,483,2904833061,2930993251
2025-06-19 10:06:50,FAKE,2904833061,244,2904833305,2930993737
2025-06-19 10:06:52,REAL,2904833305,485,2904833790,2930994222
2025-06-19 10:06:54,REAL,2904833790,476,2904834266,2930994698
2025-06-19 10:06:56,REAL,2904834266,484,2904834750,2930995182
2025-06-19 10:06:58,FAKE,2904834750,238,2904834988,2930995670
2025-06-19 10:07:00,REAL,2904834988,478,2904835466,2930996148
2025-06-19 10:07:02,REAL,2904835466,481,2904835947,2930996629
2025-06-19 10:07:04,REAL,2904835947,486,2904836433,2930997115
2025-06-19 10:07:06,REAL,2904836433,543,2904836976,2930997658
2025-06-19 10:07:08,REAL,2904836976,475,2904837451,2930998133
2025-06-19 10:07:10,REAL,2904837451,482,2904837933,2930998615
2025-06-19 10:07:12,REAL,2904837933,540,2904838473,2930999155
2025-06-19 10:07:14,REAL,2904838473,483,2904838956,2930999638
2025-06-19 10:07:16,REAL,2904838956,485,2904839441,2931000123
2025-06-19 10:07:18,FAKE,2904839441,238,2904839679,2931000599
2025-06-19 10:07:20,REAL,2904839679,480,2904840159,2931001079
2025-06-19 10:07:22,REAL,2904840159,483,2904840642,2931001562
2025-06-19 10:07:24,REAL,2904840642,483,2904841125,2931002045
2025-06-19 10:07:26,REAL,2904841125,476,2904841601,2931002521
2025-06-19 10:07:28,REAL,2904841601,485,2904842086,2931003006
2025-06-19 10:07:30,REAL,2904842086,480,2904842566,2931003486
2025-06-19 10:07:32,FAKE,2904842566,244,2904842810,2931003974
2025-06-19 10:07:34,REAL,2904842810,486,2904843296,2931004460
2025-06-19 10:07:36,REAL,2904843296,486,2904843782,2931004946
2025-06-19 10:07:38,REAL,2904843782,482,2904844264,2931005428
2025-06-19 10:07:40,REAL,2904844264,7882,2904852146,2931013310
2025-06-19 10:07:42,FAKE,2904852146,238,2904852384,2931024280
2025-06-19 10:07:44,REAL,2904852384,10379,2904862763,2931034659
2025-06-19 10:07:46,REAL,2904862763,10255,2904873018,2931044914
2025-06-19 10:07:48,REAL,2904873018,10313,2904883331,2931055227
2025-06-19 10:07:50,FAKE,2904883331,244,2904883575,2931065476
2025-06-19 10:07:52,FAKE,2904883575,244,2904883819,2931075736
2025-06-19 10:07:54,REAL,2904883819,8933,2904892752,2931084669
2025-06-19 10:07:56,REAL,2904892752,487,2904893239,2931085156
2025-06-19 10:07:58,FAKE,2904893239,244,2904893483,2931085643
2025-06-19 10:08:00,FAKE,2904893483,241,2904893724,2931086123
2025-06-19 10:08:02,REAL,2904893724,477,2904894201,2931086600
2025-06-19 10:08:04,REAL,2904894201,483,2904894684,2931087083
2025-06-19 10:08:06,REAL,2904894684,482,2904895166,2931087565
2025-06-19 10:08:08,FAKE,2904895166,243,2904895409,2931088044
2025-06-19 10:08:10,FAKE,2904895409,244,2904895653,2931088531
2025-06-19 10:08:12,REAL,2904895653,475,2904896128,2931089006
2025-06-19 10:08:14,REAL,2904896128,488,2904896616,2931089494
2025-06-19 10:08:16,REAL,2904896616,536,2904897152,2931090030
2025-06-19 10:08:18,FAKE,2904897152,238,2904897390,2931090510
2025-06-19 10:08:20,REAL,2904897390,483,2904897873,2931090993
2025-06-19 10:08:22,REAL,2904897873,480,2904898353,2931091473
2025-06-19 10:08:24,REAL,2904898353,543,2904898896,2931092016
2025-06-19 10:08:26,FAKE,2904898896,241,2904899137,2931092501
2025-06-19 10:08:28,FAKE,2904899137,243,2904899380,2931092986
2025-06-19 10:08:30,FAKE,2904899380,244,2904899624,2931093468
2025-06-19 10:08:32,REAL,2904899624,486,2904900110,2931093954
2025-06-19 10:08:34,FAKE,2904900110,244,2904900354,2931094435
2025-06-19 10:08:36,REAL,2904900354,487,2904900841,2931094922
2025-06-19 10:08:38,FAKE,2904900841,238,2904901079,2931095405
2025-06-19 10:08:40,REAL,2904901079,479,2904901558,2931095884
2025-06-19 10:08:42,REAL,2904901558,482,2904902040,2931096366
2025-06-19 10:08:44,REAL,2904902040,479,2904902519,2931096845
2025-06-19 10:08:46,REAL,2904902519,476,2904902995,2931097321
2025-06-19 10:08:48,FAKE,2904902995,244,2904903239,2931097809
2025-06-19 10:08:50,FAKE,2904903239,241,2904903480,2931098351
2025-06-19 10:08:52,REAL,2904903480,494,2904903974,2931098845
2025-06-19 10:08:54,REAL,2904903974,479,2904904453,2931099324
2025-06-19 10:08:56,FAKE,2904904453,241,2904904694,2931099802
2025-06-19 10:08:58,REAL,2904904694,483,2904905177,2931100285
2025-06-19 10:09:00,FAKE,2904905177,241,2904905418,2931100778
2025-06-19 10:09:02,REAL,2904905418,488,2904905906,2931101266
2025-06-19 10:09:04,REAL,2904905906,536,2904906442,2931101802
2025-06-19 10:09:06,FAKE,2904906442,238,2904906680,2931102286
2025-06-19 10:09:08,REAL,2904906680,481,2904907161,2931102767
2025-06-19 10:09:10,REAL,2904907161,476,2904907637,2931103243
2025-06-19 10:09:12,REAL,2904907637,484,2904908121,2931103727
2025-06-19 10:09:14,REAL,2904908121,483,2904908604,2931104210
2025-06-19 10:09:16,REAL,2904908604,488,2904909092,2931104698
2025-06-19 10:09:18,FAKE,2904909092,243,2904909335,2931105181
2025-06-19 10:09:20,REAL,2904909335,487,2904909822,2931105668
2025-06-19 10:09:22,REAL,2904909822,493,2904910315,2931106161
2025-06-19 10:09:24,REAL,2904910315,545,2904910860,2931106706
2025-06-19 10:09:26,REAL,2904910860,489,2904911349,2931107195
2025-06-19 10:09:28,REAL,2904911349,476,2904911825,2931107671
2025-06-19 10:09:30,REAL,2904911825,478,2904912303,2931108149
2025-06-19 10:09:32,REAL,2904912303,481,2904912784,2931108630
2025-06-19 10:09:34,REAL,2904912784,489,2904913273,2931109119
2025-06-19 10:09:36,REAL,2904913273,482,2904913755,2931109601
2025-06-19 10:09:38,REAL,2904913755,478,2904914233,2931110079
2025-06-19 10:09:40,REAL,2904914233,538,2904914771,2931110617
2025-06-19 10:09:42,REAL,2904914771,487,2904915258,2931111104
2025-06-19 10:09:44,REAL,2904915258,484,2904915742,2931111588
2025-06-19 10:09:46,REAL,2904915742,488,2904916230,2931112076
2025-06-19 10:09:48,REAL,2904916230,485,2904916715,2931112561
2025-06-19 10:09:50,REAL,2904916715,482,2904917197,2931113043
2025-06-19 10:09:52,FAKE,2904917197,241,2904917438,2931113528
2025-06-19 10:09:54,REAL,2904917438,484,2904917922,2931114012
2025-06-19 10:09:56,FAKE,2904917922,238,2904918160,2931114497
2025-06-19 10:09:58,FAKE,2904918160,243,2904918403,2931115030
2025-06-19 10:10:00,REAL,2904918403,491,2904918894,2931115521
2025-06-19 10:10:02,FAKE,2904918894,243,2904919137,2931116005
2025-06-19 10:10:04,REAL,2904919137,489,2904919626,2931116494
2025-06-19 10:10:06,REAL,2904919626,485,2904920111,2931116979
2025-06-19 10:10:08,FAKE,2904920111,244,2904920355,2931117467
2025-06-19 10:10:10,REAL,2904920355,483,2904920838,2931117950
2025-06-19 10:10:12,REAL,2904920838,485,2904921323,2931118435
2025-06-19 10:10:14,FAKE,2904921323,238,2904921561,2931118920
2025-06-19 10:10:16,REAL,2904921561,479,2904922040,2931119399
2025-06-19 10:10:18,REAL,2904922040,10520,2904932560,2931129919
2025-06-19 10:10:20,REAL,2904932560,10310,2904942870,2931140229
2025-06-19 10:10:22,REAL,2904942870,10258,2904953128,2931150487
2025-06-19 10:10:24,FAKE,2904953128,241,2904953369,2931160736
2025-06-19 10:10:26,REAL,2904953369,10316,2904963685,2931171052
2025-06-19 10:10:28,REAL,2904963685,10254,2904973939,2931181306
2025-06-19 10:10:30,FAKE,2904973939,244,2904974183,2931191567
2025-06-19 10:10:32,REAL,2904974183,6488,2904980671,2931198055
2025-06-19 10:10:34,FAKE,2904980671,244,2904980915,2931198540
2025-06-19 10:10:36,REAL,2904980915,479,2904981394,2931199019
2025-06-19 10:10:38,FAKE,2904981394,241,2904981635,2931199505
2025-06-19 10:10:40,REAL,2904981635,479,2904982114,2931199984
2025-06-19 10:10:42,REAL,2904982114,487,2904982601,2931200471
2025-06-19 10:10:44,FAKE,2904982601,241,2904982842,2931200959
2025-06-19 10:10:46,REAL,2904982842,478,2904983320,2931201437
2025-06-19 10:10:48,FAKE,2904983320,238,2904983558,2931201924
2025-06-19 10:10:50,REAL,2904983558,14432,2904997990,2931216356
2025-06-19 10:10:52,REAL,2904997990,10326,2905008316,2931226682
2025-06-19 10:10:54,REAL,2905008316,10252,2905018568,2931236934
2025-06-19 10:10:56,FAKE,2905018568,244,2905018812,2931247187
2025-06-19 10:10:58,REAL,2905018812,10317,2905029129,2931257504
2025-06-19 10:11:00,FAKE,2905029129,241,2905029370,2931267812
2025-06-19 10:11:02,REAL,2905029370,10250,2905039620,2931278062
2025-06-19 10:11:04,REAL,2905039620,5834,2905045454,2931283896
2025-06-19 10:11:06,FAKE,2905045454,238,2905045692,2931284381
2025-06-19 10:11:08,FAKE,2905045692,238,2905045930,2931284866
2025-06-19 10:11:10,REAL,2905045930,476,2905046406,2931285342
2025-06-19 10:11:12,FAKE,2905046406,243,2905046649,2931285829
2025-06-19 10:11:14,FAKE,2905046649,243,2905046892,2931286304
2025-06-19 10:11:16,FAKE,2905046892,243,2905047135,2931286787
2025-06-19 10:11:18,REAL,2905047135,478,2905047613,2931287265
2025-06-19 10:11:20,REAL,2905047613,478,2905048091,2931287743
2025-06-19 10:11:22,REAL,2905048091,11777,2905059868,2931299520
2025-06-19 10:11:24,REAL,2905059868,10710,2905070578,2931310230
2025-06-19 10:11:26,FAKE,2905070578,241,2905070819,2931320085
2025-06-19 10:11:28,FAKE,2905070819,243,2905071062,2931330337
2025-06-19 10:11:30,REAL,2905071062,10255,2905081317,2931340592
2025-06-19 10:11:32,REAL,2905081317,10249,2905091566,2931350841
2025-06-19 10:11:34,REAL,2905091566,10374,2905101940,2931361215
2025-06-19 10:11:36,REAL,2905101940,5172,2905107112,2931366387
2025-06-19 10:11:38,REAL,2905107112,484,2905107596,2931366871
2025-06-19 10:11:40,REAL,2905107596,242,2905107838,2931367113
2025-06-19 10:11:42,FAKE,2905107838,238,2905108076,2931374007
2025-06-19 10:11:44,REAL,2905108076,11106,2905119182,2931385113
2025-06-19 10:11:46,REAL,2905119182,10248,2905129430,2931395361
2025-06-19 10:11:48,FAKE,2905129430,243,2905129673,2931405611
2025-06-19 10:11:50,REAL,2905129673,10254,2905139927,2931415865
2025-06-19 10:11:52,REAL,2905139927,10313,2905150240,2931426178
2025-06-19 10:11:54,FAKE,2905150240,241,2905150481,2931436434
2025-06-19 10:11:56,REAL,2905150481,9725,2905160206,2931446159
2025-06-19 10:11:58,REAL,2905160206,483,2905160689,2931446642
2025-06-19 10:12:00,REAL,2905160689,474,2905161163,2931447116
2025-06-19 10:12:02,REAL,2905161163,1284,2905162447,2931448400
2025-06-19 10:12:04,FAKE,2905162447,243,2905162690,2931460056
2025-06-19 10:12:06,REAL,2905162690,10250,2905172940,2931470306
2025-06-19 10:12:08,REAL,2905172940,10311,2905183251,2931480617
2025-06-19 10:12:10,REAL,2905183251,10256,2905193507,2931490873
2025-06-19 10:12:12,FAKE,2905193507,241,2905193748,2931501189
2025-06-19 10:12:14,REAL,2905193748,10254,2905204002,2931511443
2025-06-19 10:12:16,REAL,2905204002,10321,2905214323,2931521764
2025-06-19 10:12:18,REAL,2905214323,4439,2905218762,2931526203
2025-06-19 10:12:20,FAKE,2905218762,244,2905219006,2931526685
2025-06-19 10:12:22,REAL,2905219006,487,2905219493,2931527172
2025-06-19 10:12:24,REAL,2905219493,478,2905219971,2931527650
2025-06-19 10:12:26,REAL,2905219971,481,2905220452,2931528131
2025-06-19 10:12:28,REAL,2905220452,491,2905220943,2931528622
2025-06-19 10:12:30,REAL,2905220943,550,2905221493,2931529172
2025-06-19 10:12:32,REAL,2905221493,481,2905221974,2931529653
2025-06-19 10:12:34,FAKE,2905221974,244,2905222218,2931530136
2025-06-19 10:12:36,REAL,2905222218,484,2905222702,2931530620
2025-06-19 10:12:38,REAL,2905222702,479,2905223181,2931531099
2025-06-19 10:12:40,REAL,2905223181,478,2905223659,2931531577
2025-06-19 10:12:42,REAL,2905223659,482,2905224141,2931532059
2025-06-19 10:12:44,REAL,2905224141,482,2905224623,2931532541
2025-06-19 10:12:46,REAL,2905224623,483,2905225106,2931533024
2025-06-19 10:12:48,REAL,2905225106,541,2905225647,2931533565
2025-06-19 10:12:50,REAL,2905225647,480,2905226127,2931534045
2025-06-19 10:12:52,REAL,2905226127,489,2905226616,2931534534
2025-06-19 10:12:54,FAKE,2905226616,241,2905226857,2931535016
2025-06-19 10:12:56,REAL,2905226857,9205,2905236062,2931544221
2025-06-19 10:12:58,REAL,2905236062,12095,2905248157,2931556316
2025-06-19 10:13:00,FAKE,2905248157,241,2905248398,2931566573
2025-06-19 10:13:02,FAKE,2905248398,243,2905248641,2931576830
2025-06-19 10:13:04,REAL,2905248641,10316,2905258957,2931587146
2025-06-19 10:13:06,REAL,2905258957,10256,2905269213,2931597402
2025-06-19 10:13:08,REAL,2905269213,10245,2905279458,2931607647
2025-06-19 10:13:10,FAKE,2905279458,238,2905279696,2931616187
2025-06-19 10:13:12,FAKE,2905279696,243,2905279939,2931616675
2025-06-19 10:13:14,FAKE,2905279939,241,2905280180,2931617162
2025-06-19 10:13:16,FAKE,2905280180,243,2905280423,2931617642
2025-06-19 10:13:18,REAL,2905280423,485,2905280908,2931618127
2025-06-19 10:13:20,FAKE,2905280908,244,2905281152,2931618614
2025-06-19 10:13:22,FAKE,2905281152,244,2905281396,2931619098
2025-06-19 10:13:24,REAL,2905281396,600,2905281996,2931619698
2025-06-19 10:13:26,REAL,2905281996,483,2905282479,2931620181
2025-06-19 10:13:28,FAKE,2905282479,241,2905282720,2931620659
2025-06-19 10:13:30,FAKE,2905282720,238,2905282958,2931621137
2025-06-19 10:13:32,REAL,2905282958,481,2905283439,2931621618
2025-06-19 10:13:34,FAKE,2905283439,238,2905283677,2931622107
2025-06-19 10:13:36,REAL,2905283677,474,2905284151,2931622581
2025-06-19 10:13:38,FAKE,2905284151,244,2905284395,2931631320
2025-06-19 10:13:40,REAL,2905284395,10518,2905294913,2931641838
2025-06-19 10:13:42,REAL,2905294913,10313,2905305226,2931652151
2025-06-19 10:13:44,FAKE,2905305226,244,2905305470,2931662404
2025-06-19 10:13:46,REAL,2905305470,10255,2905315725,2931672659
2025-06-19 10:13:48,FAKE,2905315725,241,2905315966,2931682920
2025-06-19 10:13:50,REAL,2905315966,10254,2905326220,2931693174
2025-06-19 10:13:52,REAL,2905326220,8003,2905334223,2931701177
2025-06-19 10:13:54,REAL,2905334223,493,2905334716,2931701670
2025-06-19 10:13:56,FAKE,2905334716,241,2905334957,2931702149
2025-06-19 10:13:58,REAL,2905334957,485,2905335442,2931702634
2025-06-19 10:14:00,REAL,2905335442,533,2905335975,2931703167
2025-06-19 10:14:02,FAKE,2905335975,244,2905336219,2931703660
2025-06-19 10:14:04,REAL,2905336219,483,2905336702,2931704143
2025-06-19 10:14:06,FAKE,2905336702,243,2905336945,2931704681
2025-06-19 10:14:08,REAL,2905336945,485,2905337430,2931705166
2025-06-19 10:14:10,REAL,2905337430,9870,2905347300,2931715036
2025-06-19 10:14:12,FAKE,2905347300,244,2905347544,2931725556
2025-06-19 10:14:14,REAL,2905347544,10249,2905357793,2931735805
2025-06-19 10:14:16,REAL,2905357793,10254,2905368047,2931746059
2025-06-19 10:14:18,FAKE,2905368047,243,2905368290,2931756370
2025-06-19 10:14:20,REAL,2905368290,10253,2905378543,2931766623
2025-06-19 10:14:22,REAL,2905378543,10259,2905388802,2931776882
2025-06-19 10:14:24,FAKE,2905388802,244,2905389046,2931784297
2025-06-19 10:14:26,FAKE,2905389046,244,2905389290,2931784779
2025-06-19 10:14:28,REAL,2905389290,485,2905389775,2931785264
2025-06-19 10:14:30,FAKE,2905389775,243,2905390018,2931789444
2025-06-19 10:14:32,REAL,2905390018,11245,2905401263,2931800689
2025-06-19 10:14:34,REAL,2905401263,10323,2905411586,2931811012
2025-06-19 10:14:36,REAL,2905411586,10314,2905421900,2931821326
2025-06-19 10:14:38,REAL,2905421900,10257,2905432157,2931831583
2025-06-19 10:14:40,REAL,2905432157,10323,2905442480,2931841906
2025-06-19 10:14:42,REAL,2905442480,10255,2905452735,2931852161
2025-06-19 10:14:44,FAKE,2905452735,244,2905452979,2931862409
2025-06-19 10:14:46,REAL,2905452979,2135,2905455114,2931864544
2025-06-19 10:14:48,REAL,2905455114,484,2905455598,2931865028
2025-06-19 10:14:50,REAL,2905455598,483,2905456081,2931865511
2025-06-19 10:14:52,REAL,2905456081,488,2905456569,2931865999
2025-06-19 10:14:54,REAL,2905456569,482,2905457051,2931866481
2025-06-19 10:14:56,REAL,2905457051,483,2905457534,2931866964
2025-06-19 10:14:58,REAL,2905457534,530,2905458064,2931867494
2025-06-19 10:15:00,REAL,2905458064,484,2905458548,2931867978
2025-06-19 10:15:02,REAL,2905458548,5772,2905464320,2931873750
2025-06-19 10:15:04,FAKE,2905464320,244,2905464564,2931887100
2025-06-19 10:15:06,FAKE,2905464564,243,2905464807,2931897344
2025-06-19 10:15:08,REAL,2905464807,10319,2905475126,2931907663
2025-06-19 10:15:10,REAL,2905475126,10254,2905485380,2931917917
2025-06-19 10:15:12,REAL,2905485380,10257,2905495637,2931928174
2025-06-19 10:15:14,REAL,2905495637,10371,2905506008,2931938545
2025-06-19 10:15:16,REAL,2905506008,10251,2905516259,2931948796
2025-06-19 10:15:18,REAL,2905516259,1466,2905517725,2931950262
2025-06-19 10:15:20,REAL,2905517725,484,2905518209,2931950746
2025-06-19 10:15:22,FAKE,2905518209,243,2905518452,2931951224
2025-06-19 10:15:24,REAL,2905518452,485,2905518937,2931951709
2025-06-19 10:15:26,REAL,2905518937,489,2905519426,2931952198
2025-06-19 10:15:28,FAKE,2905519426,243,2905519669,2931952684
2025-06-19 10:15:30,FAKE,2905519669,243,2905519912,2931953218
2025-06-19 10:15:32,REAL,2905519912,483,2905520395,2931953701
2025-06-19 10:15:34,REAL,2905520395,485,2905520880,2931954186
2025-06-19 10:15:36,REAL,2905520880,476,2905521356,2931954662
2025-06-19 10:15:38,FAKE,2905521356,238,2905521594,2931955145
2025-06-19 10:15:40,FAKE,2905521594,238,2905521832,2931969968
2025-06-19 10:15:42,REAL,2905521832,10243,2905532075,2931980211
2025-06-19 10:15:44,FAKE,2905532075,238,2905532313,2931990531
2025-06-19 10:15:46,REAL,2905532313,10261,2905542574,2932000792
2025-06-19 10:15:48,FAKE,2905542574,243,2905542817,2932011045
2025-06-19 10:15:50,FAKE,2905542817,244,2905543061,2932021428
2025-06-19 10:15:52,REAL,2905543061,10249,2905553310,2932031677
2025-06-19 10:15:54,REAL,2905553310,5693,2905559003,2932037370
2025-06-19 10:15:56,REAL,2905559003,476,2905559479,2932037846
2025-06-19 10:15:58,FAKE,2905559479,243,2905559722,2932038328
2025-06-19 10:16:00,REAL,2905559722,5908,2905565630,2932044236
2025-06-19 10:16:02,REAL,2905565630,10784,2905576414,2932055020
2025-06-19 10:16:04,REAL,2905576414,10251,2905586665,2932065271
2025-06-19 10:16:06,REAL,2905586665,10255,2905596920,2932075526
2025-06-19 10:16:08,REAL,2905596920,10311,2905607231,2932085837
2025-06-19 10:16:10,FAKE,2905607231,238,2905607469,2932096085
2025-06-19 10:16:12,REAL,2905607469,10254,2905617723,2932106339
2025-06-19 10:16:14,FAKE,2905617723,243,2905617966,2932116647
2025-06-19 10:16:16,REAL,2905617966,483,2905618449,2932117130
2025-06-19 10:16:18,REAL,2905618449,486,2905618935,2932117616
2025-06-19 10:16:20,FAKE,2905618935,238,2905619173,2932118109
2025-06-19 10:16:22,REAL,2905619173,483,2905619656,2932118592
2025-06-19 10:16:24,FAKE,2905619656,241,2905619897,2932119081
2025-06-19 10:16:26,REAL,2905619897,484,2905620381,2932119565
2025-06-19 10:16:28,REAL,2905620381,543,2905620924,2932120108
2025-06-19 10:16:30,REAL,2905620924,485,2905621409,2932120593
2025-06-19 10:16:32,REAL,2905621409,480,2905621889,2932121073
2025-06-19 10:16:34,REAL,2905621889,494,2905622383,2932121567
2025-06-19 10:16:36,FAKE,2905622383,241,2905622624,2932122046
2025-06-19 10:16:38,FAKE,2905622624,243,2905622867,2932122530
2025-06-19 10:16:40,REAL,2905622867,535,2905623402,2932123065
2025-06-19 10:16:42,REAL,2905623402,487,2905623889,2932123552
2025-06-19 10:16:44,REAL,2905623889,485,2905624374,2932124037
2025-06-19 10:16:46,FAKE,2905624374,243,2905624617,2932124525
2025-06-19 10:16:48,REAL,2905624617,474,2905625091,2932124999
2025-06-19 10:16:50,REAL,2905625091,484,2905625575,2932125483
2025-06-19 10:16:52,REAL,2905625575,487,2905626062,2932125970
2025-06-19 10:16:54,REAL,2905626062,494,2905626556,2932126464
2025-06-19 10:16:56,REAL,2905626556,481,2905627037,2932126945
2025-06-19 10:16:58,REAL,2905627037,533,2905627570,2932127478
2025-06-19 10:17:00,REAL,2905627570,482,2905628052,2932127960
2025-06-19 10:17:02,REAL,2905628052,478,2905628530,2932128438
2025-06-19 10:17:04,REAL,2905628530,9385,2905637915,2932137823
2025-06-19 10:17:06,FAKE,2905637915,243,2905638158,2932150907
2025-06-19 10:17:08,REAL,2905638158,10257,2905648415,2932161164
2025-06-19 10:17:10,FAKE,2905648415,238,2905648653,2932171419
2025-06-19 10:17:12,REAL,2905648653,10318,2905658971,2932181737
2025-06-19 10:17:14,REAL,2905658971,10259,2905669230,2932191996
2025-06-19 10:17:16,REAL,2905669230,10260,2905679490,2932202256
2025-06-19 10:17:18,REAL,2905679490,9072,2905688562,2932211328
2025-06-19 10:17:20,REAL,2905688562,484,2905689046,2932211812
2025-06-19 10:17:22,FAKE,2905689046,238,2905689284,2932212295
2025-06-19 10:17:24,FAKE,2905689284,244,2905689528,2932212774
2025-06-19 10:17:26,FAKE,2905689528,243,2905689771,2932213258
2025-06-19 10:17:28,FAKE,2905689771,238,2905690009,2932213802
2025-06-19 10:17:30,REAL,2905690009,482,2905690491,2932214284
2025-06-19 10:17:32,FAKE,2905690491,241,2905690732,2932214762
2025-06-19 10:17:34,REAL,2905690732,476,2905691208,2932215238
2025-06-19 10:17:36,FAKE,2905691208,244,2905691452,2932225096
2025-06-19 10:17:38,REAL,2905691452,11763,2905703215,2932236859
2025-06-19 10:17:40,REAL,2905703215,10313,2905713528,2932247172
2025-06-19 10:17:42,REAL,2905713528,10252,2905723780,2932257424
2025-06-19 10:17:44,REAL,2905723780,10315,2905734095,2932267739
2025-06-19 10:17:46,REAL,2905734095,10251,2905744346,2932277990
2025-06-19 10:17:48,REAL,2905744346,10318,2905754664,2932288308
2025-06-19 10:17:50,REAL,2905754664,8337,2905763001,2932296645
2025-06-19 10:17:52,FAKE,2905763001,243,2905763244,2932297184
2025-06-19 10:17:54,REAL,2905763244,491,2905763735,2932297675
2025-06-19 10:17:56,REAL,2905763735,490,2905764225,2932298165
2025-06-19 10:17:58,REAL,2905764225,491,2905764716,2932298656
2025-06-19 10:18:00,REAL,2905764716,486,2905765202,2932299142
2025-06-19 10:18:02,REAL,2905765202,480,2905765682,2932299622
2025-06-19 10:18:04,REAL,2905765682,479,2905766161,2932300101
2025-06-19 10:18:06,FAKE,2905766161,243,2905766404,2932300592
2025-06-19 10:18:08,REAL,2905766404,8801,2905775205,2932309393
2025-06-19 10:18:10,REAL,2905775205,10780,2905785985,2932320173
2025-06-19 10:18:12,REAL,2905785985,10313,2905796298,2932330486
2025-06-19 10:18:14,REAL,2905796298,10256,2905806554,2932340742
2025-06-19 10:18:16,REAL,2905806554,10313,2905816867,2932351055
2025-06-19 10:18:18,REAL,2905816867,10312,2905827179,2932361367
2025-06-19 10:18:20,REAL,2905827179,10258,2905837437,2932371625
2025-06-19 10:18:22,REAL,2905837437,7752,2905845189,2932379377
2025-06-19 10:18:24,REAL,2905845189,477,2905845666,2932379854
2025-06-19 10:18:26,REAL,2905845666,492,2905846158,2932380346
2025-06-19 10:18:28,REAL,2905846158,488,2905846646,2932380834
2025-06-19 10:18:30,REAL,2905846646,494,2905847140,2932381328
2025-06-19 10:18:32,REAL,2905847140,488,2905847628,2932381816
2025-06-19 10:18:34,REAL,2905847628,486,2905848114,2932382302
2025-06-19 10:18:36,REAL,2905848114,488,2905848602,2932382790
2025-06-19 10:18:38,REAL,2905848602,486,2905849088,2932383276
2025-06-19 10:18:40,REAL,2905849088,538,2905849626,2932383814
2025-06-19 10:18:42,REAL,2905849626,487,2905850113,2932384301
2025-06-19 10:18:44,REAL,2905850113,480,2905850593,2932384781
2025-06-19 10:18:46,REAL,2905850593,485,2905851078,2932385266
2025-06-19 10:18:48,REAL,2905851078,481,2905851559,2932385747
2025-06-19 10:18:50,REAL,2905851559,492,2905852051,2932386239
2025-06-19 10:18:52,REAL,2905852051,482,2905852533,2932386721
2025-06-19 10:18:54,REAL,2905852533,490,2905853023,2932387211
2025-06-19 10:18:56,FAKE,2905853023,243,2905853266,2932387700
2025-06-19 10:18:58,FAKE,2905853266,238,2905853504,2932388239
2025-06-19 10:19:00,REAL,2905853504,4730,2905858234,2932392969
2025-06-19 10:19:02,FAKE,2905858234,244,2905858478,2932404400
2025-06-19 10:19:04,REAL,2905858478,10260,2905868738,2932414660
2025-06-19 10:19:06,FAKE,2905868738,244,2905868982,2932424973
2025-06-19 10:19:08,REAL,2905868982,10249,2905879231,2932435222
2025-06-19 10:19:10,REAL,2905879231,10251,2905889482,2932445473
2025-06-19 10:19:12,FAKE,2905889482,241,2905889723,2932455793
2025-06-19 10:19:14,REAL,2905889723,10251,2905899974,2932466044
2025-06-19 10:19:16,REAL,2905899974,1861,2905901835,2932467905
2025-06-19 10:19:18,REAL,2905901835,474,2905902309,2932468379
2025-06-19 10:19:20,FAKE,2905902309,241,2905902550,2932468867
2025-06-19 10:19:22,REAL,2905902550,485,2905903035,2932469352
2025-06-19 10:19:24,REAL,2905903035,479,2905903514,2932469831
2025-06-19 10:19:26,FAKE,2905903514,243,2905903757,2932470318
2025-06-19 10:19:28,REAL,2905903757,544,2905904301,2932470862
2025-06-19 10:19:30,REAL,2905904301,487,2905904788,2932471349
2025-06-19 10:19:32,REAL,2905904788,482,2905905270,2932471831
2025-06-19 10:19:34,REAL,2905905270,489,2905905759,2932472320
2025-06-19 10:19:36,REAL,2905905759,483,2905906242,2932472803
2025-06-19 10:19:38,FAKE,2905906242,244,2905906486,2932473288
2025-06-19 10:19:40,FAKE,2905906486,238,2905906724,2932473776
2025-06-19 10:19:42,FAKE,2905906724,244,2905906968,2932474259
2025-06-19 10:19:44,REAL,2905906968,479,2905907447,2932474738
2025-06-19 10:19:46,REAL,2905907447,475,2905907922,2932475213
2025-06-19 10:19:48,REAL,2905907922,478,2905908400,2932475691
2025-06-19 10:19:50,REAL,2905908400,537,2905908937,2932476228
2025-06-19 10:19:52,FAKE,2905908937,243,2905909180,2932476759
2025-06-19 10:19:54,REAL,2905909180,492,2905909672,2932477251
2025-06-19 10:19:56,FAKE,2905909672,243,2905909915,2932477734
2025-06-19 10:19:58,REAL,2905909915,479,2905910394,2932478213
2025-06-19 10:20:00,REAL,2905910394,486,2905910880,2932478699
2025-06-19 10:20:02,FAKE,2905910880,238,2905911118,2932479185
2025-06-19 10:20:04,FAKE,2905911118,238,2905911356,2932485424
2025-06-19 10:20:06,FAKE,2905911356,241,2905911597,2932496874
2025-06-19 10:20:08,REAL,2905911597,10254,2905921851,2932507128
2025-06-19 10:20:10,REAL,2905921851,10244,2905932095,2932517372
2025-06-19 10:20:12,FAKE,2905932095,241,2905932336,2932527688
2025-06-19 10:20:14,REAL,2905932336,10247,2905942583,2932537935
2025-06-19 10:20:16,REAL,2905942583,10302,2905952885,2932548237
2025-06-19 10:20:18,REAL,2905952885,10251,2905963136,2932558488
2025-06-19 10:20:20,REAL,2905963136,614,2905963750,2932559102
2025-06-19 10:20:22,REAL,2905963750,481,2905964231,2932559583
2025-06-19 10:20:24,FAKE,2905964231,241,2905964472,2932560067
2025-06-19 10:20:26,FAKE,2905964472,241,2905964713,2932560552
2025-06-19 10:20:28,REAL,2905964713,491,2905965204,2932561043
2025-06-19 10:20:30,REAL,2905965204,484,2905965688,2932561527
2025-06-19 10:20:32,FAKE,2905965688,244,2905965932,2932562012
2025-06-19 10:20:34,REAL,2905965932,486,2905966418,2932562498
2025-06-19 10:20:36,REAL,2905966418,6897,2905973315,2932569395
2025-06-19 10:20:38,FAKE,2905973315,243,2905973558,2932580107
2025-06-19 10:20:40,REAL,2905973558,10250,2905983808,2932590357
2025-06-19 10:20:42,FAKE,2905983808,238,2905984046,2932600670
2025-06-19 10:20:44,REAL,2905984046,10249,2905994295,2932610919
2025-06-19 10:20:46,REAL,2905994295,10248,2906004543,2932621167
2025-06-19 10:20:48,REAL,2906004543,10254,2906014797,2932631421
2025-06-19 10:20:50,REAL,2906014797,9852,2906024649,2932641273
2025-06-19 10:20:52,REAL,2906024649,481,2906025130,2932641754
2025-06-19 10:20:54,REAL,2906025130,475,2906025605,2932642229
2025-06-19 10:20:56,REAL,2906025605,487,2906026092,2932642716
2025-06-19 10:20:58,FAKE,2906026092,238,2906026330,2932643202
2025-06-19 10:21:00,REAL,2906026330,475,2906026805,2932643677
2025-06-19 10:21:02,REAL,2906026805,476,2906027281,2932644153
2025-06-19 10:21:04,REAL,2906027281,488,2906027769,2932644641
2025-06-19 10:21:06,REAL,2906027769,537,2906028306,2932645178
2025-06-19 10:21:08,REAL,2906028306,484,2906028790,2932645662
2025-06-19 10:21:10,REAL,2906028790,489,2906029279,2932646151
2025-06-19 10:21:12,REAL,2906029279,485,2906029764,2932646636
2025-06-19 10:21:14,REAL,2906029764,483,2906030247,2932647119
2025-06-19 10:21:16,REAL,2906030247,484,2906030731,2932647603
2025-06-19 10:21:18,REAL,2906030731,485,2906031216,2932648088
2025-06-19 10:21:20,FAKE,2906031216,241,2906031457,2932648565
2025-06-19 10:21:22,REAL,2906031457,487,2906031944,2932649052
2025-06-19 10:21:24,REAL,2906031944,486,2906032430,2932649538
2025-06-19 10:21:26,FAKE,2906032430,244,2906032674,2932650076
2025-06-19 10:21:28,REAL,2906032674,492,2906033166,2932650568
2025-06-19 10:21:30,REAL,2906033166,475,2906033641,2932651043
2025-06-19 10:21:32,REAL,2906033641,485,2906034126,2932651528
2025-06-19 10:21:34,REAL,2906034126,489,2906034615,2932652017
2025-06-19 10:21:36,REAL,2906034615,483,2906035098,2932652500
2025-06-19 10:21:38,FAKE,2906035098,244,2906035342,2932652992
2025-06-19 10:21:40,REAL,2906035342,8292,2906043634,2932661284
2025-06-19 10:21:42,FAKE,2906043634,238,2906043872,2932671928
2025-06-19 10:21:44,REAL,2906043872,10246,2906054118,2932682174
2025-06-19 10:21:46,FAKE,2906054118,244,2906054362,2932692427
2025-06-19 10:21:48,REAL,2906054362,10249,2906064611,2932702676
2025-06-19 10:21:50,REAL,2906064611,10249,2906074860,2932712925
2025-06-19 10:21:52,FAKE,2906074860,241,2906075101,2932723167
2025-06-19 10:21:54,REAL,2906075101,8593,2906083694,2932731760
2025-06-19 10:21:56,REAL,2906083694,483,2906084177,2932732243
2025-06-19 10:21:58,FAKE,2906084177,238,2906084415,2932732734
2025-06-19 10:22:00,FAKE,2906084415,243,2906084658,2932733226
2025-06-19 10:22:02,REAL,2906084658,488,2906085146,2932733714
2025-06-19 10:22:04,FAKE,2906085146,244,2906085390,2932734199
2025-06-19 10:22:06,REAL,2906085390,479,2906085869,2932734678
2025-06-19 10:22:08,REAL,2906085869,485,2906086354,2932735163
2025-06-19 10:22:10,REAL,2906086354,483,2906086837,2932735646
2025-06-19 10:22:12,FAKE,2906086837,238,2906087075,2932744852
2025-06-19 10:22:14,FAKE,2906087075,238,2906087313,2932755497
2025-06-19 10:22:16,REAL,2906087313,10316,2906097629,2932765813
2025-06-19 10:22:18,REAL,2906097629,10245,2906107874,2932776058
2025-06-19 10:22:20,REAL,2906107874,10252,2906118126,2932786310
2025-06-19 10:22:22,REAL,2906118126,10312,2906128438,2932796622
2025-06-19 10:22:24,FAKE,2906128438,243,2906128681,2932806873
2025-06-19 10:22:26,FAKE,2906128681,238,2906128919,2932814749
2025-06-19 10:22:28,FAKE,2906128919,241,2906129160,2932815230
2025-06-19 10:22:30,FAKE,2906129160,238,2906129398,2932815707
2025-06-19 10:22:32,REAL,2906129398,484,2906129882,2932816191
2025-06-19 10:22:34,REAL,2906129882,492,2906130374,2932816683
2025-06-19 10:22:36,REAL,2906130374,486,2906130860,2932817169
2025-06-19 10:22:38,REAL,2906130860,487,2906131347,2932817656
2025-06-19 10:22:40,REAL,2906131347,491,2906131838,2932818147
2025-06-19 10:22:42,REAL,2906131838,493,2906132331,2932818640
2025-06-19 10:22:44,FAKE,2906132331,244,2906132575,2932819180
2025-06-19 10:22:46,REAL,2906132575,479,2906133054,2932819659
2025-06-19 10:22:48,REAL,2906133054,483,2906133537,2932820142
2025-06-19 10:22:50,REAL,2906133537,484,2906134021,2932820626
2025-06-19 10:22:52,REAL,2906134021,484,2906134505,2932821110
2025-06-19 10:22:54,FAKE,2906134505,243,2906134748,2932821652
2025-06-19 10:22:56,REAL,2906134748,484,2906135232,2932822136
2025-06-19 10:22:58,FAKE,2906135232,238,2906135470,2932822623
2025-06-19 10:23:00,REAL,2906135470,477,2906135947,2932823100
2025-06-19 10:23:02,REAL,2906135947,487,2906136434,2932823587
2025-06-19 10:23:04,REAL,2906136434,492,2906136926,2932824079
2025-06-19 10:23:06,FAKE,2906136926,241,2906137167,2932824562
2025-06-19 10:23:08,FAKE,2906137167,244,2906137411,2932825050
2025-06-19 10:23:10,FAKE,2906137411,244,2906137655,2932825530
2025-06-19 10:23:12,REAL,2906137655,477,2906138132,2932826007
2025-06-19 10:23:14,FAKE,2906138132,238,2906138370,2932826488
2025-06-19 10:23:16,REAL,2906138370,486,2906138856,2932826974
2025-06-19 10:23:18,REAL,2906138856,484,2906139340,2932827458
2025-06-19 10:23:20,REAL,2906139340,483,2906139823,2932827941
2025-06-19 10:23:22,REAL,2906139823,485,2906140308,2932828426
2025-06-19 10:23:24,REAL,2906140308,487,2906140795,2932828913
2025-06-19 10:23:26,FAKE,2906140795,238,2906141033,2932829390
2025-06-19 10:23:28,REAL,2906141033,478,2906141511,2932829868
2025-06-19 10:23:30,REAL,2906141511,537,2906142048,2932830405
2025-06-19 10:23:32,REAL,2906142048,545,2906142593,2932830950
2025-06-19 10:23:34,REAL,2906142593,474,2906143067,2932831424
2025-06-19 10:23:36,FAKE,2906143067,243,2906143310,2932831908
2025-06-19 10:23:38,FAKE,2906143310,238,2906143548,2932832394
2025-06-19 10:23:40,REAL,2906143548,484,2906144032,2932832878
2025-06-19 10:23:42,REAL,2906144032,11323,2906155355,2932844201
2025-06-19 10:23:44,FAKE,2906155355,241,2906155596,2932854588
2025-06-19 10:23:46,FAKE,2906155596,238,2906155834,2932864845
2025-06-19 10:23:48,REAL,2906155834,10253,2906166087,2932875098
2025-06-19 10:23:50,REAL,2906166087,10318,2906176405,2932885416
2025-06-19 10:23:52,FAKE,2906176405,238,2906176643,2932895663
2025-06-19 10:23:54,REAL,2906176643,10260,2906186903,2932905923
2025-06-19 10:23:56,FAKE,2906186903,244,2906187147,2932912346
2025-06-19 10:23:58,REAL,2906187147,493,2906187640,2932912839
2025-06-19 10:24:00,FAKE,2906187640,243,2906187883,2932913317
2025-06-19 10:24:02,FAKE,2906187883,244,2906188127,2932913795
2025-06-19 10:24:04,FAKE,2906188127,241,2906188368,2932914271
2025-06-19 10:24:06,REAL,2906188368,485,2906188853,2932914756
2025-06-19 10:24:08,FAKE,2906188853,238,2906189091,2932915248
2025-06-19 10:24:10,REAL,2906189091,478,2906189569,2932915726
2025-06-19 10:24:12,REAL,2906189569,485,2906190054,2932916211
2025-06-19 10:24:14,REAL,2906190054,11466,2906201520,2932927677
2025-06-19 10:24:16,REAL,2906201520,10248,2906211768,2932937925
2025-06-19 10:24:18,FAKE,2906211768,243,2906212011,2932948175
2025-06-19 10:24:20,REAL,2906212011,10252,2906222263,2932958427
2025-06-19 10:24:22,FAKE,2906222263,243,2906222506,2932968736
2025-06-19 10:24:24,REAL,2906222506,10313,2906232819,2932979049
2025-06-19 10:24:26,REAL,2906232819,10247,2906243066,2932989296
2025-06-19 10:24:28,FAKE,2906243066,238,2906243304,2932995059
2025-06-19 10:24:30,REAL,2906243304,486,2906243790,2932995545
2025-06-19 10:24:32,FAKE,2906243790,243,2906244033,2932996028
2025-06-19 10:24:34,REAL,2906244033,480,2906244513,2932996508
2025-06-19 10:24:36,REAL,2906244513,480,2906244993,2932996988
2025-06-19 10:24:38,FAKE,2906244993,244,2906245237,2932997476
2025-06-19 10:24:40,FAKE,2906245237,238,2906245475,2932997967
2025-06-19 10:24:42,REAL,2906245475,489,2906245964,2932998456
2025-06-19 10:24:44,FAKE,2906245964,238,2906246202,2932998933
2025-06-19 10:24:46,REAL,2906246202,484,2906246686,2932999417
2025-06-19 10:24:48,FAKE,2906246686,241,2906246927,2932999900
2025-06-19 10:24:50,REAL,2906246927,547,2906247474,2933000447
2025-06-19 10:24:52,FAKE,2906247474,244,2906247718,2933000938
2025-06-19 10:24:54,REAL,2906247718,480,2906248198,2933001418
2025-06-19 10:24:56,REAL,2906248198,479,2906248677,2933001897
2025-06-19 10:24:58,FAKE,2906248677,238,2906248915,2933002389
2025-06-19 10:25:00,REAL,2906248915,489,2906249404,2933002878
2025-06-19 10:25:02,REAL,2906249404,477,2906249881,2933003355
2025-06-19 10:25:04,REAL,2906249881,483,2906250364,2933003838
2025-06-19 10:25:06,FAKE,2906250364,238,2906250602,2933004331
2025-06-19 10:25:08,FAKE,2906250602,238,2906250840,2933004817
2025-06-19 10:25:10,REAL,2906250840,539,2906251379,2933005356
2025-06-19 10:25:12,REAL,2906251379,486,2906251865,2933005842
2025-06-19 10:25:14,FAKE,2906251865,243,2906252108,2933006325
2025-06-19 10:25:16,FAKE,2906252108,241,2906252349,2933006815
2025-06-19 10:25:18,REAL,2906252349,481,2906252830,2933007296
2025-06-19 10:25:20,REAL,2906252830,480,2906253310,2933007776
2025-06-19 10:25:22,REAL,2906253310,475,2906253785,2933008251
2025-06-19 10:25:24,FAKE,2906253785,238,2906254023,2933008728
2025-06-19 10:25:26,REAL,2906254023,540,2906254563,2933009268
2025-06-19 10:25:28,REAL,2906254563,478,2906255041,2933009746
2025-06-19 10:25:30,FAKE,2906255041,238,2906255279,2933010239
2025-06-19 10:25:32,FAKE,2906255279,241,2906255520,2933010727
2025-06-19 10:25:34,REAL,2906255520,486,2906256006,2933011213
2025-06-19 10:25:36,FAKE,2906256006,238,2906256244,2933011698
2025-06-19 10:25:38,REAL,2906256244,7897,2906264141,2933019595
2025-06-19 10:25:40,REAL,2906264141,10706,2906274847,2933030301
2025-06-19 10:25:42,REAL,2906274847,10320,2906285167,2933040621
2025-06-19 10:25:44,REAL,2906285167,10245,2906295412,2933050866
2025-06-19 10:25:46,REAL,2906295412,10252,2906305664,2933061118
2025-06-19 10:25:48,FAKE,2906305664,243,2906305907,2933071435
2025-06-19 10:25:50,FAKE,2906305907,241,2906306148,2933081679
2025-06-19 10:25:52,REAL,2906306148,9068,2906315216,2933090747
2025-06-19 10:25:54,FAKE,2906315216,238,2906315454,2933091231
2025-06-19 10:25:56,REAL,2906315454,478,2906315932,2933091709
2025-06-19 10:25:58,REAL,2906315932,489,2906316421,2933092198
2025-06-19 10:26:00,FAKE,2906316421,243,2906316664,2933092739
2025-06-19 10:26:02,REAL,2906316664,483,2906317147,2933093222
2025-06-19 10:26:04,REAL,2906317147,477,2906317624,2933093699
2025-06-19 10:26:06,REAL,2906317624,475,2906318099,2933094174
2025-06-19 10:26:08,REAL,2906318099,485,2906318584,2933094659
2025-06-19 10:26:10,REAL,2906318584,484,2906319068,2933095143
2025-06-19 10:26:12,FAKE,2906319068,241,2906319309,2933095626
2025-06-19 10:26:14,REAL,2906319309,548,2906319857,2933096174
2025-06-19 10:26:16,REAL,2906319857,481,2906320338,2933096655
2025-06-19 10:26:18,REAL,2906320338,484,2906320822,2933097139
2025-06-19 10:26:20,REAL,2906320822,488,2906321310,2933097627
2025-06-19 10:26:22,REAL,2906321310,548,2906321858,2933098175
2025-06-19 10:26:24,REAL,2906321858,478,2906322336,2933098653
2025-06-19 10:26:26,REAL,2906322336,475,2906322811,2933099128
2025-06-19 10:26:28,FAKE,2906322811,241,2906323052,2933099602
2025-06-19 10:26:30,REAL,2906323052,2934,2906325986,2933102536
2025-06-19 10:26:32,REAL,2906325986,14409,2906340395,2933116945
2025-06-19 10:26:34,REAL,2906340395,10248,2906350643,2933127193
2025-06-19 10:26:36,REAL,2906350643,10320,2906360963,2933137513
2025-06-19 10:26:38,REAL,2906360963,10247,2906371210,2933147760
2025-06-19 10:26:40,REAL,2906371210,10247,2906381457,2933158007
2025-06-19 10:26:42,REAL,2906381457,10316,2906391773,2933168323
2025-06-19 10:26:44,FAKE,2906391773,238,2906392011,2933178634
2025-06-19 10:26:46,FAKE,2906392011,241,2906392252,2933181820
2025-06-19 10:26:48,REAL,2906392252,493,2906392745,2933182313
2025-06-19 10:26:50,FAKE,2906392745,244,2906392989,2933182798
2025-06-19 10:26:52,REAL,2906392989,487,2906393476,2933183285
2025-06-19 10:26:54,REAL,2906393476,486,2906393962,2933183771
2025-06-19 10:26:56,FAKE,2906393962,243,2906394205,2933184259
2025-06-19 10:26:58,REAL,2906394205,490,2906394695,2933184749
2025-06-19 10:27:00,REAL,2906394695,488,2906395183,2933185237
2025-06-19 10:27:02,REAL,2906395183,475,2906395658,2933185712
2025-06-19 10:27:04,FAKE,2906395658,244,2906395902,2933186205
2025-06-19 10:27:06,REAL,2906395902,540,2906396442,2933186745
2025-06-19 10:27:08,REAL,2906396442,549,2906396991,2933187294
2025-06-19 10:27:10,REAL,2906396991,475,2906397466,2933187769
2025-06-19 10:27:12,REAL,2906397466,484,2906397950,2933188253
2025-06-19 10:27:14,FAKE,2906397950,244,2906398194,2933188741
2025-06-19 10:27:16,REAL,2906398194,479,2906398673,2933189220
2025-06-19 10:27:18,REAL,2906398673,491,2906399164,2933189711
2025-06-19 10:27:20,REAL,2906399164,482,2906399646,2933190193
2025-06-19 10:27:22,FAKE,2906399646,238,2906399884,2933190678
2025-06-19 10:27:24,REAL,2906399884,9875,2906409759,2933200553
2025-06-19 10:27:26,REAL,2906409759,10451,2906420210,2933211004
2025-06-19 10:27:28,REAL,2906420210,10312,2906430522,2933221316
2025-06-19 10:27:30,FAKE,2906430522,241,2906430763,2933231569
2025-06-19 10:27:32,FAKE,2906430763,244,2906431007,2933241885
2025-06-19 10:27:34,REAL,2906431007,10257,2906441264,2933252142
2025-06-19 10:27:36,FAKE,2906441264,241,2906441505,2933262391
2025-06-19 10:27:38,REAL,2906441505,7143,2906448648,2933269534
2025-06-19 10:27:40,FAKE,2906448648,244,2906448892,2933270009
2025-06-19 10:27:42,FAKE,2906448892,238,2906449130,2933270491
2025-06-19 10:27:44,FAKE,2906449130,243,2906449373,2933275331
2025-06-19 10:27:46,REAL,2906449373,11712,2906461085,2933287043
2025-06-19 10:27:48,REAL,2906461085,10245,2906471330,2933297288
2025-06-19 10:27:50,FAKE,2906471330,241,2906471571,2933307604
2025-06-19 10:27:52,REAL,2906471571,10312,2906481883,2933317916
2025-06-19 10:27:54,FAKE,2906481883,244,2906482127,2933328174
2025-06-19 10:27:56,REAL,2906482127,10259,2906492386,2933338433
2025-06-19 10:27:58,REAL,2906492386,10243,2906502629,2933348676
2025-06-19 10:28:00,REAL,2906502629,1942,2906504571,2933350618
2025-06-19 10:28:02,FAKE,2906504571,241,2906504812,2933351109
2025-06-19 10:28:04,FAKE,2906504812,241,2906505053,2933351595
2025-06-19 10:28:06,REAL,2906505053,482,2906505535,2933352077
2025-06-19 10:28:08,FAKE,2906505535,238,2906505773,2933352555
2025-06-19 10:28:10,REAL,2906505773,494,2906506267,2933353049
2025-06-19 10:28:12,REAL,2906506267,543,2906506810,2933353592
2025-06-19 10:28:14,FAKE,2906506810,244,2906507054,2933354075
2025-06-19 10:28:16,REAL,2906507054,481,2906507535,2933354556
2025-06-19 10:28:18,REAL,2906507535,532,2906508067,2933355088
2025-06-19 10:28:20,REAL,2906508067,482,2906508549,2933355570
2025-06-19 10:28:22,FAKE,2906508549,241,2906508790,2933356051
2025-06-19 10:28:24,REAL,2906508790,484,2906509274,2933356535
2025-06-19 10:28:26,FAKE,2906509274,241,2906509515,2933356774
2025-06-19 10:28:28,FAKE,2906509515,238,2906509753,2933357252
2025-06-19 10:28:30,FAKE,2906509753,244,2906509997,2933357734
2025-06-19 10:28:32,FAKE,2906509997,238,2906510235,2933358216
2025-06-19 10:28:34,FAKE,2906510235,244,2906510479,2933358761
2025-06-19 10:28:36,REAL,2906510479,483,2906510962,2933359244
2025-06-19 10:28:38,REAL,2906510962,14945,2906525907,2933374189
2025-06-19 10:28:40,REAL,2906525907,10245,2906536152,2933384434
2025-06-19 10:28:42,REAL,2906536152,10319,2906546471,2933394753
2025-06-19 10:28:44,REAL,2906546471,10254,2906556725,2933405007
2025-06-19 10:28:46,REAL,2906556725,10313,2906567038,2933415320
2025-06-19 10:28:48,REAL,2906567038,10245,2906577283,2933425565
2025-06-19 10:28:50,FAKE,2906577283,243,2906577526,2933435813
2025-06-19 10:28:52,FAKE,2906577526,241,2906577767,2933441650
2025-06-19 10:28:54,FAKE,2906577767,243,2906578010,2933442124
2025-06-19 10:28:56,FAKE,2906578010,244,2906578254,2933442662
2025-06-19 10:28:58,REAL,2906578254,485,2906578739,2933443147
2025-06-19 10:29:00,REAL,2906578739,485,2906579224,2933443632
2025-06-19 10:29:02,REAL,2906579224,481,2906579705,2933444113
2025-06-19 10:29:04,REAL,2906579705,489,2906580194,2933444602
2025-06-19 10:29:06,REAL,2906580194,481,2906580675,2933445083
2025-06-19 10:29:08,FAKE,2906580675,238,2906580913,2933445575
2025-06-19 10:29:10,FAKE,2906580913,238,2906581151,2933446062
2025-06-19 10:29:12,FAKE,2906581151,244,2906581395,2933446603
2025-06-19 10:29:14,FAKE,2906581395,238,2906581633,2933447085
2025-06-19 10:29:16,REAL,2906581633,476,2906582109,2933447561
2025-06-19 10:29:18,REAL,2906582109,542,2906582651,2933448103
2025-06-19 10:29:20,FAKE,2906582651,243,2906582894,2933448584
2025-06-19 10:29:22,REAL,2906582894,481,2906583375,2933449065
2025-06-19 10:29:24,REAL,2906583375,491,2906583866,2933449556
2025-06-19 10:29:26,REAL,2906583866,486,2906584352,2933450042
2025-06-19 10:29:28,FAKE,2906584352,238,2906584590,2933450519
2025-06-19 10:29:30,REAL,2906584590,487,2906585077,2933451006
2025-06-19 10:29:32,REAL,2906585077,483,2906585560,2933451489
2025-06-19 10:29:34,REAL,2906585560,484,2906586044,2933451973
2025-06-19 10:29:36,FAKE,2906586044,241,2906586285,2933452456
2025-06-19 10:29:38,REAL,2906586285,489,2906586774,2933452945
2025-06-19 10:29:40,REAL,2906586774,1402,2906588176,2933454347
2025-06-19 10:29:42,FAKE,2906588176,241,2906588417,2933466321
2025-06-19 10:29:44,REAL,2906588417,10248,2906598665,2933476569
2025-06-19 10:29:46,REAL,2906598665,10248,2906608913,2933486817
2025-06-19 10:29:48,FAKE,2906608913,241,2906609154,2933497066
2025-06-19 10:29:50,FAKE,2906609154,241,2906609395,2933507313
2025-06-19 10:29:52,REAL,2906609395,10317,2906619712,2933517630
2025-06-19 10:29:54,FAKE,2906619712,243,2906619955,2933527882
2025-06-19 10:29:56,REAL,2906619955,4507,2906624462,2933532389
2025-06-19 10:29:58,REAL,2906624462,484,2906624946,2933532873
2025-06-19 10:30:00,FAKE,2906624946,241,2906625187,2933533358
2025-06-19 10:30:02,REAL,2906625187,538,2906625725,2933533896
2025-06-19 10:30:04,REAL,2906625725,482,2906626207,2933534378
2025-06-19 10:30:06,FAKE,2906626207,244,2906626451,2933534864
2025-06-19 10:30:08,FAKE,2906626451,243,2906626694,2933535346
2025-06-19 10:30:10,FAKE,2906626694,241,2906626935,2933535822
2025-06-19 10:30:12,FAKE,2906626935,243,2906627178,2933536298
2025-06-19 10:30:14,REAL,2906627178,489,2906627667,2933536787
2025-06-19 10:30:16,FAKE,2906627667,241,2906627908,2933537324
2025-06-19 10:30:18,REAL,2906627908,487,2906628395,2933537811
2025-06-19 10:30:20,REAL,2906628395,480,2906628875,2933538291
2025-06-19 10:30:22,REAL,2906628875,486,2906629361,2933538777
2025-06-19 10:30:24,REAL,2906629361,544,2906629905,2933539321
2025-06-19 10:30:26,REAL,2906629905,492,2906630397,2933539813
2025-06-19 10:30:28,REAL,2906630397,483,2906630880,2933540296
2025-06-19 10:30:30,REAL,2906630880,494,2906631374,2933540790
2025-06-19 10:30:32,REAL,2906631374,478,2906631852,2933541268
2025-06-19 10:30:34,REAL,2906631852,491,2906632343,2933541759
2025-06-19 10:30:36,FAKE,2906632343,241,2906632584,2933542240
2025-06-19 10:30:38,REAL,2906632584,485,2906633069,2933542725
2025-06-19 10:30:40,REAL,2906633069,489,2906633558,2933543214
2025-06-19 10:30:42,REAL,2906633558,485,2906634043,2933543699
2025-06-19 10:30:44,REAL,2906634043,493,2906634536,2933544192
2025-06-19 10:30:46,FAKE,2906634536,244,2906634780,2933544686
2025-06-19 10:30:48,REAL,2906634780,487,2906635267,2933545173
2025-06-19 10:30:50,REAL,2906635267,542,2906635809,2933545715
2025-06-19 10:30:52,REAL,2906635809,491,2906636300,2933546206
2025-06-19 10:30:54,REAL,2906636300,545,2906636845,2933546751
2025-06-19 10:30:56,REAL,2906636845,479,2906637324,2933547230
2025-06-19 10:30:58,REAL,2906637324,491,2906637815,2933547721
2025-06-19 10:31:00,REAL,2906637815,478,2906638293,2933548199
2025-06-19 10:31:02,REAL,2906638293,484,2906638777,2933548683
2025-06-19 10:31:04,REAL,2906638777,479,2906639256,2933549162
2025-06-19 10:31:06,REAL,2906639256,484,2906639740,2933549646
2025-06-19 10:31:08,REAL,2906639740,479,2906640219,2933550125
2025-06-19 10:31:10,FAKE,2906640219,243,2906640462,2933550600
2025-06-19 10:31:12,REAL,2906640462,487,2906640949,2933551087
2025-06-19 10:31:14,REAL,2906640949,484,2906641433,2933551571
2025-06-19 10:31:16,REAL,2906641433,481,2906641914,2933552052
2025-06-19 10:31:18,REAL,2906641914,480,2906642394,2933552532
2025-06-19 10:31:20,REAL,2906642394,489,2906642883,2933553021
2025-06-19 10:31:22,REAL,2906642883,491,2906643374,2933553512
2025-06-19 10:31:24,FAKE,2906643374,238,2906643612,2933554044
2025-06-19 10:31:26,REAL,2906643612,543,2906644155,2933554587
2025-06-19 10:31:28,REAL,2906644155,485,2906644640,2933555072
2025-06-19 10:31:30,REAL,2906644640,487,2906645127,2933555559
2025-06-19 10:31:32,FAKE,2906645127,243,2906645370,2933556053
2025-06-19 10:31:34,FAKE,2906645370,243,2906645613,2933556539
2025-06-19 10:31:36,FAKE,2906645613,243,2906645856,2933557022
2025-06-19 10:31:38,REAL,2906645856,488,2906646344,2933557510
2025-06-19 10:31:40,FAKE,2906646344,238,2906646582,2933558000
2025-06-19 10:31:42,REAL,2906646582,486,2906647068,2933558486
2025-06-19 10:31:44,REAL,2906647068,483,2906647551,2933558969
2025-06-19 10:31:46,FAKE,2906647551,244,2906647795,2933559451
2025-06-19 10:31:48,REAL,2906647795,486,2906648281,2933559937
2025-06-19 10:31:50,FAKE,2906648281,241,2906648522,2933560429
2025-06-19 10:31:52,REAL,2906648522,483,2906649005,2933560912
2025-06-19 10:31:54,FAKE,2906649005,244,2906649249,2933561459
2025-06-19 10:31:56,REAL,2906649249,488,2906649737,2933561947
2025-06-19 10:31:58,REAL,2906649737,486,2906650223,2933562433
2025-06-19 10:32:00,REAL,2906650223,545,2906650768,2933562978
2025-06-19 10:32:02,REAL,2906650768,479,2906651247,2933563457
2025-06-19 10:32:04,REAL,2906651247,484,2906651731,2933563941
2025-06-19 10:32:06,REAL,2906651731,478,2906652209,2933564419
2025-06-19 10:32:08,FAKE,2906652209,243,2906652452,2933564905
2025-06-19 10:32:10,FAKE,2906652452,243,2906652695,2933565387
2025-06-19 10:32:12,REAL,2906652695,492,2906653187,2933565879
2025-06-19 10:32:14,FAKE,2906653187,243,2906653430,2933566366
2025-06-19 10:32:16,REAL,2906653430,480,2906653910,2933566846
2025-06-19 10:32:18,REAL,2906653910,490,2906654400,2933567336
2025-06-19 10:32:20,REAL,2906654400,484,2906654884,2933567820
2025-06-19 10:32:22,FAKE,2906654884,241,2906655125,2933568304
2025-06-19 10:32:24,FAKE,2906655125,244,2906655369,2933568791
2025-06-19 10:32:26,FAKE,2906655369,244,2906655613,2933569333
2025-06-19 10:32:28,REAL,2906655613,483,2906656096,2933569816
2025-06-19 10:32:30,FAKE,2906656096,238,2906656334,2933570298
2025-06-19 10:32:32,REAL,2906656334,486,2906656820,2933570784
2025-06-19 10:32:34,FAKE,2906656820,243,2906657063,2933571274
2025-06-19 10:32:36,FAKE,2906657063,243,2906657306,2933571818
2025-06-19 10:32:38,REAL,2906657306,481,2906657787,2933572299
2025-06-19 10:32:40,FAKE,2906657787,241,2906658028,2933572777
2025-06-19 10:32:42,FAKE,2906658028,241,2906658269,2933573261
2025-06-19 10:32:44,REAL,2906658269,486,2906658755,2933573747
2025-06-19 10:32:46,REAL,2906658755,474,2906659229,2933574221
2025-06-19 10:32:48,FAKE,2906659229,243,2906659472,2933574701
2025-06-19 10:32:50,REAL,2906659472,484,2906659956,2933575185
2025-06-19 10:32:52,REAL,2906659956,481,2906660437,2933575666
2025-06-19 10:32:54,FAKE,2906660437,238,2906660675,2933576157
2025-06-19 10:32:56,FAKE,2906660675,238,2906660913,2933581917
2025-06-19 10:32:58,FAKE,2906660913,238,2906661151,2933596127
2025-06-19 10:33:00,FAKE,2906661151,241,2906661392,2933606380
2025-06-19 10:33:02,FAKE,2906661392,241,2906661633,2933616626
2025-06-19 10:33:04,FAKE,2906661633,241,2906661874,2933626945
2025-06-19 10:33:06,REAL,2906661874,10248,2906672122,2933637193
2025-06-19 10:33:08,REAL,2906672122,10258,2906682380,2933647451
2025-06-19 10:33:10,REAL,2906682380,10247,2906692627,2933657698
2025-06-19 10:33:12,REAL,2906692627,1138,2906693765,2933658836
2025-06-19 10:33:14,REAL,2906693765,492,2906694257,2933659328
2025-06-19 10:33:16,FAKE,2906694257,244,2906694501,2933659814
2025-06-19 10:33:18,REAL,2906694501,481,2906694982,2933660295
2025-06-19 10:33:20,REAL,2906694982,481,2906695463,2933660776
2025-06-19 10:33:22,FAKE,2906695463,244,2906695707,2933661260
2025-06-19 10:33:24,FAKE,2906695707,238,2906695945,2933661743
2025-06-19 10:33:26,REAL,2906695945,534,2906696479,2933662277
2025-06-19 10:33:28,REAL,2906696479,7681,2906704160,2933669958
2025-06-19 10:33:30,FAKE,2906704160,241,2906704401,2933680805
2025-06-19 10:33:32,REAL,2906704401,10252,2906714653,2933691057
2025-06-19 10:33:34,FAKE,2906714653,244,2906714897,2933701315
2025-06-19 10:33:36,FAKE,2906714897,238,2906715135,2933711565
2025-06-19 10:33:38,FAKE,2906715135,241,2906715376,2933721881
2025-06-19 10:33:40,REAL,2906715376,10247,2906725623,2933732128
2025-06-19 10:33:42,REAL,2906725623,10259,2906735882,2933742387
2025-06-19 10:33:44,REAL,2906735882,483,2906736365,2933742870
2025-06-19 10:33:46,REAL,2906736365,490,2906736855,2933743360
2025-06-19 10:33:48,REAL,2906736855,475,2906737330,2933743835
2025-06-19 10:33:50,FAKE,2906737330,238,2906737568,2933744318
2025-06-19 10:33:52,REAL,2906737568,487,2906738055,2933744805
2025-06-19 10:33:54,FAKE,2906738055,241,2906738296,2933745289
2025-06-19 10:33:56,REAL,2906738296,540,2906738836,2933745829
2025-06-19 10:33:58,FAKE,2906738836,244,2906739080,2933746314
2025-06-19 10:34:00,REAL,2906739080,484,2906739564,2933746798
2025-06-19 10:34:02,REAL,2906739564,535,2906740099,2933747333
2025-06-19 10:34:04,REAL,2906740099,481,2906740580,2933747814
2025-06-19 10:34:06,FAKE,2906740580,238,2906740818,2933748294
2025-06-19 10:34:08,REAL,2906740818,483,2906741301,2933748777
2025-06-19 10:34:10,FAKE,2906741301,241,2906741542,2933749265
2025-06-19 10:34:12,REAL,2906741542,483,2906742025,2933749748
2025-06-19 10:34:14,REAL,2906742025,489,2906742514,2933750237
2025-06-19 10:34:16,REAL,2906742514,7091,2906749605,2933757328
2025-06-19 10:34:18,REAL,2906749605,11105,2906760710,2933768433
2025-06-19 10:34:20,REAL,2906760710,10246,2906770956,2933778679
2025-06-19 10:34:22,FAKE,2906770956,238,2906771194,2933788941
2025-06-19 10:34:24,REAL,2906771194,10256,2906781450,2933799197
2025-06-19 10:34:26,REAL,2906781450,10376,2906791826,2933809573
2025-06-19 10:34:28,REAL,2906791826,10246,2906802072,2933819819
2025-06-19 10:34:30,REAL,2906802072,9331,2906811403,2933829150
2025-06-19 10:34:32,REAL,2906811403,487,2906811890,2933829637
2025-06-19 10:34:34,FAKE,2906811890,241,2906812131,2933830131
2025-06-19 10:34:36,REAL,2906812131,476,2906812607,2933830607
2025-06-19 10:34:38,FAKE,2906812607,241,2906812848,2933831085
2025-06-19 10:34:40,REAL,2906812848,483,2906813331,2933831568
2025-06-19 10:34:42,REAL,2906813331,479,2906813810,2933832047
2025-06-19 10:34:44,REAL,2906813810,482,2906814292,2933832529
2025-06-19 10:34:46,REAL,2906814292,489,2906814781,2933833018
2025-06-19 10:34:48,REAL,2906814781,534,2906815315,2933833552
2025-06-19 10:34:50,REAL,2906815315,491,2906815806,2933834043
2025-06-19 10:34:52,REAL,2906815806,479,2906816285,2933834522
2025-06-19 10:34:54,FAKE,2906816285,244,2906816529,2933835007
2025-06-19 10:34:56,FAKE,2906816529,243,2906816772,2933835544
2025-06-19 10:34:58,REAL,2906816772,489,2906817261,2933836033
2025-06-19 10:35:00,REAL,2906817261,481,2906817742,2933836514
2025-06-19 10:35:02,REAL,2906817742,491,2906818233,2933837005
2025-06-19 10:35:04,FAKE,2906818233,238,2906818471,2933837498
2025-06-19 10:35:06,FAKE,2906818471,241,2906818712,2933837985
2025-06-19 10:35:08,REAL,2906818712,2735,2906821447,2933840720
2025-06-19 10:35:10,FAKE,2906821447,241,2906821688,2933852219
2025-06-19 10:35:12,REAL,2906821688,10320,2906832008,2933862539
2025-06-19 10:35:14,REAL,2906832008,10247,2906842255,2933872786
2025-06-19 10:35:16,REAL,2906842255,10322,2906852577,2933883108
2025-06-19 10:35:18,REAL,2906852577,10251,2906862828,2933893359
2025-06-19 10:35:20,FAKE,2906862828,243,2906863071,2933903680
2025-06-19 10:35:22,FAKE,2906863071,244,2906863315,2933913933
2025-06-19 10:35:24,REAL,2906863315,3463,2906866778,2933917396
2025-06-19 10:35:26,FAKE,2906866778,241,2906867019,2933917941
2025-06-19 10:35:28,FAKE,2906867019,241,2906867260,2933918429
2025-06-19 10:35:30,REAL,2906867260,483,2906867743,2933918912
2025-06-19 10:35:32,REAL,2906867743,492,2906868235,2933919404
2025-06-19 10:35:34,REAL,2906868235,490,2906868725,2933919894
2025-06-19 10:35:36,FAKE,2906868725,243,2906868968,2933920378
2025-06-19 10:35:38,REAL,2906868968,486,2906869454,2933920864
2025-06-19 10:35:40,REAL,2906869454,480,2906869934,2933921344
2025-06-19 10:35:42,FAKE,2906869934,244,2906870178,2933921878
2025-06-19 10:35:44,REAL,2906870178,487,2906870665,2933922365
2025-06-19 10:35:46,REAL,2906870665,9070,2906879735,2933931435
2025-06-19 10:35:48,REAL,2906879735,10529,2906890264,2933941964
2025-06-19 10:35:50,FAKE,2906890264,243,2906890507,2933952213
2025-06-19 10:35:52,FAKE,2906890507,238,2906890745,2933962463
2025-06-19 10:35:54,REAL,2906890745,10250,2906900995,2933972713
2025-06-19 10:35:56,REAL,2906900995,10260,2906911255,2933982973
2025-06-19 10:35:58,FAKE,2906911255,244,2906911499,2933993284
2025-06-19 10:36:00,REAL,2906911499,7681,2906919180,2934000965
2025-06-19 10:36:02,REAL,2906919180,488,2906919668,2934001453
2025-06-19 10:36:04,REAL,2906919668,480,2906920148,2934001933
2025-06-19 10:36:06,REAL,2906920148,481,2906920629,2934002414
2025-06-19 10:36:08,REAL,2906920629,479,2906921108,2934002893
2025-06-19 10:36:10,REAL,2906921108,483,2906921591,2934003376
2025-06-19 10:36:12,REAL,2906921591,481,2906922072,2934003857
2025-06-19 10:36:14,REAL,2906922072,485,2906922557,2934004342
2025-06-19 10:36:16,REAL,2906922557,548,2906923105,2934004890
2025-06-19 10:36:18,REAL,2906923105,475,2906923580,2934005365
2025-06-19 10:36:20,REAL,2906923580,483,2906924063,2934005848
2025-06-19 10:36:22,REAL,2906924063,484,2906924547,2934006332
2025-06-19 10:36:24,REAL,2906924547,491,2906925038,2934006823
2025-06-19 10:36:26,REAL,2906925038,484,2906925522,2934007307
2025-06-19 10:36:28,REAL,2906925522,480,2906926002,2934007787
2025-06-19 10:36:30,REAL,2906926002,477,2906926479,2934008264
2025-06-19 10:36:32,REAL,2906926479,490,2906926969,2934008754
2025-06-19 10:36:34,FAKE,2906926969,243,2906927212,2934009297
2025-06-19 10:36:36,FAKE,2906927212,241,2906927453,2934009779
2025-06-19 10:36:38,FAKE,2906927453,241,2906927694,2934010254
2025-06-19 10:36:40,REAL,2906927694,485,2906928179,2934010739
2025-06-19 10:36:42,REAL,2906928179,485,2906928664,2934011224
2025-06-19 10:36:44,REAL,2906928664,484,2906929148,2934011708
2025-06-19 10:36:46,FAKE,2906929148,243,2906929391,2934012196
2025-06-19 10:36:48,REAL,2906929391,536,2906929927,2934012732
2025-06-19 10:36:50,REAL,2906929927,488,2906930415,2934013220
2025-06-19 10:36:52,REAL,2906930415,480,2906930895,2934013700
2025-06-19 10:36:54,FAKE,2906930895,238,2906931133,2934014186
2025-06-19 10:36:56,REAL,2906931133,486,2906931619,2934014672
2025-06-19 10:36:58,REAL,2906931619,485,2906932104,2934015157
2025-06-19 10:37:00,REAL,2906932104,484,2906932588,2934015641
2025-06-19 10:37:02,REAL,2906932588,487,2906933075,2934016128
2025-06-19 10:37:04,FAKE,2906933075,238,2906933313,2934016615
2025-06-19 10:37:06,REAL,2906933313,487,2906933800,2934017102
2025-06-19 10:37:08,REAL,2906933800,549,2906934349,2934017651
2025-06-19 10:37:10,REAL,2906934349,487,2906934836,2934018138
2025-06-19 10:37:12,REAL,2906934836,485,2906935321,2934018623
2025-06-19 10:37:14,REAL,2906935321,481,2906935802,2934019104
2025-06-19 10:37:16,REAL,2906935802,11637,2906947439,2934030741
2025-06-19 10:37:18,FAKE,2906947439,241,2906947680,2934041057
2025-06-19 10:37:20,REAL,2906947680,10253,2906957933,2934051310
2025-06-19 10:37:22,FAKE,2906957933,244,2906958177,2934061622
2025-06-19 10:37:24,REAL,2906958177,10259,2906968436,2934071881
2025-06-19 10:37:26,REAL,2906968436,10319,2906978755,2934082200
2025-06-19 10:37:28,FAKE,2906978755,238,2906978993,2934092452
2025-06-19 10:37:30,FAKE,2906978993,241,2906979234,2934098484
2025-06-19 10:37:32,FAKE,2906979234,243,2906979477,2934098969
2025-06-19 10:37:34,REAL,2906979477,489,2906979966,2934099458
2025-06-19 10:37:36,REAL,2906979966,478,2906980444,2934099936
2025-06-19 10:37:38,REAL,2906980444,491,2906980935,2934100427
2025-06-19 10:37:40,REAL,2906980935,545,2906981480,2934100972
2025-06-19 10:37:42,REAL,2906981480,491,2906981971,2934101463
2025-06-19 10:37:44,FAKE,2906981971,244,2906982215,2934101941
2025-06-19 10:37:46,FAKE,2906982215,243,2906982458,2934102417
2025-06-19 10:37:48,REAL,2906982458,11930,2906994388,2934114347
2025-06-19 10:37:50,REAL,2906994388,10247,2907004635,2934124594
2025-06-19 10:37:52,REAL,2907004635,10250,2907014885,2934134844
2025-06-19 10:37:54,REAL,2907014885,10321,2907025206,2934145165
2025-06-19 10:37:56,REAL,2907025206,10248,2907035454,2934155413
2025-06-19 10:37:58,REAL,2907035454,10327,2907045781,2934165740
2025-06-19 10:38:00,REAL,2907045781,10256,2907056037,2934175996
2025-06-19 10:38:02,REAL,2907056037,5370,2907061407,2934181366
2025-06-19 10:38:04,REAL,2907061407,478,2907061885,2934181844
2025-06-19 10:38:06,REAL,2907061885,482,2907062367,2934182326
2025-06-19 10:38:08,REAL,2907062367,6769,2907069136,2934189095
2025-06-19 10:38:10,FAKE,2907069136,238,2907069374,2934200069
2025-06-19 10:38:12,REAL,2907069374,10249,2907079623,2934210318
2025-06-19 10:38:14,FAKE,2907079623,244,2907079867,2934220634
2025-06-19 10:38:16,REAL,2907079867,10304,2907090171,2934230938
2025-06-19 10:38:18,REAL,2907090171,10318,2907100489,2934241256
2025-06-19 10:38:20,REAL,2907100489,10261,2907110750,2934251517
2025-06-19 10:38:22,REAL,2907110750,9984,2907120734,2934261501
2025-06-19 10:38:24,REAL,2907120734,486,2907121220,2934261987
2025-06-19 10:38:26,REAL,2907121220,489,2907121709,2934262476
2025-06-19 10:38:28,REAL,2907121709,484,2907122193,2934262960
2025-06-19 10:38:30,FAKE,2907122193,241,2907122434,2934263442
2025-06-19 10:38:32,REAL,2907122434,487,2907122921,2934263929
2025-06-19 10:38:34,REAL,2907122921,487,2907123408,2934264416
2025-06-19 10:38:36,REAL,2907123408,481,2907123889,2934264897
2025-06-19 10:38:38,REAL,2907123889,475,2907124364,2934265372
2025-06-19 10:38:40,REAL,2907124364,7765,2907132129,2934273137
2025-06-19 10:38:42,REAL,2907132129,11392,2907143521,2934284529
2025-06-19 10:38:44,REAL,2907143521,10251,2907153772,2934294780
2025-06-19 10:38:46,FAKE,2907153772,243,2907154015,2934305039
2025-06-19 10:38:48,REAL,2907154015,10316,2907164331,2934315355
2025-06-19 10:38:50,REAL,2907164331,10309,2907174640,2934325664
2025-06-19 10:38:52,REAL,2907174640,10317,2907184957,2934335981
2025-06-19 10:38:54,REAL,2907184957,9331,2907194288,2934345312
2025-06-19 10:38:56,REAL,2907194288,487,2907194775,2934345799
2025-06-19 10:38:58,FAKE,2907194775,243,2907195018,2934346286
2025-06-19 10:39:00,FAKE,2907195018,241,2907195259,2934346772
2025-06-19 10:39:02,FAKE,2907195259,244,2907195503,2934347259
2025-06-19 10:39:04,REAL,2907195503,487,2907195990,2934347746
2025-06-19 10:39:06,REAL,2907195990,483,2907196473,2934348229
2025-06-19 10:39:08,REAL,2907196473,484,2907196957,2934348713
2025-06-19 10:39:10,REAL,2907196957,482,2907197439,2934349195
2025-06-19 10:39:12,FAKE,2907197439,238,2907197677,2934349683
2025-06-19 10:39:14,REAL,2907197677,487,2907198164,2934350170
2025-06-19 10:39:16,REAL,2907198164,480,2907198644,2934350650
2025-06-19 10:39:18,REAL,2907198644,481,2907199125,2934351131
2025-06-19 10:39:20,FAKE,2907199125,244,2907199369,2934351666
2025-06-19 10:39:22,REAL,2907199369,475,2907199844,2934352141
2025-06-19 10:39:24,FAKE,2907199844,244,2907200088,2934352685
2025-06-19 10:39:26,REAL,2907200088,484,2907200572,2934353169
2025-06-19 10:39:28,FAKE,2907200572,243,2907200815,2934353650
2025-06-19 10:39:30,FAKE,2907200815,244,2907201059,2934354133
2025-06-19 10:39:32,REAL,2907201059,483,2907201542,2934354616
2025-06-19 10:39:34,REAL,2907201542,490,2907202032,2934355106
2025-06-19 10:39:36,REAL,2907202032,485,2907202517,2934355591
2025-06-19 10:39:38,REAL,2907202517,487,2907203004,2934356078
2025-06-19 10:39:40,FAKE,2907203004,241,2907203245,2934356563
2025-06-19 10:39:42,REAL,2907203245,481,2907203726,2934357044
2025-06-19 10:39:44,REAL,2907203726,9006,2907212732,2934366050
2025-06-19 10:39:46,REAL,2907212732,10586,2907223318,2934376636
2025-06-19 10:39:48,REAL,2907223318,10325,2907233643,2934386961
2025-06-19 10:39:50,FAKE,2907233643,238,2907233881,2934397213
2025-06-19 10:39:52,FAKE,2907233881,244,2907234125,2934407535
2025-06-19 10:39:54,REAL,2907234125,10252,2907244377,2934417787
2025-06-19 10:39:56,REAL,2907244377,10244,2907254621,2934428031
2025-06-19 10:39:58,REAL,2907254621,8134,2907262755,2934436165
2025-06-19 10:40:00,REAL,2907262755,485,2907263240,2934436650
2025-06-19 10:40:02,REAL,2907263240,481,2907263721,2934437131
2025-06-19 10:40:04,REAL,2907263721,486,2907264207,2934437617
2025-06-19 10:40:06,REAL,2907264207,479,2907264686,2934438096
2025-06-19 10:40:08,FAKE,2907264686,241,2907264927,2934438582
2025-06-19 10:40:10,REAL,2907264927,484,2907265411,2934439066
2025-06-19 10:40:12,REAL,2907265411,490,2907265901,2934439556
2025-06-19 10:40:14,REAL,2907265901,486,2907266387,2934440042
2025-06-19 10:40:16,REAL,2907266387,481,2907266868,2934440523
2025-06-19 10:40:18,FAKE,2907266868,244,2907267112,2934441007
2025-06-19 10:40:20,FAKE,2907267112,238,2907267350,2934441491
2025-06-19 10:40:22,FAKE,2907267350,243,2907267593,2934441972
2025-06-19 10:40:24,REAL,2907267593,530,2907268123,2934442502
2025-06-19 10:40:26,REAL,2907268123,485,2907268608,2934442987
2025-06-19 10:40:28,REAL,2907268608,484,2907269092,2934443471
2025-06-19 10:40:30,REAL,2907269092,539,2907269631,2934444010
2025-06-19 10:40:32,REAL,2907269631,481,2907270112,2934444491
2025-06-19 10:40:34,REAL,2907270112,488,2907270600,2934444979
2025-06-19 10:40:36,REAL,2907270600,485,2907271085,2934445464
2025-06-19 10:40:38,FAKE,2907271085,243,2907271328,2934445945
2025-06-19 10:40:40,REAL,2907271328,478,2907271806,2934446423
2025-06-19 10:40:42,REAL,2907271806,481,2907272287,2934446904
2025-06-19 10:40:44,REAL,2907272287,479,2907272766,2934447383
2025-06-19 10:40:46,REAL,2907272766,484,2907273250,2934447867
2025-06-19 10:40:48,REAL,2907273250,10128,2907283378,2934457995
2025-06-19 10:40:50,REAL,2907283378,10376,2907293754,2934468371
2025-06-19 10:40:52,REAL,2907293754,10311,2907304065,2934478682
2025-06-19 10:40:54,REAL,2907304065,10251,2907314316,2934488933
2025-06-19 10:40:56,REAL,2907314316,10313,2907324629,2934499246
2025-06-19 10:40:58,REAL,2907324629,10247,2907334876,2934509493
2025-06-19 10:41:00,REAL,2907334876,10250,2907345126,2934519743
2025-06-19 10:41:02,FAKE,2907345126,238,2907345364,2934526563
2025-06-19 10:41:04,REAL,2907345364,474,2907345838,2934527037
2025-06-19 10:41:06,REAL,2907345838,543,2907346381,2934527580
2025-06-19 10:41:08,FAKE,2907346381,244,2907346625,2934532754
2025-06-19 10:41:10,REAL,2907346625,10983,2907357608,2934543737
2025-06-19 10:41:12,REAL,2907357608,10249,2907367857,2934553986
2025-06-19 10:41:14,REAL,2907367857,10254,2907378111,2934564240
2025-06-19 10:41:16,REAL,2907378111,10253,2907388364,2934574493
2025-06-19 10:41:18,FAKE,2907388364,241,2907388605,2934584816
2025-06-19 10:41:20,REAL,2907388605,10252,2907398857,2934595068
2025-06-19 10:41:22,FAKE,2907398857,241,2907399098,2934605388
2025-06-19 10:41:24,REAL,2907399098,1540,2907400638,2934606928
2025-06-19 10:41:26,REAL,2907400638,488,2907401126,2934607416
2025-06-19 10:41:28,FAKE,2907401126,241,2907401367,2934607905
2025-06-19 10:41:30,REAL,2907401367,487,2907401854,2934608392
2025-06-19 10:41:32,REAL,2907401854,486,2907402340,2934608878
2025-06-19 10:41:34,REAL,2907402340,483,2907402823,2934609361
2025-06-19 10:41:36,FAKE,2907402823,243,2907403066,2934609847
2025-06-19 10:41:38,FAKE,2907403066,241,2907403307,2934610387
2025-06-19 10:41:40,REAL,2907403307,7026,2907410333,2934617413
2025-06-19 10:41:42,FAKE,2907410333,243,2907410576,2934630957
2025-06-19 10:41:44,REAL,2907410576,10316,2907420892,2934641273
2025-06-19 10:41:46,FAKE,2907420892,243,2907421135,2934651523
2025-06-19 10:41:48,FAKE,2907421135,243,2907421378,2934661841
2025-06-19 10:41:50,REAL,2907421378,10251,2907431629,2934672092
2025-06-19 10:41:52,REAL,2907431629,10319,2907441948,2934682411
2025-06-19 10:41:54,REAL,2907441948,10247,2907452195,2934692658
2025-06-19 10:41:56,REAL,2907452195,945,2907453140,2934693603
2025-06-19 10:41:58,FAKE,2907453140,238,2907453378,2934694091
2025-06-19 10:42:00,REAL,2907453378,493,2907453871,2934694584
2025-06-19 10:42:02,REAL,2907453871,479,2907454350,2934695063
2025-06-19 10:42:04,REAL,2907454350,487,2907454837,2934695550
2025-06-19 10:42:06,REAL,2907454837,489,2907455326,2934696039
2025-06-19 10:42:08,FAKE,2907455326,238,2907455564,2934696513
2025-06-19 10:42:10,REAL,2907455564,538,2907456102,2934697051
2025-06-19 10:42:12,FAKE,2907456102,238,2907456340,2934704212
2025-06-19 10:42:14,REAL,2907456340,13028,2907469368,2934717240
2025-06-19 10:42:16,REAL,2907469368,10324,2907479692,2934727564
2025-06-19 10:42:18,REAL,2907479692,10251,2907489943,2934737815
2025-06-19 10:42:20,FAKE,2907489943,241,2907490184,2934748129
2025-06-19 10:42:22,FAKE,2907490184,243,2907490427,2934758380
2025-06-19 10:42:24,REAL,2907490427,10250,2907500677,2934768630
2025-06-19 10:42:26,FAKE,2907500677,244,2907500921,2934778754
2025-06-19 10:42:28,REAL,2907500921,481,2907501402,2934779235
2025-06-19 10:42:30,REAL,2907501402,488,2907501890,2934779723
2025-06-19 10:42:32,REAL,2907501890,762,2907502652,2934780485
2025-06-19 10:42:34,REAL,2907502652,12509,2907515161,2934792994
2025-06-19 10:42:36,FAKE,2907515161,244,2907515405,2934803244
2025-06-19 10:42:38,REAL,2907515405,10251,2907525656,2934813495
2025-06-19 10:42:40,REAL,2907525656,10248,2907535904,2934823743
2025-06-19 10:42:42,FAKE,2907535904,244,2907536148,2934833991
2025-06-19 10:42:44,REAL,2907536148,10367,2907546515,2934844358
2025-06-19 10:42:46,REAL,2907546515,10256,2907556771,2934854614
2025-06-19 10:42:48,REAL,2907556771,4839,2907561610,2934859453
2025-06-19 10:42:50,REAL,2907561610,486,2907562096,2934859939
2025-06-19 10:42:52,REAL,2907562096,484,2907562580,2934860423
2025-06-19 10:42:54,REAL,2907562580,7232,2907569812,2934867655
2025-06-19 10:42:56,REAL,2907569812,10987,2907580799,2934878642
2025-06-19 10:42:58,REAL,2907580799,10260,2907591059,2934888902
2025-06-19 10:43:00,REAL,2907591059,10250,2907601309,2934899152
2025-06-19 10:43:02,REAL,2907601309,10259,2907611568,2934909411
2025-06-19 10:43:04,REAL,2907611568,10256,2907621824,2934919667
2025-06-19 10:43:06,REAL,2907621824,10326,2907632150,2934929993
2025-06-19 10:43:08,REAL,2907632150,9400,2907641550,2934939393
2025-06-19 10:43:10,FAKE,2907641550,241,2907641791,2934939877
2025-06-19 10:43:12,REAL,2907641791,478,2907642269,2934940355
2025-06-19 10:43:14,FAKE,2907642269,241,2907642510,2934940841
2025-06-19 10:43:16,REAL,2907642510,546,2907643056,2934941387
2025-06-19 10:43:18,REAL,2907643056,479,2907643535,2934941866
2025-06-19 10:43:20,REAL,2907643535,481,2907644016,2934942347
2025-06-19 10:43:22,REAL,2907644016,479,2907644495,2934942826
2025-06-19 10:43:24,REAL,2907644495,488,2907644983,2934943314
2025-06-19 10:43:26,REAL,2907644983,9997,2907654980,2934953311
2025-06-19 10:43:28,REAL,2907654980,12040,2907667020,2934965351
2025-06-19 10:43:30,REAL,2907667020,10316,2907677336,2934975667
2025-06-19 10:43:32,FAKE,2907677336,244,2907677580,2934985924
2025-06-19 10:43:34,FAKE,2907677580,238,2907677818,2934996240
2025-06-19 10:43:36,FAKE,2907677818,243,2907678061,2935006499
2025-06-19 10:43:38,FAKE,2907678061,244,2907678305,2935016827
2025-06-19 10:43:40,REAL,2907678305,8737,2907687042,2935025564
2025-06-19 10:43:42,REAL,2907687042,488,2907687530,2935026052
2025-06-19 10:43:44,FAKE,2907687530,238,2907687768,2935026529
2025-06-19 10:43:46,FAKE,2907687768,238,2907688006,2935027014
2025-06-19 10:43:48,REAL,2907688006,483,2907688489,2935027497
2025-06-19 10:43:50,REAL,2907688489,543,2907689032,2935028040
2025-06-19 10:43:52,REAL,2907689032,485,2907689517,2935028525
2025-06-19 10:43:54,REAL,2907689517,476,2907689993,2935029001
2025-06-19 10:43:56,REAL,2907689993,2539,2907692532,2935031540
2025-06-19 10:43:58,REAL,2907692532,12034,2907704566,2935043574
2025-06-19 10:44:00,REAL,2907704566,10253,2907714819,2935053827
2025-06-19 10:44:02,REAL,2907714819,10317,2907725136,2935064144
2025-06-19 10:44:04,REAL,2907725136,10251,2907735387,2935074395
2025-06-19 10:44:06,REAL,2907735387,10246,2907745633,2935084641
2025-06-19 10:44:08,FAKE,2907745633,243,2907745876,2935094952
2025-06-19 10:44:10,REAL,2907745876,10256,2907756132,2935105208
2025-06-19 10:44:12,REAL,2907756132,3588,2907759720,2935108796
2025-06-19 10:44:14,REAL,2907759720,477,2907760197,2935109273
2025-06-19 10:44:16,REAL,2907760197,491,2907760688,2935109764
2025-06-19 10:44:18,FAKE,2907760688,243,2907760931,2935110248
2025-06-19 10:44:20,REAL,2907760931,483,2907761414,2935110731
2025-06-19 10:44:22,FAKE,2907761414,243,2907761657,2935111269
2025-06-19 10:44:24,REAL,2907761657,477,2907762134,2935111746
2025-06-19 10:44:26,REAL,2907762134,490,2907762624,2935112236
2025-06-19 10:44:28,REAL,2907762624,3722,2907766346,2935115958
2025-06-19 10:44:30,REAL,2907766346,15266,2907781612,2935131224
2025-06-19 10:44:32,FAKE,2907781612,243,2907781855,2935141541
2025-06-19 10:44:34,FAKE,2907781855,243,2907782098,2935151797
2025-06-19 10:44:36,REAL,2907782098,10315,2907792413,2935162112
2025-06-19 10:44:38,REAL,2907792413,10249,2907802662,2935172361
2025-06-19 10:44:40,FAKE,2907802662,244,2907802906,2935182621
2025-06-19 10:44:42,REAL,2907802906,10254,2907813160,2935192875
2025-06-19 10:44:44,REAL,2907813160,2988,2907816148,2935195863
2025-06-19 10:44:46,FAKE,2907816148,244,2907816392,2935196342
2025-06-19 10:44:48,FAKE,2907816392,243,2907816635,2935196831
2025-06-19 10:44:50,REAL,2907816635,10008,2907826643,2935206839
2025-06-19 10:44:52,FAKE,2907826643,243,2907826886,2935217614
2025-06-19 10:44:54,REAL,2907826886,10252,2907837138,2935227866
2025-06-19 10:44:56,REAL,2907837138,10312,2907847450,2935238178
2025-06-19 10:44:58,REAL,2907847450,10317,2907857767,2935248495
2025-06-19 10:45:00,FAKE,2907857767,238,2907858005,2935258742
2025-06-19 10:45:02,REAL,2907858005,10260,2907868265,2935269002
2025-06-19 10:45:04,FAKE,2907868265,238,2907868503,2935276551
2025-06-19 10:45:06,FAKE,2907868503,244,2907868747,2935276792
2025-06-19 10:45:08,REAL,2907868747,488,2907869235,2935277280
2025-06-19 10:45:10,REAL,2907869235,482,2907869717,2935277762
2025-06-19 10:45:12,FAKE,2907869717,244,2907869961,2935278244
2025-06-19 10:45:14,REAL,2907869961,487,2907870448,2935278731
2025-06-19 10:45:16,REAL,2907870448,482,2907870930,2935279213
2025-06-19 10:45:18,REAL,2907870930,475,2907871405,2935279688
2025-06-19 10:45:20,REAL,2907871405,489,2907871894,2935280177
2025-06-19 10:45:22,REAL,2907871894,10318,2907882212,2935290495
2025-06-19 10:45:24,REAL,2907882212,10384,2907892596,2935300879
2025-06-19 10:45:26,REAL,2907892596,10251,2907902847,2935311130
2025-06-19 10:45:28,FAKE,2907902847,244,2907903091,2935321433
2025-06-19 10:45:30,FAKE,2907903091,241,2907903332,2935331688
2025-06-19 10:45:32,FAKE,2907903332,241,2907903573,2935341935
2025-06-19 10:45:34,REAL,2907903573,10258,2907913831,2935352193
2025-06-19 10:45:36,REAL,2907913831,6881,2907920712,2935359074
2025-06-19 10:45:38,FAKE,2907920712,238,2907920950,2935359557
2025-06-19 10:45:40,REAL,2907920950,489,2907921439,2935360046
2025-06-19 10:45:42,FAKE,2907921439,238,2907921677,2935364965
2025-06-19 10:45:44,REAL,2907921677,13682,2907935359,2935378647
2025-06-19 10:45:46,REAL,2907935359,10258,2907945617,2935388905
2025-06-19 10:45:48,REAL,2907945617,10247,2907955864,2935399152
2025-06-19 10:45:50,REAL,2907955864,10309,2907966173,2935409461
2025-06-19 10:45:52,REAL,2907966173,10254,2907976427,2935419715
2025-06-19 10:45:54,REAL,2907976427,10256,2907986683,2935429971
2025-06-19 10:45:56,FAKE,2907986683,241,2907986924,2935440293
2025-06-19 10:45:58,FAKE,2907986924,243,2907987167,2935441970
2025-06-19 10:46:00,REAL,2907987167,544,2907987711,2935442514
2025-06-19 10:46:02,FAKE,2907987711,243,2907987954,2935442998
2025-06-19 10:46:04,REAL,2907987954,485,2907988439,2935443483
2025-06-19 10:46:06,FAKE,2907988439,244,2907988683,2935443964
2025-06-19 10:46:08,FAKE,2907988683,241,2907988924,2935444438
2025-06-19 10:46:10,REAL,2907988924,488,2907989412,2935444926
2025-06-19 10:46:12,REAL,2907989412,491,2907989903,2935445417
2025-06-19 10:46:14,REAL,2907989903,476,2907990379,2935445893
2025-06-19 10:46:16,REAL,2907990379,479,2907990858,2935446372
2025-06-19 10:46:18,REAL,2907990858,490,2907991348,2935446862
2025-06-19 10:46:20,FAKE,2907991348,243,2907991591,2935447343
2025-06-19 10:46:22,REAL,2907991591,489,2907992080,2935447832
2025-06-19 10:46:24,REAL,2907992080,5184,2907997264,2935453016
2025-06-19 10:46:26,FAKE,2907997264,243,2907997507,2935464379
2025-06-19 10:46:28,REAL,2907997507,10250,2908007757,2935474629
2025-06-19 10:46:30,REAL,2908007757,10319,2908018076,2935484948
2025-06-19 10:46:32,REAL,2908018076,10256,2908028332,2935495204
2025-06-19 10:46:34,FAKE,2908028332,241,2908028573,2935505529
2025-06-19 10:46:36,REAL,2908028573,10254,2908038827,2935515783
2025-06-19 10:46:38,REAL,2908038827,10316,2908049143,2935526099
2025-06-19 10:46:40,REAL,2908049143,1072,2908050215,2935527171
2025-06-19 10:46:42,REAL,2908050215,483,2908050698,2935527654
2025-06-19 10:46:44,REAL,2908050698,482,2908051180,2935528136
2025-06-19 10:46:46,REAL,2908051180,480,2908051660,2935528616
2025-06-19 10:46:48,REAL,2908051660,474,2908052134,2935529090
2025-06-19 10:46:50,REAL,2908052134,484,2908052618,2935529574
2025-06-19 10:46:52,REAL,2908052618,533,2908053151,2935530107
2025-06-19 10:46:54,FAKE,2908053151,238,2908053389,2935530590
2025-06-19 10:46:56,FAKE,2908053389,238,2908053627,2935531072
2025-06-19 10:46:58,REAL,2908053627,492,2908054119,2935531564
2025-06-19 10:47:00,FAKE,2908054119,243,2908054362,2935532048
2025-06-19 10:47:02,FAKE,2908054362,238,2908054600,2935532528
2025-06-19 10:47:04,FAKE,2908054600,243,2908054843,2935533017
2025-06-19 10:47:06,REAL,2908054843,479,2908055322,2935533496
2025-06-19 10:47:08,REAL,2908055322,484,2908055806,2935533980
2025-06-19 10:47:10,REAL,2908055806,487,2908056293,2935534467
2025-06-19 10:47:12,REAL,2908056293,480,2908056773,2935534947
2025-06-19 10:47:14,REAL,2908056773,534,2908057307,2935535481
2025-06-19 10:47:16,REAL,2908057307,546,2908057853,2935536027
2025-06-19 10:47:18,FAKE,2908057853,241,2908058094,2935536509
2025-06-19 10:47:20,FAKE,2908058094,241,2908058335,2935536991
2025-06-19 10:47:22,FAKE,2908058335,243,2908058578,2935537475
2025-06-19 10:47:24,REAL,2908058578,488,2908059066,2935537963
2025-06-19 10:47:26,REAL,2908059066,484,2908059550,2935538447
2025-06-19 10:47:28,REAL,2908059550,475,2908060025,2935538922
2025-06-19 10:47:30,REAL,2908060025,488,2908060513,2935539410
2025-06-19 10:47:32,REAL,2908060513,482,2908060995,2935539892
2025-06-19 10:47:34,REAL,2908060995,476,2908061471,2935540368
2025-06-19 10:47:36,REAL,2908061471,480,2908061951,2935540848
2025-06-19 10:47:38,REAL,2908061951,483,2908062434,2935541331
2025-06-19 10:47:40,FAKE,2908062434,244,2908062678,2935541811
2025-06-19 10:47:42,FAKE,2908062678,244,2908062922,2935542299
2025-06-19 10:47:44,REAL,2908062922,8406,2908071328,2935550705
2025-06-19 10:47:46,REAL,2908071328,10725,2908082053,2935561430
2025-06-19 10:47:48,FAKE,2908082053,243,2908082296,2935571742
2025-06-19 10:47:50,FAKE,2908082296,241,2908082537,2935581995
2025-06-19 10:47:52,REAL,2908082537,10253,2908092790,2935592248
2025-06-19 10:47:54,REAL,2908092790,10320,2908103110,2935602568
2025-06-19 10:47:56,REAL,2908103110,10254,2908113364,2935612822
2025-06-19 10:47:58,REAL,2908113364,9328,2908122692,2935622150
2025-06-19 10:48:00,FAKE,2908122692,243,2908122935,2935622632
2025-06-19 10:48:02,REAL,2908122935,492,2908123427,2935623124
2025-06-19 10:48:04,REAL,2908123427,490,2908123917,2935623614
2025-06-19 10:48:06,FAKE,2908123917,241,2908124158,2935624097
2025-06-19 10:48:08,REAL,2908124158,480,2908124638,2935624577
2025-06-19 10:48:10,REAL,2908124638,534,2908125172,2935625111
2025-06-19 10:48:12,REAL,2908125172,477,2908125649,2935625588
2025-06-19 10:48:14,REAL,2908125649,485,2908126134,2935626073
2025-06-19 10:48:16,REAL,2908126134,7875,2908134009,2935633948
2025-06-19 10:48:18,FAKE,2908134009,243,2908134252,2935644994
2025-06-19 10:48:20,REAL,2908134252,10251,2908144503,2935655245
2025-06-19 10:48:22,REAL,2908144503,10326,2908154829,2935665571
2025-06-19 10:48:24,REAL,2908154829,10254,2908165083,2935675825
2025-06-19 10:48:26,FAKE,2908165083,238,2908165321,2935686149
2025-06-19 10:48:28,FAKE,2908165321,243,2908165564,2935696408
2025-06-19 10:48:30,FAKE,2908165564,243,2908165807,2935705134
2025-06-19 10:48:32,FAKE,2908165807,238,2908166045,2935705611
2025-06-19 10:48:34,REAL,2908166045,542,2908166587,2935706153
2025-06-19 10:48:36,REAL,2908166587,2671,2908169258,2935708824
2025-06-19 10:48:38,FAKE,2908169258,244,2908169502,2935723761
2025-06-19 10:48:40,REAL,2908169502,10318,2908179820,2935734079
2025-06-19 10:48:42,FAKE,2908179820,238,2908180058,2935744329
2025-06-19 10:48:44,FAKE,2908180058,243,2908180301,2935754587
2025-06-19 10:48:46,REAL,2908180301,10318,2908190619,2935764905
2025-06-19 10:48:48,FAKE,2908190619,241,2908190860,2935775164
2025-06-19 10:48:50,REAL,2908190860,10326,2908201186,2935785490
2025-06-19 10:48:52,REAL,2908201186,3448,2908204634,2935788938
2025-06-19 10:48:54,REAL,2908204634,484,2908205118,2935789422
2025-06-19 10:48:56,REAL,2908205118,481,2908205599,2935789903
2025-06-19 10:48:58,REAL,2908205599,8477,2908214076,2935798380
2025-06-19 10:49:00,REAL,2908214076,10919,2908224995,2935809299
2025-06-19 10:49:02,REAL,2908224995,10244,2908235239,2935819543
2025-06-19 10:49:04,REAL,2908235239,10248,2908245487,2935829791
2025-06-19 10:49:06,REAL,2908245487,10317,2908255804,2935840108
2025-06-19 10:49:08,REAL,2908255804,10257,2908266061,2935850365
2025-06-19 10:49:10,REAL,2908266061,10315,2908276376,2935860680
2025-06-19 10:49:12,FAKE,2908276376,244,2908276620,2935868816
2025-06-19 10:49:14,REAL,2908276620,486,2908277106,2935869302
2025-06-19 10:49:16,REAL,2908277106,483,2908277589,2935869785
2025-06-19 10:49:18,REAL,2908277589,489,2908278078,2935870274
2025-06-19 10:49:20,FAKE,2908278078,243,2908278321,2935870756
2025-06-19 10:49:22,REAL,2908278321,486,2908278807,2935871242
2025-06-19 10:49:24,REAL,2908278807,483,2908279290,2935871725
2025-06-19 10:49:26,FAKE,2908279290,244,2908279534,2935872269
2025-06-19 10:49:28,REAL,2908279534,478,2908280012,2935872747
2025-06-19 10:49:30,FAKE,2908280012,243,2908280255,2935873281
2025-06-19 10:49:32,REAL,2908280255,482,2908280737,2935873763
2025-06-19 10:49:34,REAL,2908280737,486,2908281223,2935874249
2025-06-19 10:49:36,REAL,2908281223,481,2908281704,2935874730
2025-06-19 10:49:38,REAL,2908281704,485,2908282189,2935875215
2025-06-19 10:49:40,FAKE,2908282189,243,2908282432,2935886930
2025-06-19 10:49:42,REAL,2908282432,11264,2908293696,2935898194
2025-06-19 10:49:44,FAKE,2908293696,238,2908293934,2935908509
2025-06-19 10:49:46,REAL,2908293934,10256,2908304190,2935918765
2025-06-19 10:49:48,REAL,2908304190,10320,2908314510,2935929085
2025-06-19 10:49:50,REAL,2908314510,10248,2908324758,2935939333
2025-06-19 10:49:52,REAL,2908324758,10375,2908335133,2935949708
2025-06-19 10:49:54,FAKE,2908335133,241,2908335374,2935957311
2025-06-19 10:49:56,FAKE,2908335374,238,2908335612,2935957801
2025-06-19 10:49:58,FAKE,2908335612,244,2908335856,2935958281
2025-06-19 10:50:00,REAL,2908335856,478,2908336334,2935958759
2025-06-19 10:50:02,FAKE,2908336334,241,2908336575,2935959243
2025-06-19 10:50:04,REAL,2908336575,483,2908337058,2935959726
2025-06-19 10:50:06,FAKE,2908337058,243,2908337301,2935960207
2025-06-19 10:50:08,REAL,2908337301,484,2908337785,2935960691
2025-06-19 10:50:10,REAL,2908337785,483,2908338268,2935961174
2025-06-19 10:50:12,REAL,2908338268,540,2908338808,2935961714
2025-06-19 10:50:14,REAL,2908338808,482,2908339290,2935962196
2025-06-19 10:50:16,REAL,2908339290,544,2908339834,2935962740
2025-06-19 10:50:18,REAL,2908339834,476,2908340310,2935963216
2025-06-19 10:50:20,REAL,2908340310,486,2908340796,2935963702
2025-06-19 10:50:22,REAL,2908340796,482,2908341278,2935964184
2025-06-19 10:50:24,REAL,2908341278,485,2908341763,2935964669
2025-06-19 10:50:26,REAL,2908341763,489,2908342252,2935965158
2025-06-19 10:50:28,FAKE,2908342252,241,2908342493,2935965641
2025-06-19 10:50:30,FAKE,2908342493,238,2908342731,2935966122
2025-06-19 10:50:32,REAL,2908342731,4977,2908347708,2935971099
2025-06-19 10:50:34,FAKE,2908347708,243,2908347951,2935982734
2025-06-19 10:50:36,REAL,2908347951,10254,2908358205,2935992988
2025-06-19 10:50:38,REAL,2908358205,10251,2908368456,2936003239
2025-06-19 10:50:40,REAL,2908368456,10248,2908378704,2936013487
2025-06-19 10:50:42,REAL,2908378704,10252,2908388956,2936023739
2025-06-19 10:50:44,FAKE,2908388956,244,2908389200,2936034112
2025-06-19 10:50:46,REAL,2908389200,10252,2908399452,2936044364
2025-06-19 10:50:48,REAL,2908399452,1736,2908401188,2936046100
2025-06-19 10:50:50,REAL,2908401188,485,2908401673,2936046585
2025-06-19 10:50:52,REAL,2908401673,487,2908402160,2936047072
2025-06-19 10:50:54,REAL,2908402160,475,2908402635,2936047547
2025-06-19 10:50:56,REAL,2908402635,486,2908403121,2936048033
2025-06-19 10:50:58,FAKE,2908403121,241,2908403362,2936048518
2025-06-19 10:51:00,REAL,2908403362,487,2908403849,2936049005
2025-06-19 10:51:02,REAL,2908403849,482,2908404331,2936049487
2025-06-19 10:51:04,REAL,2908404331,486,2908404817,2936049973
2025-06-19 10:51:06,REAL,2908404817,544,2908405361,2936050517
2025-06-19 10:51:08,REAL,2908405361,477,2908405838,2936050994
2025-06-19 10:51:10,REAL,2908405838,494,2908406332,2936051488
2025-06-19 10:51:12,FAKE,2908406332,238,2908406570,2936051974
2025-06-19 10:51:14,REAL,2908406570,537,2908407107,2936052511
2025-06-19 10:51:16,REAL,2908407107,474,2908407581,2936052985
2025-06-19 10:51:18,REAL,2908407581,483,2908408064,2936053468
2025-06-19 10:51:20,REAL,2908408064,485,2908408549,2936053953
2025-06-19 10:51:22,FAKE,2908408549,241,2908408790,2936054441
2025-06-19 10:51:24,REAL,2908408790,482,2908409272,2936054923
2025-06-19 10:51:26,REAL,2908409272,484,2908409756,2936055407
2025-06-19 10:51:28,REAL,2908409756,479,2908410235,2936055886
2025-06-19 10:51:30,FAKE,2908410235,244,2908410479,2936056365
2025-06-19 10:51:32,FAKE,2908410479,244,2908410723,2936056846
2025-06-19 10:51:34,REAL,2908410723,485,2908411208,2936057331
2025-06-19 10:51:36,REAL,2908411208,6303,2908417511,2936063634
2025-06-19 10:51:38,REAL,2908417511,11193,2908428704,2936074827
2025-06-19 10:51:40,REAL,2908428704,10248,2908438952,2936085075
2025-06-19 10:51:42,REAL,2908438952,10323,2908449275,2936095398
2025-06-19 10:51:44,REAL,2908449275,10311,2908459586,2936105709
2025-06-19 10:51:46,REAL,2908459586,10253,2908469839,2936115962
2025-06-19 10:51:48,FAKE,2908469839,244,2908470083,2936126287
2025-06-19 10:51:50,FAKE,2908470083,238,2908470321,2936136531
2025-06-19 10:51:52,REAL,2908470321,482,2908470803,2936137013
2025-06-19 10:51:54,FAKE,2908470803,241,2908471044,2936137487
2025-06-19 10:51:56,REAL,2908471044,488,2908471532,2936137975
2025-06-19 10:51:58,FAKE,2908471532,244,2908471776,2936138457
2025-06-19 10:52:00,REAL,2908471776,487,2908472263,2936138944
2025-06-19 10:52:02,REAL,2908472263,491,2908472754,2936139435
2025-06-19 10:52:04,FAKE,2908472754,238,2908472992,2936139920
2025-06-19 10:52:06,REAL,2908472992,485,2908473477,2936140405
2025-06-19 10:52:08,REAL,2908473477,7558,2908481035,2936147963
2025-06-19 10:52:10,FAKE,2908481035,244,2908481279,2936160924
2025-06-19 10:52:12,REAL,2908481279,10318,2908491597,2936171242
2025-06-19 10:52:14,FAKE,2908491597,244,2908491841,2936181565
2025-06-19 10:52:16,REAL,2908491841,10315,2908502156,2936191880
2025-06-19 10:52:18,REAL,2908502156,10251,2908512407,2936202131
2025-06-19 10:52:20,FAKE,2908512407,241,2908512648,2936212445
2025-06-19 10:52:22,REAL,2908512648,9595,2908522243,2936222040
2025-06-19 10:52:24,REAL,2908522243,482,2908522725,2936222522
2025-06-19 10:52:26,REAL,2908522725,478,2908523203,2936223000
2025-06-19 10:52:28,REAL,2908523203,481,2908523684,2936223481
2025-06-19 10:52:30,FAKE,2908523684,238,2908523922,2936223969
2025-06-19 10:52:32,REAL,2908523922,488,2908524410,2936224457
2025-06-19 10:52:34,REAL,2908524410,488,2908524898,2936224945
2025-06-19 10:52:36,REAL,2908524898,488,2908525386,2936225433
2025-06-19 10:52:38,REAL,2908525386,486,2908525872,2936225919
2025-06-19 10:52:40,REAL,2908525872,482,2908526354,2936226401
2025-06-19 10:52:42,REAL,2908526354,544,2908526898,2936226945
2025-06-19 10:52:44,REAL,2908526898,493,2908527391,2936227438
2025-06-19 10:52:46,REAL,2908527391,546,2908527937,2936227984
2025-06-19 10:52:48,REAL,2908527937,483,2908528420,2936228467
2025-06-19 10:52:50,REAL,2908528420,482,2908528902,2936228949
2025-06-19 10:52:52,REAL,2908528902,488,2908529390,2936229437
2025-06-19 10:52:54,REAL,2908529390,489,2908529879,2936229926
2025-06-19 10:52:56,REAL,2908529879,484,2908530363,2936230410
2025-06-19 10:52:58,FAKE,2908530363,243,2908530606,2936230896
2025-06-19 10:53:00,REAL,2908530606,482,2908531088,2936231378
2025-06-19 10:53:02,FAKE,2908531088,244,2908531332,2936231864
2025-06-19 10:53:04,FAKE,2908531332,238,2908531570,2936232348
2025-06-19 10:53:06,FAKE,2908531570,238,2908531808,2936232835
2025-06-19 10:53:08,REAL,2908531808,482,2908532290,2936233317
2025-06-19 10:53:10,REAL,2908532290,484,2908532774,2936233801
2025-06-19 10:53:12,REAL,2908532774,484,2908533258,2936234285
2025-06-19 10:53:14,FAKE,2908533258,241,2908533499,2936234769
2025-06-19 10:53:16,FAKE,2908533499,241,2908533740,2936235306
2025-06-19 10:53:18,FAKE,2908533740,238,2908533978,2936235797
2025-06-19 10:53:20,FAKE,2908533978,244,2908534222,2936236286
2025-06-19 10:53:22,REAL,2908534222,484,2908534706,2936236770
2025-06-19 10:53:24,REAL,2908534706,481,2908535187,2936237251
2025-06-19 10:53:26,REAL,2908535187,537,2908535724,2936237788
2025-06-19 10:53:28,REAL,2908535724,8811,2908544535,2936246599
2025-06-19 10:53:30,REAL,2908544535,10525,2908555060,2936257124
2025-06-19 10:53:32,REAL,2908555060,10245,2908565305,2936267369
2025-06-19 10:53:34,REAL,2908565305,10322,2908575627,2936277691
2025-06-19 10:53:36,REAL,2908575627,10258,2908585885,2936287949
2025-06-19 10:53:38,FAKE,2908585885,241,2908586126,2936298205
2025-06-19 10:53:40,FAKE,2908586126,244,2908586370,2936308526
2025-06-19 10:53:42,REAL,2908586370,8011,2908594381,2936316537
2025-06-19 10:53:44,FAKE,2908594381,238,2908594619,2936317019
2025-06-19 10:53:46,REAL,2908594619,479,2908595098,2936317498
2025-06-19 10:53:48,FAKE,2908595098,238,2908595336,2936320951
2025-06-19 10:53:50,REAL,2908595336,11573,2908606909,2936332524
2025-06-19 10:53:52,FAKE,2908606909,241,2908607150,2936342786
2025-06-19 10:53:54,REAL,2908607150,10252,2908617402,2936353038
2025-06-19 10:53:56,REAL,2908617402,10251,2908627653,2936363289
2025-06-19 10:53:58,REAL,2908627653,10309,2908637962,2936373598
2025-06-19 10:54:00,FAKE,2908637962,241,2908638203,2936383851
2025-06-19 10:54:02,REAL,2908638203,10255,2908648458,2936394106
2025-06-19 10:54:04,FAKE,2908648458,243,2908648701,2936396970
2025-06-19 10:54:06,REAL,2908648701,483,2908649184,2936397453
2025-06-19 10:54:08,REAL,2908649184,488,2908649672,2936397941
2025-06-19 10:54:10,REAL,2908649672,483,2908650155,2936398424
2025-06-19 10:54:12,FAKE,2908650155,243,2908650398,2936398912
2025-06-19 10:54:14,FAKE,2908650398,241,2908650639,2936399396
2025-06-19 10:54:16,FAKE,2908650639,243,2908650882,2936399881
2025-06-19 10:54:18,REAL,2908650882,539,2908651421,2936400420
2025-06-19 10:54:20,REAL,2908651421,484,2908651905,2936400904
2025-06-19 10:54:22,REAL,2908651905,480,2908652385,2936401384
2025-06-19 10:54:24,FAKE,2908652385,241,2908652626,2936401859
2025-06-19 10:54:26,REAL,2908652626,481,2908653107,2936402340
2025-06-19 10:54:28,REAL,2908653107,482,2908653589,2936402822
2025-06-19 10:54:30,REAL,2908653589,487,2908654076,2936403309
2025-06-19 10:54:32,REAL,2908654076,488,2908654564,2936403797
2025-06-19 10:54:34,FAKE,2908654564,243,2908654807,2936404340
2025-06-19 10:54:36,FAKE,2908654807,244,2908655051,2936404818
2025-06-19 10:54:38,REAL,2908655051,482,2908655533,2936405300
2025-06-19 10:54:40,REAL,2908655533,485,2908656018,2936405785
2025-06-19 10:54:42,REAL,2908656018,482,2908656500,2936406267
2025-06-19 10:54:44,REAL,2908656500,488,2908656988,2936406755
2025-06-19 10:54:46,REAL,2908656988,488,2908657476,2936407243
2025-06-19 10:54:48,FAKE,2908657476,243,2908657719,2936407785
2025-06-19 10:54:50,FAKE,2908657719,238,2908657957,2936408267
2025-06-19 10:54:52,FAKE,2908657957,241,2908658198,2936408755
2025-06-19 10:54:54,REAL,2908658198,474,2908658672,2936409229
2025-06-19 10:54:56,REAL,2908658672,484,2908659156,2936409713
2025-06-19 10:54:58,REAL,2908659156,486,2908659642,2936410199
2025-06-19 10:55:00,FAKE,2908659642,243,2908659885,2936410687
2025-06-19 10:55:02,REAL,2908659885,484,2908660369,2936411171
2025-06-19 10:55:04,FAKE,2908660369,244,2908660613,2936411648
2025-06-19 10:55:06,REAL,2908660613,480,2908661093,2936412128
2025-06-19 10:55:08,FAKE,2908661093,241,2908661334,2936412613
2025-06-19 10:55:10,FAKE,2908661334,244,2908661578,2936413094
2025-06-19 10:55:12,REAL,2908661578,478,2908662056,2936413572
2025-06-19 10:55:14,REAL,2908662056,485,2908662541,2936414057
2025-06-19 10:55:16,REAL,2908662541,483,2908663024,2936414540
2025-06-19 10:55:18,REAL,2908663024,546,2908663570,2936415086
2025-06-19 10:55:20,REAL,2908663570,539,2908664109,2936415625
2025-06-19 10:55:22,REAL,2908664109,487,2908664596,2936416112
2025-06-19 10:55:24,REAL,2908664596,482,2908665078,2936416594
2025-06-19 10:55:26,REAL,2908665078,482,2908665560,2936417076
2025-06-19 10:55:28,REAL,2908665560,480,2908666040,2936417556
2025-06-19 10:55:30,REAL,2908666040,484,2908666524,2936418040
2025-06-19 10:55:32,REAL,2908666524,483,2908667007,2936418523
2025-06-19 10:55:34,REAL,2908667007,487,2908667494,2936419010
2025-06-19 10:55:36,REAL,2908667494,483,2908667977,2936419493
2025-06-19 10:55:38,FAKE,2908667977,244,2908668221,2936419977
2025-06-19 10:55:40,FAKE,2908668221,243,2908668464,2936420465
2025-06-19 10:55:42,REAL,2908668464,479,2908668943,2936420944
2025-06-19 10:55:44,REAL,2908668943,6304,2908675247,2936427248
2025-06-19 10:55:46,REAL,2908675247,11384,2908686631,2936438632
2025-06-19 10:55:48,REAL,2908686631,10254,2908696885,2936448886
2025-06-19 10:55:50,REAL,2908696885,10253,2908707138,2936459139
2025-06-19 10:55:52,FAKE,2908707138,243,2908707381,2936469456
2025-06-19 10:55:54,REAL,2908707381,10244,2908717625,2936479700
2025-06-19 10:55:56,REAL,2908717625,10242,2908727867,2936489942
2025-06-19 10:55:58,FAKE,2908727867,241,2908728108,2936500199
2025-06-19 10:56:00,FAKE,2908728108,244,2908728352,2936501076
2025-06-19 10:56:02,REAL,2908728352,490,2908728842,2936501566
2025-06-19 10:56:04,REAL,2908728842,486,2908729328,2936502052
2025-06-19 10:56:06,FAKE,2908729328,244,2908729572,2936513706
2025-06-19 10:56:08,REAL,2908729572,10261,2908739833,2936523967
2025-06-19 10:56:10,FAKE,2908739833,241,2908740074,2936534228
2025-06-19 10:56:12,REAL,2908740074,10318,2908750392,2936544546
2025-06-19 10:56:14,FAKE,2908750392,241,2908750633,2936554798
2025-06-19 10:56:16,FAKE,2908750633,244,2908750877,2936565113
2025-06-19 10:56:18,REAL,2908750877,10249,2908761126,2936575362
2025-06-19 10:56:20,REAL,2908761126,5310,2908766436,2936580672
2025-06-19 10:56:22,FAKE,2908766436,243,2908766679,2936581154
2025-06-19 10:56:24,FAKE,2908766679,244,2908766923,2936581640
2025-06-19 10:56:26,REAL,2908766923,482,2908767405,2936582122
2025-06-19 10:56:28,REAL,2908767405,487,2908767892,2936582609
2025-06-19 10:56:30,REAL,2908767892,476,2908768368,2936583085
2025-06-19 10:56:32,REAL,2908768368,488,2908768856,2936583573
2025-06-19 10:56:34,REAL,2908768856,480,2908769336,2936584053
2025-06-19 10:56:36,REAL,2908769336,476,2908769812,2936584529
2025-06-19 10:56:38,REAL,2908769812,478,2908770290,2936585007
2025-06-19 10:56:40,FAKE,2908770290,244,2908770534,2936585548
2025-06-19 10:56:42,REAL,2908770534,486,2908771020,2936586034
2025-06-19 10:56:44,REAL,2908771020,479,2908771499,2936586513
2025-06-19 10:56:46,REAL,2908771499,488,2908771987,2936587001
2025-06-19 10:56:48,REAL,2908771987,485,2908772472,2936587486
2025-06-19 10:56:50,FAKE,2908772472,241,2908772713,2936588034
2025-06-19 10:56:52,REAL,2908772713,482,2908773195,2936588516
2025-06-19 10:56:54,REAL,2908773195,488,2908773683,2936589004
2025-06-19 10:56:56,FAKE,2908773683,244,2908773927,2936589490
2025-06-19 10:56:58,REAL,2908773927,492,2908774419,2936589982
2025-06-19 10:57:00,FAKE,2908774419,243,2908774662,2936590456
2025-06-19 10:57:02,FAKE,2908774662,241,2908774903,2936590943
2025-06-19 10:57:04,REAL,2908774903,479,2908775382,2936591422
2025-06-19 10:57:06,FAKE,2908775382,243,2908775625,2936591909
2025-06-19 10:57:08,REAL,2908775625,486,2908776111,2936592395
2025-06-19 10:57:10,REAL,2908776111,480,2908776591,2936592875
2025-06-19 10:57:12,REAL,2908776591,479,2908777070,2936593354
2025-06-19 10:57:14,REAL,2908777070,483,2908777553,2936593837
2025-06-19 10:57:16,REAL,2908777553,477,2908778030,2936594314
2025-06-19 10:57:18,REAL,2908778030,1742,2908779772,2936596056
2025-06-19 10:57:20,FAKE,2908779772,243,2908780015,2936608362
2025-06-19 10:57:22,FAKE,2908780015,241,2908780256,2936618616
2025-06-19 10:57:24,REAL,2908780256,10252,2908790508,2936628868
2025-06-19 10:57:26,REAL,2908790508,10325,2908800833,2936639193
2025-06-19 10:57:28,REAL,2908800833,10246,2908811079,2936649439
2025-06-19 10:57:30,REAL,2908811079,10253,2908821332,2936659692
2025-06-19 10:57:32,REAL,2908821332,10250,2908831582,2936669942
2025-06-19 10:57:34,REAL,2908831582,4183,2908835765,2936674125
2025-06-19 10:57:36,FAKE,2908835765,238,2908836003,2936674608
2025-06-19 10:57:38,REAL,2908836003,494,2908836497,2936675102
2025-06-19 10:57:40,REAL,2908836497,485,2908836982,2936675587
2025-06-19 10:57:42,REAL,2908836982,480,2908837462,2936676067
2025-06-19 10:57:44,REAL,2908837462,487,2908837949,2936676554
2025-06-19 10:57:46,FAKE,2908837949,244,2908838193,2936677036
2025-06-19 10:57:48,FAKE,2908838193,238,2908838431,2936677516
2025-06-19 10:57:50,REAL,2908838431,2476,2908840907,2936679992
2025-06-19 10:57:52,REAL,2908840907,11771,2908852678,2936691763
2025-06-19 10:57:54,FAKE,2908852678,244,2908852922,2936702018
2025-06-19 10:57:56,REAL,2908852922,10260,2908863182,2936712278
2025-06-19 10:57:58,FAKE,2908863182,238,2908863420,2936722600
2025-06-19 10:58:00,REAL,2908863420,10317,2908873737,2936732917
2025-06-19 10:58:02,FAKE,2908873737,243,2908873980,2936743167
2025-06-19 10:58:04,FAKE,2908873980,243,2908874223,2936753426
2025-06-19 10:58:06,REAL,2908874223,3525,2908877748,2936756951
2025-06-19 10:58:08,REAL,2908877748,487,2908878235,2936757438
2025-06-19 10:58:10,REAL,2908878235,490,2908878725,2936757928
2025-06-19 10:58:12,REAL,2908878725,494,2908879219,2936758422
2025-06-19 10:58:14,FAKE,2908879219,238,2908879457,2936758899
2025-06-19 10:58:16,REAL,2908879457,482,2908879939,2936759381
2025-06-19 10:58:18,REAL,2908879939,486,2908880425,2936759867
2025-06-19 10:58:20,REAL,2908880425,481,2908880906,2936760348
2025-06-19 10:58:22,REAL,2908880906,479,2908881385,2936760827
2025-06-19 10:58:24,REAL,2908881385,491,2908881876,2936761318
2025-06-19 10:58:26,REAL,2908881876,483,2908882359,2936761801
2025-06-19 10:58:28,REAL,2908882359,477,2908882836,2936762278
2025-06-19 10:58:30,REAL,2908882836,482,2908883318,2936762760
2025-06-19 10:58:32,REAL,2908883318,487,2908883805,2936763247
2025-06-19 10:58:34,FAKE,2908883805,243,2908884048,2936763726
2025-06-19 10:58:36,REAL,2908884048,490,2908884538,2936764216
2025-06-19 10:58:38,FAKE,2908884538,241,2908884779,2936764705
2025-06-19 10:58:40,REAL,2908884779,540,2908885319,2936765245
2025-06-19 10:58:42,REAL,2908885319,547,2908885866,2936765792
2025-06-19 10:58:44,REAL,2908885866,490,2908886356,2936766282
2025-06-19 10:58:46,REAL,2908886356,477,2908886833,2936766759
2025-06-19 10:58:48,FAKE,2908886833,241,2908887074,2936767235
2025-06-19 10:58:50,REAL,2908887074,485,2908887559,2936767720
2025-06-19 10:58:52,FAKE,2908887559,241,2908887800,2936768207
2025-06-19 10:58:54,FAKE,2908887800,244,2908888044,2936768686
2025-06-19 10:58:56,FAKE,2908888044,244,2908888288,2936769166
2025-06-19 10:58:58,REAL,2908888288,483,2908888771,2936769649
2025-06-19 10:59:00,REAL,2908888771,483,2908889254,2936770132
2025-06-19 10:59:02,REAL,2908889254,486,2908889740,2936770618
2025-06-19 10:59:04,FAKE,2908889740,238,2908889978,2936771105
2025-06-19 10:59:06,REAL,2908889978,482,2908890460,2936771587
2025-06-19 10:59:08,FAKE,2908890460,244,2908890704,2936772061
2025-06-19 10:59:10,REAL,2908890704,480,2908891184,2936772541
2025-06-19 10:59:12,REAL,2908891184,481,2908891665,2936773022
2025-06-19 10:59:14,FAKE,2908891665,241,2908891906,2936773500
2025-06-19 10:59:16,REAL,2908891906,485,2908892391,2936773985
2025-06-19 10:59:18,REAL,2908892391,483,2908892874,2936774468
2025-06-19 10:59:20,FAKE,2908892874,241,2908893115,2936778926
2025-06-19 10:59:22,FAKE,2908893115,243,2908893358,2936790500
2025-06-19 10:59:24,FAKE,2908893358,241,2908893599,2936800805
2025-06-19 10:59:26,REAL,2908893599,10321,2908903920,2936811126
2025-06-19 10:59:28,REAL,2908903920,10257,2908914177,2936821383
2025-06-19 10:59:30,FAKE,2908914177,244,2908914421,2936831641
2025-06-19 10:59:32,REAL,2908914421,10248,2908924669,2936841889
2025-06-19 10:59:34,FAKE,2908924669,238,2908924907,2936852144
2025-06-19 10:59:36,FAKE,2908924907,243,2908925150,2936854020
2025-06-19 10:59:38,REAL,2908925150,484,2908925634,2936854504
2025-06-19 10:59:40,REAL,2908925634,484,2908926118,2936854988
2025-06-19 10:59:42,REAL,2908926118,483,2908926601,2936855471
2025-06-19 10:59:44,REAL,2908926601,485,2908927086,2936855956
2025-06-19 10:59:46,REAL,2908927086,482,2908927568,2936856438
2025-06-19 10:59:48,REAL,2908927568,482,2908928050,2936856920
2025-06-19 10:59:50,FAKE,2908928050,243,2908928293,2936857402
2025-06-19 10:59:52,FAKE,2908928293,244,2908928537,2936857885
2025-06-19 10:59:54,REAL,2908928537,487,2908929024,2936858372
2025-06-19 10:59:56,REAL,2908929024,486,2908929510,2936858858
2025-06-19 10:59:58,REAL,2908929510,486,2908929996,2936859344
2025-06-19 11:00:00,REAL,2908929996,491,2908930487,2936859835
2025-06-19 11:00:02,REAL,2908930487,482,2908930969,2936860317
2025-06-19 11:00:04,FAKE,2908930969,241,2908931210,2936860858
2025-06-19 11:00:06,FAKE,2908931210,243,2908931453,2936861340
2025-06-19 11:00:08,FAKE,2908931453,241,2908931694,2936861824
2025-06-19 11:00:10,FAKE,2908931694,241,2908931935,2936862355
2025-06-19 11:00:12,REAL,2908931935,487,2908932422,2936862842
2025-06-19 11:00:14,REAL,2908932422,555,2908932977,2936863397
2025-06-19 11:00:16,FAKE,2908932977,238,2908933215,2936863876
2025-06-19 11:00:18,FAKE,2908933215,241,2908933456,2936864370
2025-06-19 11:00:20,REAL,2908933456,476,2908933932,2936864846
2025-06-19 11:00:22,FAKE,2908933932,238,2908934170,2936865330
2025-06-19 11:00:24,REAL,2908934170,475,2908934645,2936865805
2025-06-19 11:00:26,REAL,2908934645,480,2908935125,2936866285
2025-06-19 11:00:28,FAKE,2908935125,244,2908935369,2936866768
2025-06-19 11:00:30,REAL,2908935369,490,2908935859,2936867258
2025-06-19 11:00:32,FAKE,2908935859,244,2908936103,2936867745
2025-06-19 11:00:34,FAKE,2908936103,244,2908936347,2936868228
2025-06-19 11:00:36,FAKE,2908936347,243,2908936590,2936868713
2025-06-19 11:00:38,REAL,2908936590,478,2908937068,2936869191
2025-06-19 11:00:40,REAL,2908937068,494,2908937562,2936869685
2025-06-19 11:00:42,REAL,2908937562,479,2908938041,2936870164
2025-06-19 11:00:44,FAKE,2908938041,241,2908938282,2936870703
2025-06-19 11:00:46,REAL,2908938282,484,2908938766,2936871187
2025-06-19 11:00:48,REAL,2908938766,481,2908939247,2936871668
2025-06-19 11:00:50,REAL,2908939247,6755,2908946002,2936878423
2025-06-19 11:00:52,REAL,2908946002,11455,2908957457,2936889878
2025-06-19 11:00:54,FAKE,2908957457,243,2908957700,2936900135
2025-06-19 11:00:56,FAKE,2908957700,244,2908957944,2936910389
2025-06-19 11:00:58,REAL,2908957944,10309,2908968253,2936920698
2025-06-19 11:01:00,FAKE,2908968253,238,2908968491,2936930949
2025-06-19 11:01:02,REAL,2908968491,10251,2908978742,2936941200
2025-06-19 11:01:04,FAKE,2908978742,241,2908978983,2936951259
2025-06-19 11:01:06,FAKE,2908978983,243,2908979226,2936951747
2025-06-19 11:01:08,REAL,2908979226,483,2908979709,2936952230
2025-06-19 11:01:10,REAL,2908979709,493,2908980202,2936952723
2025-06-19 11:01:12,REAL,2908980202,485,2908980687,2936953208
2025-06-19 11:01:14,FAKE,2908980687,238,2908980925,2936953693
2025-06-19 11:01:16,REAL,2908980925,487,2908981412,2936954180
2025-06-19 11:01:18,REAL,2908981412,483,2908981895,2936954663
2025-06-19 11:01:20,REAL,2908981895,480,2908982375,2936955143
2025-06-19 11:01:22,REAL,2908982375,490,2908982865,2936955633
2025-06-19 11:01:24,REAL,2908982865,482,2908983347,2936956115
2025-06-19 11:01:26,REAL,2908983347,488,2908983835,2936956603
2025-06-19 11:01:28,FAKE,2908983835,238,2908984073,2936957083
2025-06-19 11:01:30,FAKE,2908984073,241,2908984314,2936957561
2025-06-19 11:01:32,REAL,2908984314,484,2908984798,2936958045
2025-06-19 11:01:34,REAL,2908984798,485,2908985283,2936958530
2025-06-19 11:01:36,FAKE,2908985283,244,2908985527,2936959073
2025-06-19 11:01:38,REAL,2908985527,541,2908986068,2936959614
2025-06-19 11:01:40,REAL,2908986068,476,2908986544,2936960090
2025-06-19 11:01:42,REAL,2908986544,489,2908987033,2936960579
2025-06-19 11:01:44,REAL,2908987033,482,2908987515,2936961061
2025-06-19 11:01:46,REAL,2908987515,480,2908987995,2936961541
2025-06-19 11:01:48,REAL,2908987995,488,2908988483,2936962029
2025-06-19 11:01:50,REAL,2908988483,487,2908988970,2936962516
2025-06-19 11:01:52,REAL,2908988970,493,2908989463,2936963009
2025-06-19 11:01:54,REAL,2908989463,240,2908989703,2936963249
2025-06-19 11:01:56,REAL,2908989703,485,2908990188,2936963734
2025-06-19 11:01:58,REAL,2908990188,480,2908990668,2936964214
2025-06-19 11:02:00,REAL,2908990668,483,2908991151,2936964697
2025-06-19 11:02:02,REAL,2908991151,484,2908991635,2936965181
2025-06-19 11:02:04,FAKE,2908991635,244,2908991879,2936965664
2025-06-19 11:02:06,FAKE,2908991879,243,2908992122,2936966146
2025-06-19 11:02:08,FAKE,2908992122,243,2908992365,2936966631
2025-06-19 11:02:10,REAL,2908992365,8478,2909000843,2936975109
2025-06-19 11:02:12,REAL,2909000843,10846,2909011689,2936985955
2025-06-19 11:02:14,FAKE,2909011689,241,2909011930,2936996200
2025-06-19 11:02:16,FAKE,2909011930,243,2909012173,2937006517
2025-06-19 11:02:18,FAKE,2909012173,244,2909012417,2937016769
2025-06-19 11:02:20,REAL,2909012417,10251,2909022668,2937027020
2025-06-19 11:02:22,REAL,2909022668,10312,2909032980,2937037332
2025-06-19 11:02:24,REAL,2909032980,8472,2909041452,2937045804
2025-06-19 11:02:26,REAL,2909041452,484,2909041936,2937046288
2025-06-19 11:02:28,REAL,2909041936,535,2909042471,2937046823
2025-06-19 11:02:30,REAL,2909042471,490,2909042961,2937047313
2025-06-19 11:02:32,FAKE,2909042961,244,2909043205,2937047800
2025-06-19 11:02:34,FAKE,2909043205,238,2909043443,2937048283
2025-06-19 11:02:36,REAL,2909043443,482,2909043925,2937048765
2025-06-19 11:02:38,REAL,2909043925,479,2909044404,2937049244
2025-06-19 11:02:40,REAL,2909044404,494,2909044898,2937049738
2025-06-19 11:02:42,REAL,2909044898,490,2909045388,2937050228
2025-06-19 11:02:44,REAL,2909045388,483,2909045871,2937050711
2025-06-19 11:02:46,FAKE,2909045871,241,2909046112,2937051195
2025-06-19 11:02:48,FAKE,2909046112,244,2909046356,2937051685
2025-06-19 11:02:50,REAL,2909046356,486,2909046842,2937052171
2025-06-19 11:02:52,REAL,2909046842,474,2909047316,2937052645
2025-06-19 11:02:54,REAL,2909047316,476,2909047792,2937053121
2025-06-19 11:02:56,FAKE,2909047792,243,2909048035,2937053607
2025-06-19 11:02:58,REAL,2909048035,538,2909048573,2937054145
2025-06-19 11:03:00,FAKE,2909048573,244,2909048817,2937054626
2025-06-19 11:03:02,FAKE,2909048817,243,2909049060,2937055104
2025-06-19 11:03:04,REAL,2909049060,478,2909049538,2937055582
2025-06-19 11:03:06,REAL,2909049538,480,2909050018,2937056062
2025-06-19 11:03:08,FAKE,2909050018,243,2909050261,2937056539
2025-06-19 11:03:10,REAL,2909050261,479,2909050740,2937057018
2025-06-19 11:03:12,REAL,2909050740,482,2909051222,2937057500
2025-06-19 11:03:14,REAL,2909051222,480,2909051702,2937057980
2025-06-19 11:03:16,FAKE,2909051702,243,2909051945,2937058469
2025-06-19 11:03:18,FAKE,2909051945,238,2909052183,2937058949
2025-06-19 11:03:20,FAKE,2909052183,238,2909052421,2937059492
2025-06-19 11:03:22,REAL,2909052421,482,2909052903,2937059974
2025-06-19 11:03:24,REAL,2909052903,9925,2909062828,2937069899
2025-06-19 11:03:26,REAL,2909062828,10449,2909073277,2937080348
2025-06-19 11:03:28,FAKE,2909073277,244,2909073521,2937090667
2025-06-19 11:03:30,REAL,2909073521,10252,2909083773,2937100919
2025-06-19 11:03:32,REAL,2909083773,10250,2909094023,2937111169
2025-06-19 11:03:34,REAL,2909094023,10317,2909104340,2937121486
2025-06-19 11:03:36,REAL,2909104340,10257,2909114597,2937131743
2025-06-19 11:03:38,REAL,2909114597,7279,2909121876,2937139022
2025-06-19 11:03:40,FAKE,2909121876,238,2909122114,2937139497
2025-06-19 11:03:42,REAL,2909122114,476,2909122590,2937139973
2025-06-19 11:03:44,REAL,2909122590,481,2909123071,2937140454
2025-06-19 11:03:46,REAL,2909123071,479,2909123550,2937140933
2025-06-19 11:03:48,REAL,2909123550,474,2909124024,2937141407
2025-06-19 11:03:50,REAL,2909124024,542,2909124566,2937141949
2025-06-19 11:03:52,REAL,2909124566,483,2909125049,2937142432
2025-06-19 11:03:54,FAKE,2909125049,241,2909125290,2937142921
2025-06-19 11:03:56,REAL,2909125290,483,2909125773,2937143404
2025-06-19 11:03:58,REAL,2909125773,479,2909126252,2937143883
2025-06-19 11:04:00,REAL,2909126252,480,2909126732,2937144363
2025-06-19 11:04:02,REAL,2909126732,491,2909127223,2937144854
2025-06-19 11:04:04,FAKE,2909127223,241,2909127464,2937145336
2025-06-19 11:04:06,REAL,2909127464,483,2909127947,2937145819
2025-06-19 11:04:08,REAL,2909127947,483,2909128430,2937146302
2025-06-19 11:04:10,REAL,2909128430,548,2909128978,2937146850
2025-06-19 11:04:12,REAL,2909128978,483,2909129461,2937147333
2025-06-19 11:04:14,FAKE,2909129461,244,2909129705,2937147873
2025-06-19 11:04:16,REAL,2909129705,491,2909130196,2937148364
2025-06-19 11:04:18,REAL,2909130196,475,2909130671,2937148839
2025-06-19 11:04:20,REAL,2909130671,484,2909131155,2937149323
2025-06-19 11:04:22,REAL,2909131155,485,2909131640,2937149808
2025-06-19 11:04:24,REAL,2909131640,489,2909132129,2937150297
2025-06-19 11:04:26,REAL,2909132129,483,2909132612,2937150780
2025-06-19 11:04:28,FAKE,2909132612,241,2909132853,2937151267
2025-06-19 11:04:30,REAL,2909132853,476,2909133329,2937151743
2025-06-19 11:04:32,FAKE,2909133329,243,2909133572,2937152232
2025-06-19 11:04:34,REAL,2909133572,478,2909134050,2937152710
2025-06-19 11:04:36,FAKE,2909134050,243,2909134293,2937153194
2025-06-19 11:04:38,REAL,2909134293,539,2909134832,2937153733
2025-06-19 11:04:40,REAL,2909134832,490,2909135322,2937154223
2025-06-19 11:04:42,FAKE,2909135322,238,2909135560,2937154713
2025-06-19 11:04:44,REAL,2909135560,478,2909136038,2937155191
2025-06-19 11:04:46,FAKE,2909136038,238,2909136276,2937155674
2025-06-19 11:04:48,REAL,2909136276,488,2909136764,2937156162
2025-06-19 11:04:50,REAL,2909136764,490,2909137254,2937156652
2025-06-19 11:04:52,FAKE,2909137254,238,2909137492,2937157135
2025-06-19 11:04:54,REAL,2909137492,482,2909137974,2937157617
2025-06-19 11:04:56,REAL,2909137974,476,2909138450,2937158093
2025-06-19 11:04:58,REAL,2909138450,487,2909138937,2937158580
2025-06-19 11:05:00,REAL,2909138937,476,2909139413,2937159056
2025-06-19 11:05:02,FAKE,2909139413,244,2909139657,2937159645
2025-06-19 11:05:04,REAL,2909139657,6496,2909146153,2937166141
2025-06-19 11:05:06,REAL,2909146153,11168,2909157321,2937177309
2025-06-19 11:05:08,REAL,2909157321,10254,2909167575,2937187563
2025-06-19 11:05:10,REAL,2909167575,10321,2909177896,2937197884
2025-06-19 11:05:12,REAL,2909177896,10253,2909188149,2937208137
2025-06-19 11:05:14,REAL,2909188149,10311,2909198460,2937218448
2025-06-19 11:05:16,FAKE,2909198460,241,2909198701,2937228695
2025-06-19 11:05:18,REAL,2909198701,10254,2909208955,2937238949
2025-06-19 11:05:20,FAKE,2909208955,238,2909209193,2937239436
2025-06-19 11:05:22,REAL,2909209193,482,2909209675,2937239918
2025-06-19 11:05:24,FAKE,2909209675,244,2909209919,2937240400
2025-06-19 11:05:26,FAKE,2909209919,244,2909210163,2937240886
2025-06-19 11:05:28,FAKE,2909210163,244,2909210407,2937241426
2025-06-19 11:05:30,REAL,2909210407,484,2909210891,2937241910
2025-06-19 11:05:32,REAL,2909210891,480,2909211371,2937242390
2025-06-19 11:05:34,REAL,2909211371,478,2909211849,2937242868
2025-06-19 11:05:36,REAL,2909211849,8550,2909220399,2937251418
2025-06-19 11:05:38,FAKE,2909220399,238,2909220637,2937264512
2025-06-19 11:05:40,FAKE,2909220637,238,2909220875,2937274830
2025-06-19 11:05:42,REAL,2909220875,10247,2909231122,2937285077
2025-06-19 11:05:44,REAL,2909231122,10311,2909241433,2937295388
2025-06-19 11:05:46,REAL,2909241433,10248,2909251681,2937305636
2025-06-19 11:05:48,REAL,2909251681,10321,2909262002,2937315957
2025-06-19 11:05:50,REAL,2909262002,9596,2909271598,2937325553
2025-06-19 11:05:52,FAKE,2909271598,243,2909271841,2937326087
2025-06-19 11:05:54,REAL,2909271841,487,2909272328,2937326574
2025-06-19 11:05:56,REAL,2909272328,488,2909272816,2937327062
2025-06-19 11:05:58,REAL,2909272816,484,2909273300,2937327546
2025-06-19 11:06:00,REAL,2909273300,540,2909273840,2937328086
2025-06-19 11:06:02,REAL,2909273840,477,2909274317,2937328563
2025-06-19 11:06:04,REAL,2909274317,484,2909274801,2937329047
2025-06-19 11:06:06,FAKE,2909274801,241,2909275042,2937329523
2025-06-19 11:06:08,REAL,2909275042,481,2909275523,2937330004
2025-06-19 11:06:10,FAKE,2909275523,241,2909275764,2937330495
2025-06-19 11:06:12,REAL,2909275764,489,2909276253,2937330984
2025-06-19 11:06:14,FAKE,2909276253,238,2909276491,2937331468
2025-06-19 11:06:16,FAKE,2909276491,243,2909276734,2937331943
2025-06-19 11:06:18,REAL,2909276734,485,2909277219,2937332428
2025-06-19 11:06:20,FAKE,2909277219,238,2909277457,2937332908
2025-06-19 11:06:22,REAL,2909277457,479,2909277936,2937333387
2025-06-19 11:06:24,REAL,2909277936,539,2909278475,2937333926
2025-06-19 11:06:26,REAL,2909278475,480,2909278955,2937334406
2025-06-19 11:06:28,FAKE,2909278955,238,2909279193,2937334894
2025-06-19 11:06:30,REAL,2909279193,486,2909279679,2937335380
2025-06-19 11:06:32,REAL,2909279679,484,2909280163,2937335864
2025-06-19 11:06:34,FAKE,2909280163,244,2909280407,2937336354
2025-06-19 11:06:36,REAL,2909280407,483,2909280890,2937336837
2025-06-19 11:06:38,REAL,2909280890,480,2909281370,2937337317
2025-06-19 11:06:40,FAKE,2909281370,244,2909281614,2937337796
2025-06-19 11:06:42,REAL,2909281614,486,2909282100,2937338282
2025-06-19 11:06:44,REAL,2909282100,537,2909282637,2937338819
2025-06-19 11:06:46,REAL,2909282637,486,2909283123,2937339305
2025-06-19 11:06:48,REAL,2909283123,484,2909283607,2937339789
2025-06-19 11:06:50,REAL,2909283607,530,2909284137,2937340319
2025-06-19 11:06:52,FAKE,2909284137,243,2909284380,2937340804
2025-06-19 11:06:54,REAL,2909284380,488,2909284868,2937341292
2025-06-19 11:06:56,REAL,2909284868,483,2909285351,2937341775
2025-06-19 11:06:58,REAL,2909285351,484,2909285835,2937342259
2025-06-19 11:07:00,REAL,2909285835,477,2909286312,2937342736
2025-06-19 11:07:02,FAKE,2909286312,238,2909286550,2937343214
2025-06-19 11:07:04,FAKE,2909286550,243,2909286793,2937343696
2025-06-19 11:07:06,REAL,2909286793,488,2909287281,2937344184
2025-06-19 11:07:08,FAKE,2909287281,238,2909287519,2937344668
2025-06-19 11:07:10,FAKE,2909287519,241,2909287760,2937345159
2025-06-19 11:07:12,FAKE,2909287760,238,2909287998,2937345640
2025-06-19 11:07:14,REAL,2909287998,543,2909288541,2937346183
2025-06-19 11:07:16,FAKE,2909288541,244,2909288785,2937346663
2025-06-19 11:07:18,REAL,2909288785,479,2909289264,2937347142
2025-06-19 11:07:20,REAL,2909289264,477,2909289741,2937347619
2025-06-19 11:07:22,FAKE,2909289741,244,2909289985,2937357084
2025-06-19 11:07:24,REAL,2909289985,10509,2909300494,2937367593
2025-06-19 11:07:26,REAL,2909300494,10309,2909310803,2937377902
2025-06-19 11:07:28,FAKE,2909310803,243,2909311046,2937388152
2025-06-19 11:07:30,FAKE,2909311046,241,2909311287,2937398470
2025-06-19 11:07:32,FAKE,2909311287,244,2909311531,2937408722
2025-06-19 11:07:34,REAL,2909311531,10304,2909321835,2937419026
2025-06-19 11:07:36,FAKE,2909321835,244,2909322079,2937426905
2025-06-19 11:07:38,FAKE,2909322079,238,2909322317,2937427386
2025-06-19 11:07:40,REAL,2909322317,486,2909322803,2937427872
2025-06-19 11:07:42,REAL,2909322803,485,2909323288,2937428357
2025-06-19 11:07:44,REAL,2909323288,484,2909323772,2937428841
2025-06-19 11:07:46,REAL,2909323772,534,2909324306,2937429375
2025-06-19 11:07:48,REAL,2909324306,478,2909324784,2937429853
2025-06-19 11:07:50,REAL,2909324784,477,2909325261,2937430330
2025-06-19 11:07:52,REAL,2909325261,481,2909325742,2937430811
2025-06-19 11:07:54,REAL,2909325742,10326,2909336068,2937441137
2025-06-19 11:07:56,REAL,2909336068,10255,2909346323,2937451392
2025-06-19 11:07:58,REAL,2909346323,10318,2909356641,2937461710
2025-06-19 11:08:00,REAL,2909356641,10261,2909366902,2937471971
2025-06-19 11:08:02,REAL,2909366902,10250,2909377152,2937482221
2025-06-19 11:08:04,REAL,2909377152,10325,2909387477,2937492546
2025-06-19 11:08:06,REAL,2909387477,10253,2909397730,2937502799
2025-06-19 11:08:08,REAL,2909397730,7220,2909404950,2937510019
2025-06-19 11:08:10,FAKE,2909404950,241,2909405191,2937510506
2025-06-19 11:08:12,REAL,2909405191,479,2909405670,2937510985
2025-06-19 11:08:14,FAKE,2909405670,244,2909405914,2937511466
2025-06-19 11:08:16,REAL,2909405914,483,2909406397,2937511949
2025-06-19 11:08:18,REAL,2909406397,490,2909406887,2937512439
2025-06-19 11:08:20,REAL,2909406887,476,2909407363,2937512915
2025-06-19 11:08:22,REAL,2909407363,475,2909407838,2937513390
2025-06-19 11:08:24,REAL,2909407838,494,2909408332,2937513884
2025-06-19 11:08:26,REAL,2909408332,10250,2909418582,2937524134
2025-06-19 11:08:28,FAKE,2909418582,241,2909418823,2937534454
2025-06-19 11:08:30,REAL,2909418823,10257,2909429080,2937544711
2025-06-19 11:08:32,FAKE,2909429080,241,2909429321,2937555030
2025-06-19 11:08:34,FAKE,2909429321,243,2909429564,2937565281
2025-06-19 11:08:36,REAL,2909429564,10244,2909439808,2937575525
2025-06-19 11:08:38,REAL,2909439808,10260,2909450068,2937585785
2025-06-19 11:08:40,FAKE,2909450068,243,2909450311,2937592399
2025-06-19 11:08:42,REAL,2909450311,478,2909450789,2937592877
2025-06-19 11:08:44,FAKE,2909450789,238,2909451027,2937593366
2025-06-19 11:08:46,REAL,2909451027,484,2909451511,2937593850
2025-06-19 11:08:48,REAL,2909451511,486,2909451997,2937594336
2025-06-19 11:08:50,FAKE,2909451997,243,2909452240,2937594823
2025-06-19 11:08:52,REAL,2909452240,481,2909452721,2937595304
2025-06-19 11:08:54,REAL,2909452721,486,2909453207,2937595790
2025-06-19 11:08:56,FAKE,2909453207,244,2909453451,2937596269
2025-06-19 11:08:58,REAL,2909453451,11120,2909464571,2937607389
2025-06-19 11:09:00,FAKE,2909464571,243,2909464814,2937617636
2025-06-19 11:09:02,REAL,2909464814,10322,2909475136,2937627958
2025-06-19 11:09:04,REAL,2909475136,10249,2909485385,2937638207
2025-06-19 11:09:06,REAL,2909485385,10254,2909495639,2937648461
2025-06-19 11:09:08,FAKE,2909495639,241,2909495880,2937658716
2025-06-19 11:09:10,FAKE,2909495880,238,2909496118,2937668966
2025-06-19 11:09:12,REAL,2909496118,5954,2909502072,2937674920
2025-06-19 11:09:14,REAL,2909502072,487,2909502559,2937675407
2025-06-19 11:09:16,REAL,2909502559,482,2909503041,2937675889
2025-06-19 11:09:18,FAKE,2909503041,238,2909503279,2937676433
2025-06-19 11:09:20,FAKE,2909503279,243,2909503522,2937676924
2025-06-19 11:09:22,REAL,2909503522,486,2909504008,2937677410
2025-06-19 11:09:24,FAKE,2909504008,241,2909504249,2937677900
2025-06-19 11:09:26,REAL,2909504249,479,2909504728,2937678379
2025-06-19 11:09:28,REAL,2909504728,476,2909505204,2937678855
2025-06-19 11:09:30,REAL,2909505204,480,2909505684,2937679335
2025-06-19 11:09:32,REAL,2909505684,490,2909506174,2937679825
2025-06-19 11:09:34,REAL,2909506174,489,2909506663,2937680314
2025-06-19 11:09:36,FAKE,2909506663,238,2909506901,2937680794
2025-06-19 11:09:38,REAL,2909506901,482,2909507383,2937681276
2025-06-19 11:09:40,REAL,2909507383,478,2909507861,2937681754
2025-06-19 11:09:42,REAL,2909507861,540,2909508401,2937682294
2025-06-19 11:09:44,REAL,2909508401,484,2909508885,2937682778
2025-06-19 11:09:46,REAL,2909508885,487,2909509372,2937683265
2025-06-19 11:09:48,REAL,2909509372,483,2909509855,2937683748
2025-06-19 11:09:50,FAKE,2909509855,238,2909510093,2937684241
2025-06-19 11:09:52,REAL,2909510093,491,2909510584,2937684732
2025-06-19 11:09:54,FAKE,2909510584,238,2909510822,2937685209
2025-06-19 11:09:56,REAL,2909510822,484,2909511306,2937685693
2025-06-19 11:09:58,REAL,2909511306,482,2909511788,2937686175
2025-06-19 11:10:00,FAKE,2909511788,238,2909512026,2937686654
2025-06-19 11:10:02,REAL,2909512026,484,2909512510,2937687138
2025-06-19 11:10:04,REAL,2909512510,486,2909512996,2937687624
2025-06-19 11:10:06,REAL,2909512996,483,2909513479,2937688107
2025-06-19 11:10:08,REAL,2909513479,539,2909514018,2937688646
2025-06-19 11:10:10,REAL,2909514018,477,2909514495,2937689123
2025-06-19 11:10:12,REAL,2909514495,487,2909514982,2937689610
2025-06-19 11:10:14,REAL,2909514982,488,2909515470,2937690098
2025-06-19 11:10:16,FAKE,2909515470,238,2909515708,2937690573
2025-06-19 11:10:18,REAL,2909515708,492,2909516200,2937691065
2025-06-19 11:10:20,REAL,2909516200,688,2909516888,2937691753
2025-06-19 11:10:22,REAL,2909516888,14475,2909531363,2937706228
2025-06-19 11:10:24,REAL,2909531363,10258,2909541621,2937716486
2025-06-19 11:10:26,REAL,2909541621,10323,2909551944,2937726809
2025-06-19 11:10:28,REAL,2909551944,10253,2909562197,2937737062
2025-06-19 11:10:30,REAL,2909562197,10252,2909572449,2937747314
2025-06-19 11:10:32,REAL,2909572449,10312,2909582761,2937757626
2025-06-19 11:10:34,FAKE,2909582761,243,2909583004,2937767878
2025-06-19 11:10:36,REAL,2909583004,4835,2909587839,2937772713
2025-06-19 11:10:38,REAL,2909587839,476,2909588315,2937773189
2025-06-19 11:10:40,FAKE,2909588315,243,2909588558,2937773674
2025-06-19 11:10:42,REAL,2909588558,478,2909589036,2937774152
2025-06-19 11:10:44,FAKE,2909589036,241,2909589277,2937774639
2025-06-19 11:10:46,REAL,2909589277,490,2909589767,2937775129
2025-06-19 11:10:48,REAL,2909589767,484,2909590251,2937775613
2025-06-19 11:10:50,REAL,2909590251,477,2909590728,2937776090
2025-06-19 11:10:52,FAKE,2909590728,243,2909590971,2937776574
2025-06-19 11:10:54,REAL,2909590971,479,2909591450,2937777053
2025-06-19 11:10:56,REAL,2909591450,480,2909591930,2937777533
2025-06-19 11:10:58,REAL,2909591930,478,2909592408,2937778011
2025-06-19 11:11:00,REAL,2909592408,543,2909592951,2937778554
2025-06-19 11:11:02,REAL,2909592951,490,2909593441,2937779044
2025-06-19 11:11:04,FAKE,2909593441,238,2909593679,2937779578
2025-06-19 11:11:06,REAL,2909593679,484,2909594163,2937780062
2025-06-19 11:11:08,REAL,2909594163,484,2909594647,2937780546
2025-06-19 11:11:10,REAL,2909594647,484,2909595131,2937781030
2025-06-19 11:11:12,REAL,2909595131,482,2909595613,2937781512
2025-06-19 11:11:14,REAL,2909595613,482,2909596095,2937781994
2025-06-19 11:11:16,FAKE,2909596095,238,2909596333,2937782478
2025-06-19 11:11:18,REAL,2909596333,490,2909596823,2937782968
2025-06-19 11:11:20,FAKE,2909596823,243,2909597066,2937783456
2025-06-19 11:11:22,REAL,2909597066,487,2909597553,2937783943
2025-06-19 11:11:24,FAKE,2909597553,238,2909597791,2937784424
2025-06-19 11:11:26,FAKE,2909597791,241,2909598032,2937784905
2025-06-19 11:11:28,FAKE,2909598032,238,2909598270,2937785394
2025-06-19 11:11:30,REAL,2909598270,485,2909598755,2937785879
2025-06-19 11:11:32,REAL,2909598755,536,2909599291,2937786415
2025-06-19 11:11:34,FAKE,2909599291,243,2909599534,2937786900
2025-06-19 11:11:36,FAKE,2909599534,238,2909599772,2937787380
2025-06-19 11:11:38,FAKE,2909599772,243,2909600015,2937787865
2025-06-19 11:11:40,REAL,2909600015,485,2909600500,2937788350
2025-06-19 11:11:42,FAKE,2909600500,238,2909600738,2937788834
2025-06-19 11:11:44,FAKE,2909600738,241,2909600979,2937789316
2025-06-19 11:11:46,REAL,2909600979,9529,2909610508,2937798845
2025-06-19 11:11:48,REAL,2909610508,10650,2909621158,2937809495
2025-06-19 11:11:50,REAL,2909621158,10324,2909631482,2937819819
2025-06-19 11:11:52,FAKE,2909631482,238,2909631720,2937830070
2025-06-19 11:11:54,REAL,2909631720,10316,2909642036,2937840386
2025-06-19 11:11:56,REAL,2909642036,10247,2909652283,2937850633
2025-06-19 11:11:58,REAL,2909652283,10325,2909662608,2937860958
2025-06-19 11:12:00,REAL,2909662608,8144,2909670752,2937869102
2025-06-19 11:12:02,FAKE,2909670752,243,2909670995,2937869582
2025-06-19 11:12:04,FAKE,2909670995,244,2909671239,2937870122
2025-06-19 11:12:06,REAL,2909671239,3340,2909674579,2937873462
2025-06-19 11:12:08,REAL,2909674579,15009,2909689588,2937888471
2025-06-19 11:12:10,REAL,2909689588,10257,2909699845,2937898728
2025-06-19 11:12:12,REAL,2909699845,10311,2909710156,2937909039
2025-06-19 11:12:14,FAKE,2909710156,244,2909710400,2937919297
2025-06-19 11:12:16,REAL,2909710400,10320,2909720720,2937929617
2025-06-19 11:12:18,FAKE,2909720720,244,2909720964,2937939927
2025-06-19 11:12:20,REAL,2909720964,10247,2909731211,2937950174
2025-06-19 11:12:22,FAKE,2909731211,243,2909731454,2937953095
2025-06-19 11:12:24,REAL,2909731454,477,2909731931,2937953572
2025-06-19 11:12:26,FAKE,2909731931,244,2909732175,2937954050
2025-06-19 11:12:28,REAL,2909732175,483,2909732658,2937954533
2025-06-19 11:12:30,FAKE,2909732658,241,2909732899,2937955023
2025-06-19 11:12:32,FAKE,2909732899,244,2909733143,2937955516
2025-06-19 11:12:34,REAL,2909733143,487,2909733630,2937956003
2025-06-19 11:12:36,REAL,2909733630,483,2909734113,2937956486
2025-06-19 11:12:38,REAL,2909734113,536,2909734649,2937957022
2025-06-19 11:12:40,FAKE,2909734649,241,2909734890,2937957506
2025-06-19 11:12:42,FAKE,2909734890,238,2909735128,2937957985
2025-06-19 11:12:44,REAL,2909735128,483,2909735611,2937958468
2025-06-19 11:12:46,FAKE,2909735611,238,2909735849,2937958959
2025-06-19 11:12:48,REAL,2909735849,489,2909736338,2937959448
2025-06-19 11:12:50,REAL,2909736338,536,2909736874,2937959984
2025-06-19 11:12:52,REAL,2909736874,480,2909737354,2937960464
2025-06-19 11:12:54,REAL,2909737354,487,2909737841,2937960951
2025-06-19 11:12:56,REAL,2909737841,479,2909738320,2937961430
2025-06-19 11:12:58,FAKE,2909738320,238,2909738558,2937961912
2025-06-19 11:13:00,REAL,2909738558,485,2909739043,2937962397
2025-06-19 11:13:02,REAL,2909739043,483,2909739526,2937962880
2025-06-19 11:13:04,REAL,2909739526,487,2909740013,2937963367
2025-06-19 11:13:06,REAL,2909740013,480,2909740493,2937963847
2025-06-19 11:13:08,REAL,2909740493,487,2909740980,2937964334
2025-06-19 11:13:10,REAL,2909740980,537,2909741517,2937964871
2025-06-19 11:13:12,REAL,2909741517,490,2909742007,2937965361
2025-06-19 11:13:14,REAL,2909742007,478,2909742485,2937965839
2025-06-19 11:13:16,REAL,2909742485,485,2909742970,2937966324
2025-06-19 11:13:18,REAL,2909742970,486,2909743456,2937966810
2025-06-19 11:13:20,REAL,2909743456,487,2909743943,2937967297
2025-06-19 11:13:22,REAL,2909743943,493,2909744436,2937967790
2025-06-19 11:13:24,REAL,2909744436,486,2909744922,2937968276
2025-06-19 11:13:26,FAKE,2909744922,243,2909745165,2937968764
2025-06-19 11:13:28,REAL,2909745165,481,2909745646,2937969245
2025-06-19 11:13:30,REAL,2909745646,494,2909746140,2937969739
2025-06-19 11:13:32,REAL,2909746140,546,2909746686,2937970285
2025-06-19 11:13:34,FAKE,2909746686,241,2909746927,2937970772
2025-06-19 11:13:36,REAL,2909746927,488,2909747415,2937971260
2025-06-19 11:13:38,REAL,2909747415,482,2909747897,2937971742
2025-06-19 11:13:40,REAL,2909747897,488,2909748385,2937972230
2025-06-19 11:13:42,FAKE,2909748385,244,2909748629,2937972712
2025-06-19 11:13:44,REAL,2909748629,538,2909749167,2937973250
2025-06-19 11:13:46,FAKE,2909749167,238,2909749405,2937973737
2025-06-19 11:13:48,REAL,2909749405,482,2909749887,2937974219
2025-06-19 11:13:50,REAL,2909749887,488,2909750375,2937974707
2025-06-19 11:13:52,REAL,2909750375,10784,2909761159,2937985491
2025-06-19 11:13:54,REAL,2909761159,10320,2909771479,2937995811
2025-06-19 11:13:56,FAKE,2909771479,241,2909771720,2938006061
2025-06-19 11:13:58,REAL,2909771720,10319,2909782039,2938016380
2025-06-19 11:14:00,REAL,2909782039,10317,2909792356,2938026697
2025-06-19 11:14:02,REAL,2909792356,10255,2909802611,2938036952
2025-06-19 11:14:04,REAL,2909802611,10311,2909812922,2938047263
2025-06-19 11:14:06,REAL,2909812922,6364,2909819286,2938053627
2025-06-19 11:14:08,REAL,2909819286,483,2909819769,2938054110
2025-06-19 11:14:10,REAL,2909819769,484,2909820253,2938054594
2025-06-19 11:14:12,REAL,2909820253,483,2909820736,2938055077
2025-06-19 11:14:14,FAKE,2909820736,244,2909820980,2938055556
2025-06-19 11:14:16,REAL,2909820980,539,2909821519,2938056095
2025-06-19 11:14:18,REAL,2909821519,487,2909822006,2938056582
2025-06-19 11:14:20,REAL,2909822006,483,2909822489,2938057065
2025-06-19 11:14:22,REAL,2909822489,488,2909822977,2938057553
2025-06-19 11:14:24,REAL,2909822977,484,2909823461,2938058037
2025-06-19 11:14:26,FAKE,2909823461,241,2909823702,2938058526
2025-06-19 11:14:28,REAL,2909823702,489,2909824191,2938059015
2025-06-19 11:14:30,REAL,2909824191,545,2909824736,2938059560
2025-06-19 11:14:32,REAL,2909824736,484,2909825220,2938060044
2025-06-19 11:14:34,REAL,2909825220,481,2909825701,2938060525
2025-06-19 11:14:36,REAL,2909825701,478,2909826179,2938061003
2025-06-19 11:14:38,REAL,2909826179,477,2909826656,2938061480
2025-06-19 11:14:40,REAL,2909826656,482,2909827138,2938061962
2025-06-19 11:14:42,REAL,2909827138,488,2909827626,2938062450
2025-06-19 11:14:44,FAKE,2909827626,243,2909827869,2938062941
2025-06-19 11:14:46,FAKE,2909827869,243,2909828112,2938063425
2025-06-19 11:14:48,FAKE,2909828112,241,2909828353,2938063910
2025-06-19 11:14:50,REAL,2909828353,541,2909828894,2938064451
2025-06-19 11:14:52,REAL,2909828894,485,2909829379,2938064936
2025-06-19 11:14:54,REAL,2909829379,489,2909829868,2938065425
2025-06-19 11:14:56,REAL,2909829868,485,2909830353,2938065910
2025-06-19 11:14:58,FAKE,2909830353,238,2909830591,2938066400
2025-06-19 11:15:00,REAL,2909830591,480,2909831071,2938066880
2025-06-19 11:15:02,REAL,2909831071,492,2909831563,2938067372
2025-06-19 11:15:04,FAKE,2909831563,238,2909831801,2938067855
2025-06-19 11:15:06,FAKE,2909831801,244,2909832045,2938068333
2025-06-19 11:15:08,FAKE,2909832045,243,2909832288,2938068877
2025-06-19 11:15:10,REAL,2909832288,890,2909833178,2938069767
2025-06-19 11:15:12,FAKE,2909833178,238,2909833416,2938082199
2025-06-19 11:15:14,REAL,2909833416,10318,2909843734,2938092517
2025-06-19 11:15:16,REAL,2909843734,10252,2909853986,2938102769
2025-06-19 11:15:18,REAL,2909853986,10321,2909864307,2938113090
2025-06-19 11:15:20,FAKE,2909864307,238,2909864545,2938123340
2025-06-19 11:15:22,REAL,2909864545,10314,2909874859,2938133654
2025-06-19 11:15:24,REAL,2909874859,10320,2909885179,2938143974
2025-06-19 11:15:26,REAL,2909885179,4776,2909889955,2938148750
2025-06-19 11:15:28,FAKE,2909889955,244,2909890199,2938149233
2025-06-19 11:15:30,REAL,2909890199,481,2909890680,2938149714
2025-06-19 11:15:32,FAKE,2909890680,238,2909890918,2938157339
2025-06-19 11:15:34,REAL,2909890918,10980,2909901898,2938168319
2025-06-19 11:15:36,FAKE,2909901898,238,2909902136,2938178569
2025-06-19 11:15:38,REAL,2909902136,10258,2909912394,2938188827
2025-06-19 11:15:40,REAL,2909912394,10324,2909922718,2938199151
2025-06-19 11:15:42,REAL,2909922718,10255,2909932973,2938209406
2025-06-19 11:15:44,FAKE,2909932973,241,2909933214,2938219658
2025-06-19 11:15:46,REAL,2909933214,9398,2909942612,2938229056
2025-06-19 11:15:48,FAKE,2909942612,241,2909942853,2938229534
2025-06-19 11:15:50,REAL,2909942853,490,2909943343,2938230024
2025-06-19 11:15:52,FAKE,2909943343,238,2909943581,2938232033
2025-06-19 11:15:54,FAKE,2909943581,241,2909943822,2938244013
2025-06-19 11:15:56,FAKE,2909943822,238,2909944060,2938254320
2025-06-19 11:15:58,REAL,2909944060,10310,2909954370,2938264630
2025-06-19 11:16:00,FAKE,2909954370,241,2909954611,2938274887
2025-06-19 11:16:02,REAL,2909954611,10320,2909964931,2938285207
2025-06-19 11:16:04,REAL,2909964931,10255,2909975186,2938295462
2025-06-19 11:16:06,REAL,2909975186,10245,2909985431,2938305707
2025-06-19 11:16:08,REAL,2909985431,4109,2909989540,2938309816
2025-06-19 11:16:10,REAL,2909989540,484,2909990024,2938310300
2025-06-19 11:16:12,FAKE,2909990024,241,2909990265,2938310791
2025-06-19 11:16:14,FAKE,2909990265,238,2909990503,2938311279
2025-06-19 11:16:16,REAL,2909990503,491,2909990994,2938311770
2025-06-19 11:16:18,REAL,2909990994,489,2909991483,2938312259
2025-06-19 11:16:20,REAL,2909991483,479,2909991962,2938312738
2025-06-19 11:16:22,REAL,2909991962,477,2909992439,2938313215
2025-06-19 11:16:24,FAKE,2909992439,244,2909992683,2938313697
2025-06-19 11:16:26,REAL,2909992683,540,2909993223,2938314237
2025-06-19 11:16:28,FAKE,2909993223,243,2909993466,2938314724
2025-06-19 11:16:30,FAKE,2909993466,244,2909993710,2938315203
2025-06-19 11:16:32,REAL,2909993710,537,2909994247,2938315740
2025-06-19 11:16:34,REAL,2909994247,2736,2909996983,2938318476
2025-06-19 11:16:36,REAL,2909996983,11443,2910008426,2938329919
2025-06-19 11:16:38,FAKE,2910008426,244,2910008670,2938340240
2025-06-19 11:16:40,REAL,2910008670,10255,2910018925,2938350495
2025-06-19 11:16:42,REAL,2910018925,10317,2910029242,2938360812
2025-06-19 11:16:44,REAL,2910029242,10317,2910039559,2938371129
2025-06-19 11:16:46,FAKE,2910039559,244,2910039803,2938381381
2025-06-19 11:16:48,REAL,2910039803,10320,2910050123,2938391701
2025-06-19 11:16:50,REAL,2910050123,3590,2910053713,2938395291
2025-06-19 11:16:52,REAL,2910053713,488,2910054201,2938395779
2025-06-19 11:16:54,REAL,2910054201,481,2910054682,2938396260
2025-06-19 11:16:56,REAL,2910054682,539,2910055221,2938396799
2025-06-19 11:16:58,REAL,2910055221,485,2910055706,2938397284
2025-06-19 11:17:00,REAL,2910055706,487,2910056193,2938397771
2025-06-19 11:17:02,FAKE,2910056193,238,2910056431,2938398258
2025-06-19 11:17:04,REAL,2910056431,484,2910056915,2938398742
2025-06-19 11:17:06,FAKE,2910056915,243,2910057158,2938402277
2025-06-19 11:17:08,REAL,2910057158,11378,2910068536,2938413655
2025-06-19 11:17:10,REAL,2910068536,10251,2910078787,2938423906
2025-06-19 11:17:12,REAL,2910078787,10305,2910089092,2938434211
2025-06-19 11:17:14,REAL,2910089092,10315,2910099407,2938444526
2025-06-19 11:17:16,FAKE,2910099407,243,2910099650,2938454769
2025-06-19 11:17:18,REAL,2910099650,10309,2910109959,2938465078
2025-06-19 11:17:20,REAL,2910109959,10256,2910120215,2938475334
2025-06-19 11:17:22,REAL,2910120215,2921,2910123136,2938478255
2025-06-19 11:17:24,REAL,2910123136,485,2910123621,2938478740
2025-06-19 11:17:26,REAL,2910123621,543,2910124164,2938479283
2025-06-19 11:17:28,FAKE,2910124164,238,2910124402,2938479768
2025-06-19 11:17:30,REAL,2910124402,479,2910124881,2938480247
2025-06-19 11:17:32,FAKE,2910124881,238,2910125119,2938480725
2025-06-19 11:17:34,REAL,2910125119,475,2910125594,2938481200
2025-06-19 11:17:36,FAKE,2910125594,243,2910125837,2938481680
2025-06-19 11:17:38,REAL,2910125837,4800,2910130637,2938486480
2025-06-19 11:17:40,REAL,2910130637,12567,2910143204,2938499047
2025-06-19 11:17:42,REAL,2910143204,10253,2910153457,2938509300
2025-06-19 11:17:44,REAL,2910153457,10255,2910163712,2938519555
2025-06-19 11:17:46,REAL,2910163712,10254,2910173966,2938529809
2025-06-19 11:17:48,REAL,2910173966,10319,2910184285,2938540128
2025-06-19 11:17:50,FAKE,2910184285,243,2910184528,2938550382
2025-06-19 11:17:52,FAKE,2910184528,243,2910184771,2938560632
2025-06-19 11:17:54,REAL,2910184771,2325,2910187096,2938562957
2025-06-19 11:17:56,FAKE,2910187096,241,2910187337,2938563440
2025-06-19 11:17:58,REAL,2910187337,547,2910187884,2938563987
2025-06-19 11:18:00,REAL,2910187884,477,2910188361,2938564464
2025-06-19 11:18:02,FAKE,2910188361,238,2910188599,2938564948
2025-06-19 11:18:04,REAL,2910188599,481,2910189080,2938565429
2025-06-19 11:18:06,FAKE,2910189080,238,2910189318,2938565916
2025-06-19 11:18:08,REAL,2910189318,477,2910189795,2938566393
2025-06-19 11:18:10,FAKE,2910189795,243,2910190038,2938566878
2025-06-19 11:18:12,REAL,2910190038,488,2910190526,2938567366
2025-06-19 11:18:14,FAKE,2910190526,241,2910190767,2938567851
2025-06-19 11:18:16,FAKE,2910190767,241,2910191008,2938568343
2025-06-19 11:18:18,REAL,2910191008,486,2910191494,2938568829
2025-06-19 11:18:20,REAL,2910191494,484,2910191978,2938569313
2025-06-19 11:18:22,FAKE,2910191978,244,2910192222,2938569845
2025-06-19 11:18:24,REAL,2910192222,478,2910192700,2938570323
2025-06-19 11:18:26,FAKE,2910192700,241,2910192941,2938570811
2025-06-19 11:18:28,REAL,2910192941,531,2910193472,2938571342
2025-06-19 11:18:30,REAL,2910193472,4712,2910198184,2938576054
2025-06-19 11:18:32,FAKE,2910198184,243,2910198427,2938587696
2025-06-19 11:18:34,FAKE,2910198427,238,2910198665,2938598005
2025-06-19 11:18:36,REAL,2910198665,10254,2910208919,2938608259
2025-06-19 11:18:38,REAL,2910208919,10318,2910219237,2938618577
2025-06-19 11:18:40,REAL,2910219237,10075,2910229312,2938628652
2025-06-19 11:18:42,REAL,2910229312,10257,2910239569,2938638909
2025-06-19 11:18:44,REAL,2910239569,10315,2910249884,2938649224
2025-06-19 11:18:46,REAL,2910249884,1745,2910251629,2938650969
2025-06-19 11:18:48,FAKE,2910251629,238,2910251867,2938651451
2025-06-19 11:18:50,REAL,2910251867,476,2910252343,2938651927
2025-06-19 11:18:52,REAL,2910252343,489,2910252832,2938652416
2025-06-19 11:18:54,REAL,2910252832,485,2910253317,2938652901
2025-06-19 11:18:56,REAL,2910253317,483,2910253800,2938653384
2025-06-19 11:18:58,REAL,2910253800,481,2910254281,2938653865
2025-06-19 11:19:00,REAL,2910254281,544,2910254825,2938654409
2025-06-19 11:19:02,FAKE,2910254825,241,2910255066,2938659780
2025-06-19 11:19:04,REAL,2910255066,11703,2910266769,2938671483
2025-06-19 11:19:06,FAKE,2910266769,243,2910267012,2938681739
2025-06-19 11:19:08,FAKE,2910267012,241,2910267253,2938692047
2025-06-19 11:19:10,FAKE,2910267253,241,2910267494,2938702299
2025-06-19 11:19:12,REAL,2910267494,10255,2910277749,2938712554
2025-06-19 11:19:14,FAKE,2910277749,243,2910277992,2938722879
2025-06-19 11:19:16,REAL,2910277992,10251,2910288243,2938733130
2025-06-19 11:19:18,REAL,2910288243,1206,2910289449,2938734336
2025-06-19 11:19:20,REAL,2910289449,482,2910289931,2938734818
2025-06-19 11:19:22,REAL,2910289931,488,2910290419,2938735306
2025-06-19 11:19:24,REAL,2910290419,482,2910290901,2938735788
2025-06-19 11:19:26,REAL,2910290901,488,2910291389,2938736276
2025-06-19 11:19:28,REAL,2910291389,5707,2910297096,2938741983
2025-06-19 11:19:30,REAL,2910297096,11106,2910308202,2938753089
2025-06-19 11:19:32,REAL,2910308202,10252,2910318454,2938763341
2025-06-19 11:19:34,REAL,2910318454,10318,2910328772,2938773659
2025-06-19 11:19:36,REAL,2910328772,10255,2910339027,2938783914
2025-06-19 11:19:38,REAL,2910339027,10244,2910349271,2938794158
2025-06-19 11:19:40,REAL,2910349271,10325,2910359596,2938804483
2025-06-19 11:19:42,REAL,2910359596,10245,2910369841,2938814728
2025-06-19 11:19:44,REAL,2910369841,1016,2910370857,2938815744
2025-06-19 11:19:46,FAKE,2910370857,238,2910371095,2938816234
2025-06-19 11:19:48,FAKE,2910371095,241,2910371336,2938816716
2025-06-19 11:19:50,REAL,2910371336,484,2910371820,2938817200
2025-06-19 11:19:52,FAKE,2910371820,238,2910372058,2938817692
2025-06-19 11:19:54,REAL,2910372058,489,2910372547,2938818181
2025-06-19 11:19:56,REAL,2910372547,490,2910373037,2938818671
2025-06-19 11:19:58,REAL,2910373037,483,2910373520,2938819154
2025-06-19 11:20:00,REAL,2910373520,540,2910374060,2938819694
2025-06-19 11:20:02,FAKE,2910374060,241,2910374301,2938820183
2025-06-19 11:20:04,REAL,2910374301,481,2910374782,2938820664
2025-06-19 11:20:06,REAL,2910374782,481,2910375263,2938821145
2025-06-19 11:20:08,REAL,2910375263,486,2910375749,2938821631
2025-06-19 11:20:10,REAL,2910375749,6828,2910382577,2938828459
2025-06-19 11:20:12,REAL,2910382577,13693,2910396270,2938842152
2025-06-19 11:20:14,REAL,2910396270,10259,2910406529,2938852411
2025-06-19 11:20:16,FAKE,2910406529,243,2910406772,2938862659
2025-06-19 11:20:18,REAL,2910406772,10314,2910417086,2938872973
2025-06-19 11:20:20,REAL,2910417086,10245,2910427331,2938883218
2025-06-19 11:20:22,REAL,2910427331,10254,2910437585,2938893472
2025-06-19 11:20:24,REAL,2910437585,10247,2910447832,2938903719
2025-06-19 11:20:26,REAL,2910447832,488,2910448320,2938904207
2025-06-19 11:20:28,REAL,2910448320,480,2910448800,2938904687
2025-06-19 11:20:30,FAKE,2910448800,241,2910449041,2938905169
2025-06-19 11:20:32,REAL,2910449041,537,2910449578,2938905706
2025-06-19 11:20:34,REAL,2910449578,479,2910450057,2938906185
2025-06-19 11:20:36,FAKE,2910450057,238,2910450295,2938906666
2025-06-19 11:20:38,FAKE,2910450295,241,2910450536,2938907155
2025-06-19 11:20:40,FAKE,2910450536,241,2910450777,2938907645
2025-06-19 11:20:42,FAKE,2910450777,238,2910451015,2938908132
2025-06-19 11:20:44,FAKE,2910451015,238,2910451253,2938908608
2025-06-19 11:20:46,REAL,2910451253,490,2910451743,2938909098
2025-06-19 11:20:48,REAL,2910451743,482,2910452225,2938909580
2025-06-19 11:20:50,FAKE,2910452225,238,2910452463,2938910062
2025-06-19 11:20:52,REAL,2910452463,480,2910452943,2938910542
2025-06-19 11:20:54,REAL,2910452943,549,2910453492,2938911091
2025-06-19 11:20:56,FAKE,2910453492,243,2910453735,2938911580
2025-06-19 11:20:58,REAL,2910453735,483,2910454218,2938912063
2025-06-19 11:21:00,REAL,2910454218,479,2910454697,2938912542
2025-06-19 11:21:02,REAL,2910454697,1466,2910456163,2938914008
2025-06-19 11:21:04,REAL,2910456163,14689,2910470852,2938928697
2025-06-19 11:21:06,REAL,2910470852,10314,2910481166,2938939011
2025-06-19 11:21:08,REAL,2910481166,10318,2910491484,2938949329
2025-06-19 11:21:10,FAKE,2910491484,243,2910491727,2938959581
2025-06-19 11:21:12,REAL,2910491727,10327,2910502054,2938969908
2025-06-19 11:21:14,REAL,2910502054,10248,2910512302,2938980156
2025-06-19 11:21:16,REAL,2910512302,10314,2910522616,2938990470
2025-06-19 11:21:18,REAL,2910522616,4439,2910527055,2938994909
2025-06-19 11:21:20,REAL,2910527055,491,2910527546,2938995400
2025-06-19 11:21:22,FAKE,2910527546,243,2910527789,2938995876
2025-06-19 11:21:24,FAKE,2910527789,244,2910528033,2938996356
2025-06-19 11:21:26,REAL,2910528033,479,2910528512,2938996835
2025-06-19 11:21:28,REAL,2910528512,723,2910529235,2938997558
2025-06-19 11:21:30,REAL,2910529235,241,2910529476,2938997799
2025-06-19 11:21:32,FAKE,2910529476,238,2910529714,2938998292
2025-06-19 11:21:34,FAKE,2910529714,243,2910529957,2939000754
2025-06-19 11:21:36,REAL,2910529957,11851,2910541808,2939012605
2025-06-19 11:21:38,FAKE,2910541808,243,2910542051,2939022925
2025-06-19 11:21:40,REAL,2910542051,10311,2910552362,2939033236
2025-06-19 11:21:42,FAKE,2910552362,244,2910552606,2939043494
2025-06-19 11:21:44,REAL,2910552606,10323,2910562929,2939053817
2025-06-19 11:21:46,REAL,2910562929,10255,2910573184,2939064072
2025-06-19 11:21:48,REAL,2910573184,10312,2910583496,2939074384
2025-06-19 11:21:50,REAL,2910583496,3848,2910587344,2939078232
2025-06-19 11:21:52,REAL,2910587344,484,2910587828,2939078716
2025-06-19 11:21:54,REAL,2910587828,484,2910588312,2939079200
2025-06-19 11:21:56,FAKE,2910588312,243,2910588555,2939079684
2025-06-19 11:21:58,REAL,2910588555,481,2910589036,2939080165
2025-06-19 11:22:00,REAL,2910589036,490,2910589526,2939080655
2025-06-19 11:22:02,REAL,2910589526,479,2910590005,2939081134
2025-06-19 11:22:04,FAKE,2910590005,241,2910590246,2939081618
2025-06-19 11:22:06,REAL,2910590246,478,2910590724,2939082096
2025-06-19 11:22:08,FAKE,2910590724,241,2910590965,2939082574
2025-06-19 11:22:10,REAL,2910590965,489,2910591454,2939083063
2025-06-19 11:22:12,REAL,2910591454,477,2910591931,2939083540
2025-06-19 11:22:14,REAL,2910591931,477,2910592408,2939084017
2025-06-19 11:22:16,FAKE,2910592408,238,2910592646,2939084498
2025-06-19 11:22:18,FAKE,2910592646,241,2910592887,2939084985
2025-06-19 11:22:20,REAL,2910592887,537,2910593424,2939085522
2025-06-19 11:22:22,FAKE,2910593424,241,2910593665,2939086069
2025-06-19 11:22:24,REAL,2910593665,491,2910594156,2939086560
2025-06-19 11:22:26,REAL,2910594156,485,2910594641,2939087045
2025-06-19 11:22:28,REAL,2910594641,483,2910595124,2939087528
2025-06-19 11:22:30,REAL,2910595124,483,2910595607,2939088011
2025-06-19 11:22:32,REAL,2910595607,482,2910596089,2939088493
2025-06-19 11:22:34,FAKE,2910596089,241,2910596330,2939088978
2025-06-19 11:22:36,FAKE,2910596330,241,2910596571,2939089468
2025-06-19 11:22:38,REAL,2910596571,3791,2910600362,2939093259
2025-06-19 11:22:40,REAL,2910600362,11587,2910611949,2939104846
2025-06-19 11:22:42,REAL,2910611949,10310,2910622259,2939115156
2025-06-19 11:22:44,REAL,2910622259,10251,2910632510,2939125407
2025-06-19 11:22:46,FAKE,2910632510,243,2910632753,2939135655
2025-06-19 11:22:48,FAKE,2910632753,243,2910632996,2939145977
2025-06-19 11:22:50,REAL,2910632996,10254,2910643250,2939156231
2025-06-19 11:22:52,REAL,2910643250,10313,2910653563,2939166544
2025-06-19 11:22:54,FAKE,2910653563,243,2910653806,2939169075
2025-06-19 11:22:56,FAKE,2910653806,238,2910654044,2939169551
2025-06-19 11:22:58,REAL,2910654044,492,2910654536,2939170043
2025-06-19 11:23:00,FAKE,2910654536,241,2910654777,2939170528
2025-06-19 11:23:02,REAL,2910654777,537,2910655314,2939171065
2025-06-19 11:23:04,REAL,2910655314,488,2910655802,2939171553
2025-06-19 11:23:06,REAL,2910655802,474,2910656276,2939172027
2025-06-19 11:23:08,FAKE,2910656276,238,2910656514,2939172504
2025-06-19 11:23:10,REAL,2910656514,476,2910656990,2939172980
2025-06-19 11:23:12,FAKE,2910656990,243,2910657233,2939173463
2025-06-19 11:23:14,FAKE,2910657233,244,2910657477,2939173950
2025-06-19 11:23:16,FAKE,2910657477,241,2910657718,2939174430
2025-06-19 11:23:18,FAKE,2910657718,244,2910657962,2939174913
2025-06-19 11:23:20,REAL,2910657962,485,2910658447,2939175398
2025-06-19 11:23:22,FAKE,2910658447,238,2910658685,2939175946
2025-06-19 11:23:24,REAL,2910658685,476,2910659161,2939176422
2025-06-19 11:23:26,FAKE,2910659161,238,2910659399,2939176909
2025-06-19 11:23:28,FAKE,2910659399,241,2910659640,2939177393
2025-06-19 11:23:30,REAL,2910659640,488,2910660128,2939177881
2025-06-19 11:23:32,REAL,2910660128,489,2910660617,2939178370
2025-06-19 11:23:34,FAKE,2910660617,244,2910660861,2939178854
2025-06-19 11:23:36,REAL,2910660861,482,2910661343,2939179336
2025-06-19 11:23:38,REAL,2910661343,487,2910661830,2939179823
2025-06-19 11:23:40,REAL,2910661830,485,2910662315,2939180308
2025-06-19 11:23:42,FAKE,2910662315,243,2910662558,2939180790
2025-06-19 11:23:44,FAKE,2910662558,238,2910662796,2939181329
2025-06-19 11:23:46,FAKE,2910662796,243,2910663039,2939181813
2025-06-19 11:23:48,REAL,2910663039,485,2910663524,2939182298
2025-06-19 11:23:50,REAL,2910663524,483,2910664007,2939182781
2025-06-19 11:23:52,REAL,2910664007,543,2910664550,2939183324
2025-06-19 11:23:54,REAL,2910664550,485,2910665035,2939183809
2025-06-19 11:23:56,FAKE,2910665035,238,2910665273,2939184291
2025-06-19 11:23:58,REAL,2910665273,493,2910665766,2939184784
2025-06-19 11:24:00,REAL,2910665766,488,2910666254,2939185272
2025-06-19 11:24:02,REAL,2910666254,475,2910666729,2939185747
2025-06-19 11:24:04,FAKE,2910666729,241,2910666970,2939186223
2025-06-19 11:24:06,FAKE,2910666970,238,2910667208,2939186711
2025-06-19 11:24:08,FAKE,2910667208,244,2910667452,2939187197
2025-06-19 11:24:10,REAL,2910667452,486,2910667938,2939187683
2025-06-19 11:24:12,FAKE,2910667938,238,2910668176,2939188165
2025-06-19 11:24:14,REAL,2910668176,475,2910668651,2939188640
2025-06-19 11:24:16,FAKE,2910668651,241,2910668892,2939189127
2025-06-19 11:24:18,FAKE,2910668892,243,2910669135,2939189610
2025-06-19 11:24:20,REAL,2910669135,536,2910669671,2939190146
2025-06-19 11:24:22,REAL,2910669671,493,2910670164,2939190639
2025-06-19 11:24:24,FAKE,2910670164,238,2910670402,2939191179
2025-06-19 11:24:26,REAL,2910670402,482,2910670884,2939191661
2025-06-19 11:24:28,REAL,2910670884,487,2910671371,2939192148
2025-06-19 11:24:30,REAL,2910671371,483,2910671854,2939192631
2025-06-19 11:24:32,REAL,2910671854,485,2910672339,2939193116
2025-06-19 11:24:34,FAKE,2910672339,238,2910672577,2939199290
2025-06-19 11:24:36,REAL,2910672577,13943,2910686520,2939213233
2025-06-19 11:24:38,REAL,2910686520,10247,2910696767,2939223480
2025-06-19 11:24:40,REAL,2910696767,10245,2910707012,2939233725
2025-06-19 11:24:42,FAKE,2910707012,243,2910707255,2939244040
2025-06-19 11:24:44,FAKE,2910707255,243,2910707498,2939254287
2025-06-19 11:24:46,REAL,2910707498,10318,2910717816,2939264605
2025-06-19 11:24:48,REAL,2910717816,10252,2910728068,2939274857
2025-06-19 11:24:50,REAL,2910728068,883,2910728951,2939275740
2025-06-19 11:24:52,REAL,2910728951,482,2910729433,2939276222
2025-06-19 11:24:54,REAL,2910729433,481,2910729914,2939276703
2025-06-19 11:24:56,REAL,2910729914,494,2910730408,2939277197
2025-06-19 11:24:58,REAL,2910730408,480,2910730888,2939277677
2025-06-19 11:25:00,FAKE,2910730888,243,2910731131,2939278155
2025-06-19 11:25:02,FAKE,2910731131,244,2910731375,2939278696
2025-06-19 11:25:04,REAL,2910731375,486,2910731861,2939279182
2025-06-19 11:25:06,REAL,2910731861,6682,2910738543,2939285864
2025-06-19 11:25:08,FAKE,2910738543,243,2910738786,2939296772
2025-06-19 11:25:10,REAL,2910738786,10255,2910749041,2939307027
2025-06-19 11:25:12,REAL,2910749041,10314,2910759355,2939317341
2025-06-19 11:25:14,FAKE,2910759355,243,2910759598,2939327598
2025-06-19 11:25:16,REAL,2910759598,10249,2910769847,2939337847
2025-06-19 11:25:18,REAL,2910769847,10319,2910780166,2939348166
2025-06-19 11:25:20,REAL,2910780166,10056,2910790222,2939358222
2025-06-19 11:25:22,REAL,2910790222,480,2910790702,2939358702
2025-06-19 11:25:24,FAKE,2910790702,238,2910790940,2939359186
2025-06-19 11:25:26,REAL,2910790940,486,2910791426,2939359672
2025-06-19 11:25:28,FAKE,2910791426,243,2910791669,2939360159
2025-06-19 11:25:30,REAL,2910791669,484,2910792153,2939360643
2025-06-19 11:25:32,FAKE,2910792153,238,2910792391,2939361125
2025-06-19 11:25:34,REAL,2910792391,533,2910792924,2939361658
2025-06-19 11:25:36,FAKE,2910792924,241,2910793165,2939362141
2025-06-19 11:25:38,REAL,2910793165,493,2910793658,2939362634
2025-06-19 11:25:40,REAL,2910793658,482,2910794140,2939363116
2025-06-19 11:25:42,REAL,2910794140,486,2910794626,2939363602
2025-06-19 11:25:44,REAL,2910794626,482,2910795108,2939364084
2025-06-19 11:25:46,FAKE,2910795108,238,2910795346,2939364624
2025-06-19 11:25:48,REAL,2910795346,492,2910795838,2939365116
2025-06-19 11:25:50,REAL,2910795838,480,2910796318,2939365596
2025-06-19 11:25:52,REAL,2910796318,485,2910796803,2939366081
2025-06-19 11:25:54,REAL,2910796803,485,2910797288,2939366566
2025-06-19 11:25:56,FAKE,2910797288,243,2910797531,2939367053
2025-06-19 11:25:58,REAL,2910797531,476,2910798007,2939367529
2025-06-19 11:26:00,REAL,2910798007,486,2910798493,2939368015
2025-06-19 11:26:02,FAKE,2910798493,241,2910798734,2939368555
2025-06-19 11:26:04,REAL,2910798734,487,2910799221,2939369042
2025-06-19 11:26:06,FAKE,2910799221,238,2910799459,2939369526
2025-06-19 11:26:08,FAKE,2910799459,238,2910799697,2939370003
2025-06-19 11:26:10,FAKE,2910799697,243,2910799940,2939380069
2025-06-19 11:26:12,REAL,2910799940,12224,2910812164,2939392293
2025-06-19 11:26:14,FAKE,2910812164,241,2910812405,2939402613
2025-06-19 11:26:16,FAKE,2910812405,244,2910812649,2939412870
2025-06-19 11:26:18,REAL,2910812649,10317,2910822966,2939423187
2025-06-19 11:26:20,REAL,2910822966,10250,2910833216,2939433437
2025-06-19 11:26:22,REAL,2910833216,10250,2910843466,2939443687
2025-06-19 11:26:24,FAKE,2910843466,241,2910843707,2939452483
2025-06-19 11:26:26,REAL,2910843707,482,2910844189,2939452965
2025-06-19 11:26:28,REAL,2910844189,543,2910844732,2939453508
2025-06-19 11:26:30,REAL,2910844732,485,2910845217,2939453993
2025-06-19 11:26:32,REAL,2910845217,475,2910845692,2939454468
2025-06-19 11:26:34,REAL,2910845692,489,2910846181,2939454957
2025-06-19 11:26:36,REAL,2910846181,479,2910846660,2939455436
2025-06-19 11:26:38,REAL,2910846660,533,2910847193,2939455969
2025-06-19 11:26:40,FAKE,2910847193,243,2910847436,2939456459
2025-06-19 11:26:42,REAL,2910847436,482,2910847918,2939456941
2025-06-19 11:26:44,FAKE,2910847918,243,2910848161,2939457426
2025-06-19 11:26:46,REAL,2910848161,484,2910848645,2939457910
2025-06-19 11:26:48,FAKE,2910848645,244,2910848889,2939458394
2025-06-19 11:26:50,REAL,2910848889,476,2910849365,2939458870
2025-06-19 11:26:52,REAL,2910849365,482,2910849847,2939459352
2025-06-19 11:26:54,REAL,2910849847,478,2910850325,2939459830
2025-06-19 11:26:56,FAKE,2910850325,238,2910850563,2939460320
2025-06-19 11:26:58,FAKE,2910850563,241,2910850804,2939460806
2025-06-19 11:27:00,REAL,2910850804,483,2910851287,2939461289
2025-06-19 11:27:02,REAL,2910851287,489,2910851776,2939461778
2025-06-19 11:27:04,REAL,2910851776,546,2910852322,2939462324
2025-06-19 11:27:06,REAL,2910852322,536,2910852858,2939462860
2025-06-19 11:27:08,REAL,2910852858,486,2910853344,2939463346
2025-06-19 11:27:10,REAL,2910853344,493,2910853837,2939463839
2025-06-19 11:27:12,REAL,2910853837,491,2910854328,2939464330
2025-06-19 11:27:14,FAKE,2910854328,238,2910854566,2939464816
2025-06-19 11:27:16,REAL,2910854566,482,2910855048,2939465298
2025-06-19 11:27:18,FAKE,2910855048,244,2910855292,2939465776
2025-06-19 11:27:20,REAL,2910855292,480,2910855772,2939466256
2025-06-19 11:27:22,FAKE,2910855772,244,2910856016,2939466741
2025-06-19 11:27:24,REAL,2910856016,487,2910856503,2939467228
2025-06-19 11:27:26,REAL,2910856503,479,2910856982,2939467707
2025-06-19 11:27:28,REAL,2910856982,492,2910857474,2939468199
2025-06-19 11:27:30,REAL,2910857474,479,2910857953,2939468678
2025-06-19 11:27:32,REAL,2910857953,490,2910858443,2939469168
2025-06-19 11:27:34,REAL,2910858443,537,2910858980,2939469705
2025-06-19 11:27:36,REAL,2910858980,477,2910859457,2939470182
2025-06-19 11:27:38,REAL,2910859457,481,2910859938,2939470663
2025-06-19 11:27:40,REAL,2910859938,534,2910860472,2939471197
2025-06-19 11:27:42,REAL,2910860472,475,2910860947,2939471672
2025-06-19 11:27:44,REAL,2910860947,3984,2910864931,2939475656
2025-06-19 11:27:46,FAKE,2910864931,238,2910865169,2939487172
2025-06-19 11:27:48,REAL,2910865169,10253,2910875422,2939497425
2025-06-19 11:27:50,FAKE,2910875422,244,2910875666,2939507677
2025-06-19 11:27:52,FAKE,2910875666,241,2910875907,2939517986
2025-06-19 11:27:54,REAL,2910875907,10261,2910886168,2939528247
2025-06-19 11:27:56,FAKE,2910886168,244,2910886412,2939538557
2025-06-19 11:27:58,REAL,2910886412,10245,2910896657,2939548802
2025-06-19 11:28:00,FAKE,2910896657,241,2910896898,2939551202
2025-06-19 11:28:02,REAL,2910896898,481,2910897379,2939551683
2025-06-19 11:28:04,REAL,2910897379,485,2910897864,2939552168
2025-06-19 11:28:06,FAKE,2910897864,238,2910898102,2939552660
2025-06-19 11:28:08,FAKE,2910898102,241,2910898343,2939553151
2025-06-19 11:28:10,REAL,2910898343,481,2910898824,2939553632
2025-06-19 11:28:12,REAL,2910898824,548,2910899372,2939554180
2025-06-19 11:28:14,REAL,2910899372,479,2910899851,2939554659
2025-06-19 11:28:16,REAL,2910899851,478,2910900329,2939555137
2025-06-19 11:28:18,REAL,2910900329,540,2910900869,2939555677
2025-06-19 11:28:20,REAL,2910900869,489,2910901358,2939556166
2025-06-19 11:28:22,REAL,2910901358,485,2910901843,2939556651
2025-06-19 11:28:24,REAL,2910901843,479,2910902322,2939557130
2025-06-19 11:28:26,REAL,2910902322,486,2910902808,2939557616
2025-06-19 11:28:28,FAKE,2910902808,244,2910903052,2939558103
2025-06-19 11:28:30,REAL,2910903052,483,2910903535,2939558586
2025-06-19 11:28:32,REAL,2910903535,487,2910904022,2939559073
2025-06-19 11:28:34,REAL,2910904022,492,2910904514,2939559565
2025-06-19 11:28:36,REAL,2910904514,482,2910904996,2939560047
2025-06-19 11:28:38,REAL,2910904996,485,2910905481,2939560532
2025-06-19 11:28:40,REAL,2910905481,483,2910905964,2939561015
2025-06-19 11:28:42,FAKE,2910905964,238,2910906202,2939561498
2025-06-19 11:28:44,FAKE,2910906202,238,2910906440,2939561979
2025-06-19 11:28:46,REAL,2910906440,490,2910906930,2939562469
2025-06-19 11:28:48,FAKE,2910906930,241,2910907171,2939568376
2025-06-19 11:28:50,REAL,2910907171,11113,2910918284,2939579489
2025-06-19 11:28:52,REAL,2910918284,10322,2910928606,2939589811
2025-06-19 11:28:54,REAL,2910928606,10307,2910938913,2939600118
2025-06-19 11:28:56,REAL,2910938913,10317,2910949230,2939610435
2025-06-19 11:28:58,FAKE,2910949230,238,2910949468,2939620756
2025-06-19 11:29:00,FAKE,2910949468,244,2910949712,2939631006
2025-06-19 11:29:02,FAKE,2910949712,241,2910949953,2939641324
2025-06-19 11:29:04,FAKE,2910949953,238,2910950191,2939642403
2025-06-19 11:29:06,REAL,2910950191,480,2910950671,2939642883
2025-06-19 11:29:08,FAKE,2910950671,243,2910950914,2939643368
2025-06-19 11:29:10,FAKE,2910950914,243,2910951157,2939643859
2025-06-19 11:29:12,REAL,2910951157,483,2910951640,2939644342
2025-06-19 11:29:14,REAL,2910951640,481,2910952121,2939644823
2025-06-19 11:29:16,REAL,2910952121,486,2910952607,2939645309
2025-06-19 11:29:18,REAL,2910952607,491,2910953098,2939645800
2025-06-19 11:29:20,REAL,2910953098,488,2910953586,2939646288
2025-06-19 11:29:22,REAL,2910953586,489,2910954075,2939646777
2025-06-19 11:29:24,REAL,2910954075,479,2910954554,2939647256
2025-06-19 11:29:26,REAL,2910954554,487,2910955041,2939647743
2025-06-19 11:29:28,FAKE,2910955041,243,2910955284,2939648232
2025-06-19 11:29:30,REAL,2910955284,478,2910955762,2939648710
2025-06-19 11:29:32,FAKE,2910955762,244,2910956006,2939649247
2025-06-19 11:29:34,REAL,2910956006,482,2910956488,2939649729
2025-06-19 11:29:36,REAL,2910956488,548,2910957036,2939650277
2025-06-19 11:29:38,REAL,2910957036,487,2910957523,2939650764
2025-06-19 11:29:40,FAKE,2910957523,243,2910957766,2939651246
2025-06-19 11:29:42,REAL,2910957766,483,2910958249,2939651729
2025-06-19 11:29:44,FAKE,2910958249,238,2910958487,2939652209
2025-06-19 11:29:46,REAL,2910958487,489,2910958976,2939652698
2025-06-19 11:29:48,REAL,2910958976,482,2910959458,2939653180
2025-06-19 11:29:50,REAL,2910959458,479,2910959937,2939653659
2025-06-19 11:29:52,REAL,2910959937,8734,2910968671,2939662393
2025-06-19 11:29:54,FAKE,2910968671,238,2910968909,2939675480
2025-06-19 11:29:56,REAL,2910968909,10252,2910979161,2939685732
2025-06-19 11:29:58,REAL,2910979161,10318,2910989479,2939696050
2025-06-19 11:30:00,REAL,2910989479,10260,2910999739,2939706310
2025-06-19 11:30:02,REAL,2910999739,11114,2911010853,2939717424
2025-06-19 11:30:04,FAKE,2911010853,238,2911011091,2939726821
2025-06-19 11:30:06,FAKE,2911011091,244,2911011335,2939736482
2025-06-19 11:30:08,REAL,2911011335,535,2911011870,2939737017
2025-06-19 11:30:10,FAKE,2911011870,241,2911012111,2939737506
2025-06-19 11:30:12,FAKE,2911012111,241,2911012352,2939738927
2025-06-19 11:30:14,REAL,2911012352,11704,2911024056,2939750631
2025-06-19 11:30:16,REAL,2911024056,10251,2911034307,2939760882
2025-06-19 11:30:18,REAL,2911034307,10254,2911044561,2939771136
2025-06-19 11:30:20,FAKE,2911044561,241,2911044802,2939781386
2025-06-19 11:30:22,REAL,2911044802,10316,2911055118,2939791702
2025-06-19 11:30:24,FAKE,2911055118,243,2911055361,2939801953
2025-06-19 11:30:26,REAL,2911055361,10254,2911065615,2939812207
2025-06-19 11:30:28,FAKE,2911065615,241,2911065856,2939816654
2025-06-19 11:30:30,FAKE,2911065856,243,2911066099,2939817146
2025-06-19 11:30:32,REAL,2911066099,487,2911066586,2939817633
2025-06-19 11:30:34,REAL,2911066586,491,2911067077,2939818124
2025-06-19 11:30:36,FAKE,2911067077,243,2911067320,2939818609
2025-06-19 11:30:38,FAKE,2911067320,238,2911067558,2939819096
2025-06-19 11:30:40,FAKE,2911067558,243,2911067801,2939819580
2025-06-19 11:30:42,FAKE,2911067801,244,2911068045,2939820063
2025-06-19 11:30:44,FAKE,2911068045,241,2911068286,2939822333
2025-06-19 11:30:46,FAKE,2911068286,238,2911068524,2939834103
2025-06-19 11:30:48,FAKE,2911068524,238,2911068762,2939844418
2025-06-19 11:30:50,REAL,2911068762,10243,2911079005,2939854661
2025-06-19 11:30:52,FAKE,2911079005,241,2911079246,2939864916
2025-06-19 11:30:54,REAL,2911079246,10256,2911089502,2939875172
2025-06-19 11:30:56,FAKE,2911089502,243,2911089745,2939885490
2025-06-19 11:30:58,REAL,2911089745,10256,2911100001,2939895746
2025-06-19 11:31:00,FAKE,2911100001,243,2911100244,2939899524
2025-06-19 11:31:02,FAKE,2911100244,243,2911100487,2939900006
2025-06-19 11:31:04,REAL,2911100487,484,2911100971,2939900490
2025-06-19 11:31:06,FAKE,2911100971,238,2911101209,2939908708
2025-06-19 11:31:08,REAL,2911101209,10713,2911111922,2939919421
2025-06-19 11:31:10,REAL,2911111922,10318,2911122240,2939929739
2025-06-19 11:31:12,FAKE,2911122240,241,2911122481,2939939988
2025-06-19 11:31:14,FAKE,2911122481,241,2911122722,2939950243
2025-06-19 11:31:16,REAL,2911122722,10258,2911132980,2939960501
2025-06-19 11:31:18,REAL,2911132980,10253,2911143233,2939970754
2025-06-19 11:31:20,FAKE,2911143233,241,2911143474,2939979287
2025-06-19 11:31:22,FAKE,2911143474,243,2911143717,2939979774
2025-06-19 11:31:24,REAL,2911143717,537,2911144254,2939980311
2025-06-19 11:31:26,REAL,2911144254,486,2911144740,2939980797
2025-06-19 11:31:28,REAL,2911144740,482,2911145222,2939981279
2025-06-19 11:31:30,FAKE,2911145222,244,2911145466,2939981761
2025-06-19 11:31:32,REAL,2911145466,485,2911145951,2939982246
2025-06-19 11:31:34,REAL,2911145951,482,2911146433,2939982728
2025-06-19 11:31:36,FAKE,2911146433,244,2911146677,2939983219
2025-06-19 11:31:38,REAL,2911146677,12310,2911158987,2939995529
2025-06-19 11:31:40,REAL,2911158987,11698,2911170685,2940007227
2025-06-19 11:31:42,REAL,2911170685,10253,2911180938,2940017480
2025-06-19 11:31:44,REAL,2911180938,10254,2911191192,2940027734
2025-06-19 11:31:46,REAL,2911191192,10260,2911201452,2940037994
2025-06-19 11:31:48,FAKE,2911201452,241,2911201693,2940048249
2025-06-19 11:31:50,FAKE,2911201693,243,2911201936,2940058496
2025-06-19 11:31:52,FAKE,2911201936,241,2911202177,2940066316
2025-06-19 11:31:54,FAKE,2911202177,238,2911202415,2940066794
2025-06-19 11:31:56,REAL,2911202415,484,2911202899,2940067278
2025-06-19 11:31:58,REAL,2911202899,489,2911203388,2940067767
2025-06-19 11:32:00,REAL,2911203388,491,2911203879,2940068258
2025-06-19 11:32:02,REAL,2911203879,482,2911204361,2940068740
2025-06-19 11:32:04,REAL,2911204361,489,2911204850,2940069229
2025-06-19 11:32:06,FAKE,2911204850,241,2911205091,2940069769
2025-06-19 11:32:08,REAL,2911205091,490,2911205581,2940070259
2025-06-19 11:32:10,REAL,2911205581,9465,2911215046,2940079724
2025-06-19 11:32:12,FAKE,2911215046,243,2911215289,2940090177
2025-06-19 11:32:14,REAL,2911215289,10245,2911225534,2940100422
2025-06-19 11:32:16,REAL,2911225534,10316,2911235850,2940110738
2025-06-19 11:32:18,FAKE,2911235850,241,2911236091,2940120990
2025-06-19 11:32:20,FAKE,2911236091,244,2911236335,2940131309
2025-06-19 11:32:22,REAL,2911236335,10246,2911246581,2940141555
2025-06-19 11:32:24,FAKE,2911246581,244,2911246825,2940148769
2025-06-19 11:32:26,REAL,2911246825,481,2911247306,2940149250
2025-06-19 11:32:28,REAL,2911247306,485,2911247791,2940149735
2025-06-19 11:32:30,FAKE,2911247791,244,2911248035,2940150215
2025-06-19 11:32:32,REAL,2911248035,479,2911248514,2940150694
2025-06-19 11:32:34,REAL,2911248514,478,2911248992,2940151172
2025-06-19 11:32:36,REAL,2911248992,493,2911249485,2940151665
2025-06-19 11:32:38,FAKE,2911249485,244,2911249729,2940152143
2025-06-19 11:32:40,REAL,2911249729,486,2911250215,2940152629
2025-06-19 11:32:42,REAL,2911250215,10254,2911260469,2940162883
2025-06-19 11:32:44,REAL,2911260469,10442,2911270911,2940173325
2025-06-19 11:32:46,REAL,2911270911,10318,2911281229,2940183643
2025-06-19 11:32:48,FAKE,2911281229,243,2911281472,2940193893
2025-06-19 11:32:50,REAL,2911281472,10259,2911291731,2940204152
2025-06-19 11:32:52,REAL,2911291731,10319,2911302050,2940214471
2025-06-19 11:32:54,REAL,2911302050,10261,2911312311,2940224732
2025-06-19 11:32:56,REAL,2911312311,6563,2911318874,2940231295
2025-06-19 11:32:58,REAL,2911318874,485,2911319359,2940231780
2025-06-19 11:33:00,REAL,2911319359,486,2911319845,2940232266
2025-06-19 11:33:02,REAL,2911319845,484,2911320329,2940232750
2025-06-19 11:33:04,FAKE,2911320329,243,2911320572,2940233238
2025-06-19 11:33:06,REAL,2911320572,486,2911321058,2940233724
2025-06-19 11:33:08,FAKE,2911321058,241,2911321299,2940234214
2025-06-19 11:33:10,FAKE,2911321299,243,2911321542,2940234705
2025-06-19 11:33:12,REAL,2911321542,477,2911322019,2940235182
2025-06-19 11:33:14,REAL,2911322019,11594,2911333613,2940246776
2025-06-19 11:33:16,FAKE,2911333613,243,2911333856,2940257032
2025-06-19 11:33:18,REAL,2911333856,10322,2911344178,2940267354
2025-06-19 11:33:20,REAL,2911344178,10257,2911354435,2940277611
2025-06-19 11:33:22,FAKE,2911354435,244,2911354679,2940287931
2025-06-19 11:33:24,REAL,2911354679,10313,2911364992,2940298244
2025-06-19 11:33:26,REAL,2911364992,10257,2911375249,2940308501
2025-06-19 11:33:28,FAKE,2911375249,243,2911375492,2940314459
2025-06-19 11:33:30,FAKE,2911375492,238,2911375730,2940314938
2025-06-19 11:33:32,REAL,2911375730,478,2911376208,2940315416
2025-06-19 11:33:34,REAL,2911376208,480,2911376688,2940315896
2025-06-19 11:33:36,REAL,2911376688,485,2911377173,2940316381
2025-06-19 11:33:38,REAL,2911377173,487,2911377660,2940316868
2025-06-19 11:33:40,REAL,2911377660,489,2911378149,2940317357
2025-06-19 11:33:42,REAL,2911378149,483,2911378632,2940317840
2025-06-19 11:33:44,REAL,2911378632,483,2911379115,2940318323
2025-06-19 11:33:46,FAKE,2911379115,238,2911379353,2940330184
2025-06-19 11:33:48,FAKE,2911379353,243,2911379596,2940340439
2025-06-19 11:33:50,REAL,2911379596,10314,2911389910,2940350753
2025-06-19 11:33:52,FAKE,2911389910,243,2911390153,2940361004
2025-06-19 11:33:54,REAL,2911390153,10315,2911400468,2940371319
2025-06-19 11:33:56,REAL,2911400468,10246,2911410714,2940381565
2025-06-19 11:33:58,REAL,2911410714,10308,2911421022,2940391873
2025-06-19 11:34:00,REAL,2911421022,5305,2911426327,2940397178
2025-06-19 11:34:02,REAL,2911426327,537,2911426864,2940397715
2025-06-19 11:34:04,REAL,2911426864,492,2911427356,2940398207
2025-06-19 11:34:06,REAL,2911427356,478,2911427834,2940398685
2025-06-19 11:34:08,REAL,2911427834,485,2911428319,2940399170
2025-06-19 11:34:10,REAL,2911428319,482,2911428801,2940399652
2025-06-19 11:34:12,FAKE,2911428801,238,2911429039,2940400137
2025-06-19 11:34:14,REAL,2911429039,487,2911429526,2940400624
2025-06-19 11:34:16,REAL,2911429526,1092,2911430618,2940401716
2025-06-19 11:34:18,REAL,2911430618,11181,2911441799,2940412897
2025-06-19 11:34:20,REAL,2911441799,10324,2911452123,2940423221
2025-06-19 11:34:22,REAL,2911452123,10247,2911462370,2940433468
2025-06-19 11:34:24,FAKE,2911462370,243,2911462613,2940443782
2025-06-19 11:34:26,REAL,2911462613,10249,2911472862,2940454031
2025-06-19 11:34:28,FAKE,2911472862,241,2911473103,2940464346
2025-06-19 11:34:30,FAKE,2911473103,243,2911473346,2940474596
2025-06-19 11:34:32,REAL,2911473346,4705,2911478051,2940479301
2025-06-19 11:34:34,FAKE,2911478051,238,2911478289,2940479785
2025-06-19 11:34:36,REAL,2911478289,482,2911478771,2940480267
2025-06-19 11:34:38,REAL,2911478771,488,2911479259,2940480755
2025-06-19 11:34:40,FAKE,2911479259,238,2911479497,2940481233
2025-06-19 11:34:42,FAKE,2911479497,241,2911479738,2940481777
2025-06-19 11:34:44,REAL,2911479738,484,2911480222,2940482261
2025-06-19 11:34:46,FAKE,2911480222,243,2911480465,2940482747
2025-06-19 11:34:48,FAKE,2911480465,241,2911480706,2940483223
2025-06-19 11:34:50,FAKE,2911480706,244,2911480950,2940483707
2025-06-19 11:34:52,FAKE,2911480950,244,2911481194,2940484186
2025-06-19 11:34:54,REAL,2911481194,482,2911481676,2940484668
2025-06-19 11:34:56,REAL,2911481676,489,2911482165,2940485157
2025-06-19 11:34:58,REAL,2911482165,546,2911482711,2940485703
2025-06-19 11:35:00,FAKE,2911482711,241,2911482952,2940486186
2025-06-19 11:35:02,REAL,2911482952,483,2911483435,2940486669
2025-06-19 11:35:04,REAL,2911483435,483,2911483918,2940487152
2025-06-19 11:35:06,FAKE,2911483918,244,2911484162,2940487635
2025-06-19 11:35:08,REAL,2911484162,489,2911484651,2940488124
2025-06-19 11:35:10,FAKE,2911484651,244,2911484895,2940488602
2025-06-19 11:35:12,REAL,2911484895,489,2911485384,2940489091
2025-06-19 11:35:14,REAL,2911485384,483,2911485867,2940489574
2025-06-19 11:35:16,REAL,2911485867,476,2911486343,2940490050
2025-06-19 11:35:18,REAL,2911486343,486,2911486829,2940490536
2025-06-19 11:35:20,FAKE,2911486829,241,2911487070,2940491013
2025-06-19 11:35:22,REAL,2911487070,298,2911487368,2940491311
2025-06-19 11:35:24,FAKE,2911487368,238,2911487606,2940491803
2025-06-19 11:35:26,FAKE,2911487606,244,2911487850,2940492290
2025-06-19 11:35:28,FAKE,2911487850,244,2911488094,2940492779
2025-06-19 11:35:30,REAL,2911488094,485,2911488579,2940493264
2025-06-19 11:35:32,FAKE,2911488579,244,2911488823,2940493746
2025-06-19 11:35:34,REAL,2911488823,475,2911489298,2940494221
2025-06-19 11:35:36,FAKE,2911489298,243,2911489541,2940494708
2025-06-19 11:35:38,FAKE,2911489541,244,2911489785,2940495240
2025-06-19 11:35:40,REAL,2911489785,475,2911490260,2940495715
2025-06-19 11:35:42,REAL,2911490260,491,2911490751,2940496206
2025-06-19 11:35:44,REAL,2911490751,485,2911491236,2940496691
2025-06-19 11:35:46,REAL,2911491236,479,2911491715,2940497170
2025-06-19 11:35:48,FAKE,2911491715,244,2911491959,2940497650
2025-06-19 11:35:50,REAL,2911491959,482,2911492441,2940498132
2025-06-19 11:35:52,REAL,2911492441,486,2911492927,2940498618
2025-06-19 11:35:54,REAL,2911492927,486,2911493413,2940499104
2025-06-19 11:35:56,FAKE,2911493413,243,2911493656,2940499588
2025-06-19 11:35:58,FAKE,2911493656,238,2911493894,2940500073
2025-06-19 11:36:00,REAL,2911493894,487,2911494381,2940500560
2025-06-19 11:36:02,REAL,2911494381,483,2911494864,2940501043
2025-06-19 11:36:04,FAKE,2911494864,238,2911495102,2940501573
2025-06-19 11:36:06,REAL,2911495102,481,2911495583,2940502054
2025-06-19 11:36:08,REAL,2911495583,491,2911496074,2940502545
2025-06-19 11:36:10,REAL,2911496074,483,2911496557,2940503028
2025-06-19 11:36:12,REAL,2911496557,483,2911497040,2940503511
2025-06-19 11:36:14,FAKE,2911497040,243,2911497283,2940503990
2025-06-19 11:36:16,REAL,2911497283,493,2911497776,2940504483
2025-06-19 11:36:18,FAKE,2911497776,243,2911498019,2940508199
2025-06-19 11:36:20,REAL,2911498019,11244,2911509263,2940519443
2025-06-19 11:36:22,REAL,2911509263,10314,2911519577,2940529757
2025-06-19 11:36:24,REAL,2911519577,10256,2911529833,2940540013
2025-06-19 11:36:26,REAL,2911529833,10326,2911540159,2940550339
2025-06-19 11:36:28,FAKE,2911540159,243,2911540402,2940560598
2025-06-19 11:36:30,FAKE,2911540402,241,2911540643,2940570852
2025-06-19 11:36:32,REAL,2911540643,10308,2911550951,2940581160
2025-06-19 11:36:34,REAL,2911550951,2532,2911553483,2940583692
2025-06-19 11:36:36,FAKE,2911553483,243,2911553726,2940584168
2025-06-19 11:36:38,FAKE,2911553726,238,2911553964,2940584652
2025-06-19 11:36:40,REAL,2911553964,492,2911554456,2940585144
2025-06-19 11:36:42,REAL,2911554456,482,2911554938,2940585626
2025-06-19 11:36:44,REAL,2911554938,485,2911555423,2940586111
2025-06-19 11:36:46,REAL,2911555423,486,2911555909,2940586597
2025-06-19 11:36:48,FAKE,2911555909,243,2911556152,2940587083
2025-06-19 11:36:50,REAL,2911556152,4498,2911560650,2940591581
2025-06-19 11:36:52,FAKE,2911560650,238,2911560888,2940603026
2025-06-19 11:36:54,FAKE,2911560888,241,2911561129,2940613342
2025-06-19 11:36:56,FAKE,2911561129,241,2911561370,2940623597
2025-06-19 11:36:58,REAL,2911561370,10256,2911571626,2940633853
2025-06-19 11:37:00,REAL,2911571626,10320,2911581946,2940644173
2025-06-19 11:37:02,REAL,2911581946,10256,2911592202,2940654429
2025-06-19 11:37:04,REAL,2911592202,10309,2911602511,2940664738
2025-06-19 11:37:06,REAL,2911602511,1933,2911604444,2940666671
2025-06-19 11:37:08,REAL,2911604444,481,2911604925,2940667152
2025-06-19 11:37:10,REAL,2911604925,485,2911605410,2940667637
2025-06-19 11:37:12,REAL,2911605410,485,2911605895,2940668122
2025-06-19 11:37:14,REAL,2911605895,481,2911606376,2940668603
2025-06-19 11:37:16,REAL,2911606376,480,2911606856,2940669083
2025-06-19 11:37:18,REAL,2911606856,482,2911607338,2940669565
2025-06-19 11:37:20,FAKE,2911607338,243,2911607581,2940670045
2025-06-19 11:37:22,FAKE,2911607581,241,2911607822,2940670525
2025-06-19 11:37:24,REAL,2911607822,485,2911608307,2940671010
2025-06-19 11:37:26,REAL,2911608307,484,2911608791,2940671494
2025-06-19 11:37:28,REAL,2911608791,490,2911609281,2940671984
2025-06-19 11:37:30,REAL,2911609281,544,2911609825,2940672528
2025-06-19 11:37:32,FAKE,2911609825,244,2911610069,2940677571
2025-06-19 11:37:34,REAL,2911610069,10782,2911620851,2940688353
2025-06-19 11:37:36,REAL,2911620851,10322,2911631173,2940698675
2025-06-19 11:37:38,FAKE,2911631173,241,2911631414,2940708984
2025-06-19 11:37:40,FAKE,2911631414,238,2911631652,2940719295
2025-06-19 11:37:42,REAL,2911631652,10254,2911641906,2940729549
2025-06-19 11:37:44,REAL,2911641906,10312,2911652218,2940739861
2025-06-19 11:37:46,REAL,2911652218,10254,2911662472,2940750115
2025-06-19 11:37:48,REAL,2911662472,1408,2911663880,2940751523
2025-06-19 11:37:50,FAKE,2911663880,241,2911664121,2940752004
2025-06-19 11:37:52,FAKE,2911664121,243,2911664364,2940752491
2025-06-19 11:37:54,REAL,2911664364,481,2911664845,2940752972
2025-06-19 11:37:56,REAL,2911664845,478,2911665323,2940753450
2025-06-19 11:37:58,REAL,2911665323,490,2911665813,2940753940
2025-06-19 11:38:00,FAKE,2911665813,241,2911666054,2940754419
2025-06-19 11:38:02,FAKE,2911666054,238,2911666292,2940754910
2025-06-19 11:38:04,REAL,2911666292,6699,2911672991,2940761609
2025-06-19 11:38:06,FAKE,2911672991,238,2911673229,2940775169
2025-06-19 11:38:08,REAL,2911673229,9985,2911683214,2940785154
2025-06-19 11:38:10,REAL,2911683214,10249,2911693463,2940795403
2025-06-19 11:38:12,REAL,2911693463,10319,2911703782,2940805722
2025-06-19 11:38:14,FAKE,2911703782,241,2911704023,2940815976
2025-06-19 11:38:16,REAL,2911704023,10254,2911714277,2940826230
2025-06-19 11:38:18,REAL,2911714277,10253,2911724530,2940836483
2025-06-19 11:38:20,REAL,2911724530,816,2911725346,2940837299
2025-06-19 11:38:22,FAKE,2911725346,244,2911725590,2940837778
2025-06-19 11:38:24,REAL,2911725590,542,2911726132,2940838320
2025-06-19 11:38:26,REAL,2911726132,487,2911726619,2940838807
2025-06-19 11:38:28,FAKE,2911726619,238,2911726857,2940839289
2025-06-19 11:38:30,FAKE,2911726857,243,2911727100,2940839769
2025-06-19 11:38:32,REAL,2911727100,484,2911727584,2940840253
2025-06-19 11:38:34,REAL,2911727584,481,2911728065,2940840734
2025-06-19 11:38:36,REAL,2911728065,486,2911728551,2940841220
2025-06-19 11:38:38,REAL,2911728551,489,2911729040,2940841709
2025-06-19 11:38:40,FAKE,2911729040,241,2911729281,2940842185
2025-06-19 11:38:42,REAL,2911729281,487,2911729768,2940842672
2025-06-19 11:38:44,REAL,2911729768,534,2911730302,2940843206
2025-06-19 11:38:46,REAL,2911730302,486,2911730788,2940843692
2025-06-19 11:38:48,REAL,2911730788,486,2911731274,2940844178
2025-06-19 11:38:50,REAL,2911731274,477,2911731751,2940844655
2025-06-19 11:38:52,REAL,2911731751,485,2911732236,2940845140
2025-06-19 11:38:54,REAL,2911732236,480,2911732716,2940845620
2025-06-19 11:38:56,REAL,2911732716,476,2911733192,2940846096
2025-06-19 11:38:58,REAL,2911733192,485,2911733677,2940846581
2025-06-19 11:39:00,REAL,2911733677,486,2911734163,2940847067
2025-06-19 11:39:02,FAKE,2911734163,243,2911734406,2940847556
2025-06-19 11:39:04,REAL,2911734406,485,2911734891,2940848041
2025-06-19 11:39:06,REAL,2911734891,536,2911735427,2940848577
2025-06-19 11:39:08,REAL,2911735427,479,2911735906,2940849056
2025-06-19 11:39:10,FAKE,2911735906,238,2911736144,2940849546
2025-06-19 11:39:12,FAKE,2911736144,241,2911736385,2940850093
2025-06-19 11:39:14,REAL,2911736385,483,2911736868,2940850576
2025-06-19 11:39:16,REAL,2911736868,481,2911737349,2940851057
2025-06-19 11:39:18,REAL,2911737349,484,2911737833,2940851541
2025-06-19 11:39:20,REAL,2911737833,487,2911738320,2940852028
2025-06-19 11:39:22,REAL,2911738320,487,2911738807,2940852515
2025-06-19 11:39:24,FAKE,2911738807,238,2911739045,2940853004
2025-06-19 11:39:26,FAKE,2911739045,244,2911739289,2940853485
2025-06-19 11:39:28,REAL,2911739289,475,2911739764,2940853960
2025-06-19 11:39:30,REAL,2911739764,546,2911740310,2940854506
2025-06-19 11:39:32,REAL,2911740310,487,2911740797,2940854993
2025-06-19 11:39:34,REAL,2911740797,477,2911741274,2940855470
2025-06-19 11:39:36,REAL,2911741274,485,2911741759,2940855955
2025-06-19 11:39:38,REAL,2911741759,493,2911742252,2940856448
2025-06-19 11:39:40,FAKE,2911742252,243,2911742495,2940856936
2025-06-19 11:39:42,REAL,2911742495,480,2911742975,2940857416
2025-06-19 11:39:44,FAKE,2911742975,238,2911743213,2940857899
2025-06-19 11:39:46,REAL,2911743213,485,2911743698,2940858384
2025-06-19 11:39:48,REAL,2911743698,483,2911744181,2940858867
2025-06-19 11:39:50,REAL,2911744181,483,2911744664,2940859350
2025-06-19 11:39:52,REAL,2911744664,544,2911745208,2940859894
2025-06-19 11:39:54,REAL,2911745208,485,2911745693,2940860379
2025-06-19 11:39:56,REAL,2911745693,488,2911746181,2940860867
2025-06-19 11:39:58,REAL,2911746181,541,2911746722,2940861408
2025-06-19 11:40:00,REAL,2911746722,484,2911747206,2940861892
2025-06-19 11:40:02,REAL,2911747206,480,2911747686,2940862372
2025-06-19 11:40:04,REAL,2911747686,490,2911748176,2940862862
2025-06-19 11:40:06,REAL,2911748176,480,2911748656,2940863342
2025-06-19 11:40:08,REAL,2911748656,483,2911749139,2940863825
2025-06-19 11:40:10,REAL,2911749139,8276,2911757415,2940872101
2025-06-19 11:40:12,REAL,2911757415,10906,2911768321,2940883007
2025-06-19 11:40:14,FAKE,2911768321,238,2911768559,2940893328
2025-06-19 11:40:16,REAL,2911768559,10260,2911778819,2940903588
2025-06-19 11:40:18,REAL,2911778819,10254,2911789073,2940913842
2025-06-19 11:40:20,FAKE,2911789073,243,2911789316,2940924156
2025-06-19 11:40:22,REAL,2911789316,10252,2911799568,2940934408
2025-06-19 11:40:24,REAL,2911799568,8606,2911808174,2940943014
2025-06-19 11:40:26,FAKE,2911808174,243,2911808417,2940943493
2025-06-19 11:40:28,REAL,2911808417,489,2911808906,2940943982
2025-06-19 11:40:30,REAL,2911808906,2666,2911811572,2940946648
2025-06-19 11:40:32,REAL,2911811572,12244,2911823816,2940958892
2025-06-19 11:40:34,REAL,2911823816,10316,2911834132,2940969208
2025-06-19 11:40:36,REAL,2911834132,10249,2911844381,2940979457
2025-06-19 11:40:38,REAL,2911844381,10326,2911854707,2940989783
2025-06-19 11:40:40,REAL,2911854707,10249,2911864956,2941000032
2025-06-19 11:40:42,FAKE,2911864956,244,2911865200,2941010290
2025-06-19 11:40:44,FAKE,2911865200,243,2911865443,2941020606
2025-06-19 11:40:46,REAL,2911865443,3447,2911868890,2941024053
2025-06-19 11:40:48,REAL,2911868890,475,2911869365,2941024528
2025-06-19 11:40:50,REAL,2911869365,485,2911869850,2941025013
2025-06-19 11:40:52,FAKE,2911869850,243,2911870093,2941025560
2025-06-19 11:40:54,FAKE,2911870093,243,2911870336,2941026047
2025-06-19 11:40:56,REAL,2911870336,487,2911870823,2941026534
2025-06-19 11:40:58,FAKE,2911870823,244,2911871067,2941027018
2025-06-19 11:41:00,REAL,2911871067,483,2911871550,2941027501
2025-06-19 11:41:02,FAKE,2911871550,238,2911871788,2941031155
2025-06-19 11:41:04,REAL,2911871788,15144,2911886932,2941046299
2025-06-19 11:41:06,REAL,2911886932,10387,2911897319,2941056686
2025-06-19 11:41:08,REAL,2911897319,10182,2911907501,2941066868
2025-06-19 11:41:10,FAKE,2911907501,244,2911907745,2941077128
2025-06-19 11:41:12,FAKE,2911907745,244,2911907989,2941087449
2025-06-19 11:41:14,FAKE,2911907989,243,2911908232,2941097697
2025-06-19 11:41:16,FAKE,2911908232,243,2911908475,2941107952
2025-06-19 11:41:18,REAL,2911908475,2793,2911911268,2941110745
2025-06-19 11:41:20,REAL,2911911268,488,2911911756,2941111233
2025-06-19 11:41:22,FAKE,2911911756,238,2911911994,2941111714
2025-06-19 11:41:24,REAL,2911911994,536,2911912530,2941112250
2025-06-19 11:41:26,REAL,2911912530,482,2911913012,2941112732
2025-06-19 11:41:28,REAL,2911913012,492,2911913504,2941113224
2025-06-19 11:41:30,FAKE,2911913504,244,2911913748,2941113703
2025-06-19 11:41:32,FAKE,2911913748,243,2911913991,2941114241
2025-06-19 11:41:34,REAL,2911913991,4323,2911918314,2941118564
2025-06-19 11:41:36,FAKE,2911918314,241,2911918555,2941129681
2025-06-19 11:41:38,FAKE,2911918555,241,2911918796,2941140003
2025-06-19 11:41:40,FAKE,2911918796,238,2911919034,2941150245
2025-06-19 11:41:42,FAKE,2911919034,244,2911919278,2941160498
2025-06-19 11:41:44,FAKE,2911919278,243,2911919521,2941170745
2025-06-19 11:41:46,REAL,2911919521,10316,2911929837,2941181061
2025-06-19 11:41:48,FAKE,2911929837,241,2911930078,2941191317
2025-06-19 11:41:50,FAKE,2911930078,238,2911930316,2941193455
2025-06-19 11:41:52,REAL,2911930316,479,2911930795,2941193934
2025-06-19 11:41:54,REAL,2911930795,487,2911931282,2941194421
2025-06-19 11:41:56,REAL,2911931282,539,2911931821,2941194960
2025-06-19 11:41:58,REAL,2911931821,542,2911932363,2941195502
2025-06-19 11:42:00,FAKE,2911932363,238,2911932601,2941195979
2025-06-19 11:42:02,REAL,2911932601,486,2911933087,2941196465
2025-06-19 11:42:04,FAKE,2911933087,238,2911933325,2941196951
2025-06-19 11:42:06,REAL,2911933325,483,2911933808,2941197434
2025-06-19 11:42:08,REAL,2911933808,480,2911934288,2941197914
2025-06-19 11:42:10,FAKE,2911934288,244,2911934532,2941198401
2025-06-19 11:42:12,REAL,2911934532,478,2911935010,2941198879
2025-06-19 11:42:14,FAKE,2911935010,238,2911935248,2941199365
2025-06-19 11:42:16,REAL,2911935248,483,2911935731,2941199848
2025-06-19 11:42:18,REAL,2911935731,484,2911936215,2941200332
2025-06-19 11:42:20,REAL,2911936215,540,2911936755,2941200872
2025-06-19 11:42:22,FAKE,2911936755,241,2911936996,2941211581
2025-06-19 11:42:24,FAKE,2911936996,238,2911937234,2941221968
2025-06-19 11:42:26,REAL,2911937234,10322,2911947556,2941232290
2025-06-19 11:42:28,REAL,2911947556,10242,2911957798,2941242532
2025-06-19 11:42:30,REAL,2911957798,10249,2911968047,2941252781
2025-06-19 11:42:32,FAKE,2911968047,243,2911968290,2941263029
2025-06-19 11:42:34,FAKE,2911968290,241,2911968531,2941273281
2025-06-19 11:42:36,REAL,2911968531,6422,2911974953,2941279703
2025-06-19 11:42:38,FAKE,2911974953,244,2911975197,2941280178
2025-06-19 11:42:40,REAL,2911975197,481,2911975678,2941280659
2025-06-19 11:42:42,REAL,2911975678,482,2911976160,2941281141
2025-06-19 11:42:44,REAL,2911976160,542,2911976702,2941281683
2025-06-19 11:42:46,REAL,2911976702,532,2911977234,2941282215
2025-06-19 11:42:48,REAL,2911977234,483,2911977717,2941282698
2025-06-19 11:42:50,FAKE,2911977717,238,2911977955,2941283182
2025-06-19 11:42:52,REAL,2911977955,491,2911978446,2941283673
2025-06-19 11:42:54,FAKE,2911978446,244,2911978690,2941284162
2025-06-19 11:42:56,REAL,2911978690,481,2911979171,2941284643
2025-06-19 11:42:58,FAKE,2911979171,238,2911979409,2941295306
2025-06-19 11:43:00,REAL,2911979409,10316,2911989725,2941305622
2025-06-19 11:43:02,FAKE,2911989725,243,2911989968,2941315937
2025-06-19 11:43:04,REAL,2911989968,10250,2912000218,2941326187
2025-06-19 11:43:06,REAL,2912000218,10255,2912010473,2941336442
2025-06-19 11:43:08,REAL,2912010473,10246,2912020719,2941346688
2025-06-19 11:43:10,REAL,2912020719,10306,2912031025,2941356994
2025-06-19 11:43:12,REAL,2912031025,6299,2912037324,2941363293
2025-06-19 11:43:14,REAL,2912037324,483,2912037807,2941363776
2025-06-19 11:43:16,FAKE,2912037807,243,2912038050,2941364262
2025-06-19 11:43:18,FAKE,2912038050,244,2912038294,2941370635
2025-06-19 11:43:20,REAL,2912038294,13686,2912051980,2941384321
2025-06-19 11:43:22,FAKE,2912051980,243,2912052223,2941394635
2025-06-19 11:43:24,FAKE,2912052223,244,2912052467,2941404884
2025-06-19 11:43:26,REAL,2912052467,10252,2912062719,2941415136
2025-06-19 11:43:28,FAKE,2912062719,244,2912062963,2941425453
2025-06-19 11:43:30,REAL,2912062963,10245,2912073208,2941435698
2025-06-19 11:43:32,REAL,2912073208,10325,2912083533,2941446023
2025-06-19 11:43:34,REAL,2912083533,1013,2912084546,2941447036
2025-06-19 11:43:36,REAL,2912084546,547,2912085093,2941447583
2025-06-19 11:43:38,REAL,2912085093,485,2912085578,2941448068
2025-06-19 11:43:40,REAL,2912085578,488,2912086066,2941448556
2025-06-19 11:43:42,REAL,2912086066,490,2912086556,2941449046
2025-06-19 11:43:44,REAL,2912086556,492,2912087048,2941449538
2025-06-19 11:43:46,REAL,2912087048,485,2912087533,2941450023
2025-06-19 11:43:48,REAL,2912087533,478,2912088011,2941450501
2025-06-19 11:43:50,REAL,2912088011,483,2912088494,2941450984
2025-06-19 11:43:52,REAL,2912088494,482,2912088976,2941451466
2025-06-19 11:43:54,REAL,2912088976,491,2912089467,2941451957
2025-06-19 11:43:56,REAL,2912089467,477,2912089944,2941452434
2025-06-19 11:43:58,FAKE,2912089944,244,2912090188,2941452911
2025-06-19 11:44:00,FAKE,2912090188,241,2912090429,2941453453
2025-06-19 11:44:02,FAKE,2912090429,244,2912090673,2941453932
2025-06-19 11:44:04,FAKE,2912090673,241,2912090914,2941454415
2025-06-19 11:44:06,REAL,2912090914,549,2912091463,2941454964
2025-06-19 11:44:08,REAL,2912091463,479,2912091942,2941455443
2025-06-19 11:44:10,FAKE,2912091942,238,2912092180,2941455926
2025-06-19 11:44:12,REAL,2912092180,489,2912092669,2941456415
2025-06-19 11:44:14,REAL,2912092669,492,2912093161,2941456907
2025-06-19 11:44:16,REAL,2912093161,485,2912093646,2941457392
2025-06-19 11:44:18,FAKE,2912093646,244,2912093890,2941457880
2025-06-19 11:44:20,REAL,2912093890,484,2912094374,2941458364
2025-06-19 11:44:22,REAL,2912094374,7496,2912101870,2941465860
2025-06-19 11:44:24,REAL,2912101870,11121,2912112991,2941476981
2025-06-19 11:44:26,REAL,2912112991,10255,2912123246,2941487236
2025-06-19 11:44:28,FAKE,2912123246,241,2912123487,2941497553
2025-06-19 11:44:30,REAL,2912123487,10250,2912133737,2941507803
2025-06-19 11:44:32,FAKE,2912133737,241,2912133978,2941518121
2025-06-19 11:44:34,REAL,2912133978,10245,2912144223,2941528366
2025-06-19 11:44:36,FAKE,2912144223,238,2912144461,2941537885
2025-06-19 11:44:38,REAL,2912144461,483,2912144944,2941538368
2025-06-19 11:44:40,FAKE,2912144944,238,2912145182,2941538850
2025-06-19 11:44:42,REAL,2912145182,490,2912145672,2941539340
2025-06-19 11:44:44,REAL,2912145672,481,2912146153,2941539821
2025-06-19 11:44:46,REAL,2912146153,490,2912146643,2941540311
2025-06-19 11:44:48,FAKE,2912146643,241,2912146884,2941540851
2025-06-19 11:44:50,REAL,2912146884,487,2912147371,2941541338
2025-06-19 11:44:52,FAKE,2912147371,243,2912147614,2941541823
2025-06-19 11:44:54,REAL,2912147614,9802,2912157416,2941551625
2025-06-19 11:44:56,FAKE,2912157416,238,2912157654,2941564458
2025-06-19 11:44:58,REAL,2912157654,10256,2912167910,2941574714
2025-06-19 11:45:00,REAL,2912167910,10251,2912178161,2941584965
2025-06-19 11:45:02,REAL,2912178161,10245,2912188406,2941595210
2025-06-19 11:45:04,FAKE,2912188406,238,2912188644,2941605538
2025-06-19 11:45:06,FAKE,2912188644,244,2912188888,2941615799
2025-06-19 11:45:08,FAKE,2912188888,241,2912189129,2941624733
2025-06-19 11:45:10,REAL,2912189129,483,2912189612,2941625216
2025-06-19 11:45:12,REAL,2912189612,488,2912190100,2941625704
2025-06-19 11:45:14,FAKE,2912190100,241,2912190341,2941626244
2025-06-19 11:45:16,REAL,2912190341,492,2912190833,2941626736
2025-06-19 11:45:18,REAL,2912190833,476,2912191309,2941627212
2025-06-19 11:45:20,REAL,2912191309,485,2912191794,2941627697
2025-06-19 11:45:22,FAKE,2912191794,238,2912192032,2941628178
2025-06-19 11:45:24,REAL,2912192032,477,2912192509,2941628655
2025-06-19 11:45:26,FAKE,2912192509,244,2912192753,2941629135
2025-06-19 11:45:28,REAL,2912192753,486,2912193239,2941629621
2025-06-19 11:45:30,REAL,2912193239,492,2912193731,2941630113
2025-06-19 11:45:32,FAKE,2912193731,241,2912193972,2941630601
2025-06-19 11:45:34,REAL,2912193972,489,2912194461,2941631090
2025-06-19 11:45:36,REAL,2912194461,485,2912194946,2941631575
2025-06-19 11:45:38,FAKE,2912194946,238,2912195184,2941632112
2025-06-19 11:45:40,REAL,2912195184,536,2912195720,2941632648
2025-06-19 11:45:42,FAKE,2912195720,238,2912195958,2941633130
2025-06-19 11:45:44,FAKE,2912195958,244,2912196202,2941633623
2025-06-19 11:45:46,FAKE,2912196202,238,2912196440,2941634105
2025-06-19 11:45:48,REAL,2912196440,484,2912196924,2941634589
2025-06-19 11:45:50,REAL,2912196924,477,2912197401,2941635066
2025-06-19 11:45:52,REAL,2912197401,483,2912197884,2941635549
2025-06-19 11:45:54,REAL,2912197884,477,2912198361,2941636026
2025-06-19 11:45:56,REAL,2912198361,485,2912198846,2941636511
2025-06-19 11:45:58,REAL,2912198846,486,2912199332,2941636997
2025-06-19 11:46:00,REAL,2912199332,491,2912199823,2941637488
2025-06-19 11:46:02,REAL,2912199823,485,2912200308,2941637973
2025-06-19 11:46:04,REAL,2912200308,542,2912200850,2941638515
2025-06-19 11:46:06,REAL,2912200850,483,2912201333,2941638998
2025-06-19 11:46:08,REAL,2912201333,477,2912201810,2941639475
2025-06-19 11:46:10,FAKE,2912201810,243,2912202053,2941639961
2025-06-19 11:46:12,REAL,2912202053,478,2912202531,2941640439
2025-06-19 11:46:14,REAL,2912202531,484,2912203015,2941640923
2025-06-19 11:46:16,REAL,2912203015,490,2912203505,2941641413
2025-06-19 11:46:18,FAKE,2912203505,243,2912203748,2941652660
2025-06-19 11:46:20,REAL,2912203748,11508,2912215256,2941664168
2025-06-19 11:46:22,REAL,2912215256,10252,2912225508,2941674420
2025-06-19 11:46:24,REAL,2912225508,10252,2912235760,2941684672
2025-06-19 11:46:26,REAL,2912235760,10249,2912246009,2941694921
2025-06-19 11:46:28,REAL,2912246009,10243,2912256252,2941705164
2025-06-19 11:46:30,REAL,2912256252,10315,2912266567,2941715479
2025-06-19 11:46:32,FAKE,2912266567,238,2912266805,2941723159
2025-06-19 11:46:34,REAL,2912266805,485,2912267290,2941723644
2025-06-19 11:46:36,REAL,2912267290,482,2912267772,2941724126
2025-06-19 11:46:38,REAL,2912267772,478,2912268250,2941724604
2025-06-19 11:46:40,REAL,2912268250,487,2912268737,2941725091
2025-06-19 11:46:42,REAL,2912268737,480,2912269217,2941725571
2025-06-19 11:46:44,REAL,2912269217,483,2912269700,2941726054
2025-06-19 11:46:46,REAL,2912269700,479,2912270179,2941726533
2025-06-19 11:46:48,REAL,2912270179,480,2912270659,2941727013
2025-06-19 11:46:50,REAL,2912270659,485,2912271144,2941727498
2025-06-19 11:46:52,REAL,2912271144,481,2912271625,2941727979
2025-06-19 11:46:54,REAL,2912271625,481,2912272106,2941728460
2025-06-19 11:46:56,REAL,2912272106,486,2912272592,2941728946
2025-06-19 11:46:58,REAL,2912272592,543,2912273135,2941729489
2025-06-19 11:47:00,REAL,2912273135,478,2912273613,2941729967
2025-06-19 11:47:02,FAKE,2912273613,243,2912273856,2941730447
2025-06-19 11:47:04,REAL,2912273856,544,2912274400,2941730991
2025-06-19 11:47:06,REAL,2912274400,488,2912274888,2941731479
2025-06-19 11:47:08,FAKE,2912274888,243,2912275131,2941731961
2025-06-19 11:47:10,REAL,2912275131,485,2912275616,2941732446
2025-06-19 11:47:12,REAL,2912275616,481,2912276097,2941732927
2025-06-19 11:47:14,REAL,2912276097,482,2912276579,2941733409
2025-06-19 11:47:16,REAL,2912276579,476,2912277055,2941733885
2025-06-19 11:47:18,REAL,2912277055,475,2912277530,2941734360
2025-06-19 11:47:20,REAL,2912277530,488,2912278018,2941734848
2025-06-19 11:47:22,REAL,2912278018,486,2912278504,2941735334
2025-06-19 11:47:24,REAL,2912278504,542,2912279046,2941735876
2025-06-19 11:47:26,REAL,2912279046,486,2912279532,2941736362
2025-06-19 11:47:28,REAL,2912279532,486,2912280018,2941736848
2025-06-19 11:47:30,REAL,2912280018,491,2912280509,2941737339
2025-06-19 11:47:32,REAL,2912280509,480,2912280989,2941737819
2025-06-19 11:47:34,REAL,2912280989,483,2912281472,2941738302
2025-06-19 11:47:36,REAL,2912281472,487,2912281959,2941738789
2025-06-19 11:47:38,FAKE,2912281959,238,2912282197,2941739278
2025-06-19 11:47:40,FAKE,2912282197,241,2912282438,2941739758
2025-06-19 11:47:42,REAL,2912282438,482,2912282920,2941740240
2025-06-19 11:47:44,FAKE,2912282920,238,2912283158,2941740721
2025-06-19 11:47:46,REAL,2912283158,486,2912283644,2941741207
2025-06-19 11:47:48,REAL,2912283644,481,2912284125,2941741688
2025-06-19 11:47:50,FAKE,2912284125,244,2912284369,2941742220
2025-06-19 11:47:52,REAL,2912284369,541,2912284910,2941742761
2025-06-19 11:47:54,FAKE,2912284910,244,2912285154,2941743250
2025-06-19 11:47:56,REAL,2912285154,481,2912285635,2941743731
2025-06-19 11:47:58,REAL,2912285635,11136,2912296771,2941754867
2025-06-19 11:48:00,FAKE,2912296771,238,2912297009,2941765179
2025-06-19 11:48:02,REAL,2912297009,10244,2912307253,2941775423
2025-06-19 11:48:04,REAL,2912307253,10317,2912317570,2941785740
2025-06-19 11:48:06,REAL,2912317570,10320,2912327890,2941796060
2025-06-19 11:48:08,FAKE,2912327890,238,2912328128,2941806315
2025-06-19 11:48:10,REAL,2912328128,10260,2912338388,2941816575
2025-06-19 11:48:12,REAL,2912338388,6159,2912344547,2941822734
2025-06-19 11:48:14,REAL,2912344547,492,2912345039,2941823226
2025-06-19 11:48:16,REAL,2912345039,483,2912345522,2941823709
2025-06-19 11:48:18,REAL,2912345522,538,2912346060,2941824247
2025-06-19 11:48:20,FAKE,2912346060,241,2912346301,2941824725
2025-06-19 11:48:22,FAKE,2912346301,244,2912346545,2941825212
2025-06-19 11:48:24,REAL,2912346545,481,2912347026,2941825693
2025-06-19 11:48:26,REAL,2912347026,490,2912347516,2941826183
2025-06-19 11:48:28,REAL,2912347516,480,2912347996,2941826663
2025-06-19 11:48:30,REAL,2912347996,487,2912348483,2941827150
2025-06-19 11:48:32,REAL,2912348483,482,2912348965,2941827632
2025-06-19 11:48:34,REAL,2912348965,6045,2912355010,2941833677
2025-06-19 11:48:36,REAL,2912355010,11108,2912366118,2941844785
2025-06-19 11:48:38,REAL,2912366118,10321,2912376439,2941855106
2025-06-19 11:48:40,FAKE,2912376439,243,2912376682,2941865359
2025-06-19 11:48:42,REAL,2912376682,10257,2912386939,2941875616
2025-06-19 11:48:44,REAL,2912386939,10314,2912397253,2941885930
2025-06-19 11:48:46,FAKE,2912397253,241,2912397494,2941896241
2025-06-19 11:48:48,FAKE,2912397494,241,2912397735,2941906557
2025-06-19 11:48:50,FAKE,2912397735,238,2912397973,2941907043
2025-06-19 11:48:52,FAKE,2912397973,238,2912398211,2941907537
2025-06-19 11:48:54,FAKE,2912398211,243,2912398454,2941908019
2025-06-19 11:48:56,REAL,2912398454,12189,2912410643,2941920208
2025-06-19 11:48:58,REAL,2912410643,10324,2912420967,2941930532
2025-06-19 11:49:00,FAKE,2912420967,243,2912421210,2941940788
2025-06-19 11:49:02,REAL,2912421210,10314,2912431524,2941951102
2025-06-19 11:49:04,FAKE,2912431524,243,2912431767,2941961361
2025-06-19 11:49:06,REAL,2912431767,10260,2912442027,2941971621
2025-06-19 11:49:08,REAL,2912442027,10319,2912452346,2941981940
2025-06-19 11:49:10,REAL,2912452346,5099,2912457445,2941987039
2025-06-19 11:49:12,FAKE,2912457445,238,2912457683,2941987573
2025-06-19 11:49:14,REAL,2912457683,480,2912458163,2941988053
2025-06-19 11:49:16,REAL,2912458163,492,2912458655,2941988545
2025-06-19 11:49:18,REAL,2912458655,486,2912459141,2941989031
2025-06-19 11:49:20,REAL,2912459141,487,2912459628,2941989518
2025-06-19 11:49:22,FAKE,2912459628,238,2912459866,2941990007
2025-06-19 11:49:24,REAL,2912459866,481,2912460347,2941990488
2025-06-19 11:49:26,REAL,2912460347,489,2912460836,2941990977
2025-06-19 11:49:28,REAL,2912460836,487,2912461323,2941991464
2025-06-19 11:49:30,REAL,2912461323,543,2912461866,2941992007
2025-06-19 11:49:32,REAL,2912461866,485,2912462351,2941992492
2025-06-19 11:49:34,REAL,2912462351,477,2912462828,2941992969
2025-06-19 11:49:36,REAL,2912462828,1284,2912464112,2941994253
2025-06-19 11:49:38,REAL,2912464112,15267,2912479379,2942009520
2025-06-19 11:49:40,FAKE,2912479379,238,2912479617,2942019773
2025-06-19 11:49:42,REAL,2912479617,11379,2912490996,2942031152
2025-06-19 11:49:44,REAL,2912490996,9193,2912500189,2942040345
2025-06-19 11:49:46,REAL,2912500189,10246,2912510435,2942050591
2025-06-19 11:49:48,REAL,2912510435,10314,2912520749,2942060905
2025-06-19 11:49:50,REAL,2912520749,10254,2912531003,2942071159
2025-06-19 11:49:52,FAKE,2912531003,243,2912531246,2942075673
2025-06-19 11:49:54,REAL,2912531246,491,2912531737,2942076164
2025-06-19 11:49:56,REAL,2912531737,481,2912532218,2942076645
2025-06-19 11:49:58,FAKE,2912532218,243,2912532461,2942085910
2025-06-19 11:50:00,REAL,2912532461,12229,2912544690,2942098139
2025-06-19 11:50:02,FAKE,2912544690,243,2912544933,2942108462
2025-06-19 11:50:04,FAKE,2912544933,238,2912545171,2942118716
2025-06-19 11:50:06,FAKE,2912545171,241,2912545412,2942129098
2025-06-19 11:50:08,FAKE,2912545412,243,2912545655,2942139347
2025-06-19 11:50:10,REAL,2912545655,10252,2912555907,2942149599
2025-06-19 11:50:12,REAL,2912555907,9135,2912565042,2942158734
2025-06-19 11:50:14,REAL,2912565042,488,2912565530,2942159222
2025-06-19 11:50:16,REAL,2912565530,477,2912566007,2942159699
2025-06-19 11:50:18,REAL,2912566007,491,2912566498,2942160190
2025-06-19 11:50:20,REAL,2912566498,480,2912566978,2942160670
2025-06-19 11:50:22,FAKE,2912566978,243,2912567221,2942161156
2025-06-19 11:50:24,REAL,2912567221,491,2912567712,2942161647
2025-06-19 11:50:26,REAL,2912567712,486,2912568198,2942162133
2025-06-19 11:50:28,REAL,2912568198,486,2912568684,2942162619
2025-06-19 11:50:30,REAL,2912568684,10583,2912579267,2942173202
2025-06-19 11:50:32,FAKE,2912579267,244,2912579511,2942184848
2025-06-19 11:50:34,FAKE,2912579511,241,2912579752,2942195092
2025-06-19 11:50:36,REAL,2912579752,10257,2912590009,2942205349
2025-06-19 11:50:38,REAL,2912590009,10252,2912600261,2942215601
2025-06-19 11:50:40,REAL,2912600261,10250,2912610511,2942225851
2025-06-19 11:50:42,REAL,2912610511,10256,2912620767,2942236107
2025-06-19 11:50:44,FAKE,2912620767,238,2912621005,2942244570
2025-06-19 11:50:46,REAL,2912621005,484,2912621489,2942245054
2025-06-19 11:50:48,FAKE,2912621489,244,2912621733,2942245538
2025-06-19 11:50:50,REAL,2912621733,483,2912622216,2942246021
2025-06-19 11:50:52,FAKE,2912622216,243,2912622459,2942246501
2025-06-19 11:50:54,FAKE,2912622459,241,2912622700,2942246985
2025-06-19 11:50:56,REAL,2912622700,483,2912623183,2942247468
2025-06-19 11:50:58,FAKE,2912623183,238,2912623421,2942248004
2025-06-19 11:51:00,REAL,2912623421,490,2912623911,2942248494
2025-06-19 11:51:02,REAL,2912623911,9277,2912633188,2942257771
2025-06-19 11:51:04,FAKE,2912633188,241,2912633429,2942268350
2025-06-19 11:51:06,FAKE,2912633429,243,2912633672,2942278593
2025-06-19 11:51:08,REAL,2912633672,10256,2912643928,2942288849
2025-06-19 11:51:10,FAKE,2912643928,244,2912644172,2942299108
2025-06-19 11:51:12,REAL,2912644172,10257,2912654429,2942309365
2025-06-19 11:51:14,REAL,2912654429,10255,2912664684,2942319620
2025-06-19 11:51:16,REAL,2912664684,7876,2912672560,2942327496
2025-06-19 11:51:18,FAKE,2912672560,238,2912672798,2942327981
2025-06-19 11:51:20,FAKE,2912672798,243,2912673041,2942328457
2025-06-19 11:51:22,REAL,2912673041,479,2912673520,2942328936
2025-06-19 11:51:24,REAL,2912673520,490,2912674010,2942329426
2025-06-19 11:51:26,REAL,2912674010,484,2912674494,2942329910
2025-06-19 11:51:28,REAL,2912674494,487,2912674981,2942330397
2025-06-19 11:51:30,FAKE,2912674981,243,2912675224,2942330879
2025-06-19 11:51:32,REAL,2912675224,481,2912675705,2942331360
2025-06-19 11:51:34,REAL,2912675705,9860,2912685565,2942341220
2025-06-19 11:51:36,REAL,2912685565,10586,2912696151,2942351806
2025-06-19 11:51:38,REAL,2912696151,10317,2912706468,2942362123
2025-06-19 11:51:40,REAL,2912706468,10249,2912716717,2942372372
2025-06-19 11:51:42,REAL,2912716717,10327,2912727044,2942382699
2025-06-19 11:51:44,FAKE,2912727044,244,2912727288,2942393013
2025-06-19 11:51:46,FAKE,2912727288,243,2912727531,2942403263
2025-06-19 11:51:48,REAL,2912727531,7220,2912734751,2942410483
2025-06-19 11:51:50,FAKE,2912734751,241,2912734992,2942410965
2025-06-19 11:51:52,REAL,2912734992,478,2912735470,2942411443
2025-06-19 11:51:54,FAKE,2912735470,238,2912735708,2942416104
2025-06-19 11:51:56,REAL,2912735708,11509,2912747217,2942427613
2025-06-19 11:51:58,REAL,2912747217,10250,2912757467,2942437863
2025-06-19 11:52:00,REAL,2912757467,10320,2912767787,2942448183
2025-06-19 11:52:02,REAL,2912767787,10250,2912778037,2942458433
2025-06-19 11:52:04,REAL,2912778037,10259,2912788296,2942468692
2025-06-19 11:52:06,REAL,2912788296,10259,2912798555,2942478951
2025-06-19 11:52:08,REAL,2912798555,10075,2912808630,2942489026
2025-06-19 11:52:10,REAL,2912808630,1935,2912810565,2942490961
2025-06-19 11:52:12,REAL,2912810565,488,2912811053,2942491449
2025-06-19 11:52:14,REAL,2912811053,484,2912811537,2942491933
2025-06-19 11:52:16,FAKE,2912811537,238,2912811775,2942502716
2025-06-19 11:52:18,REAL,2912811775,10320,2912822095,2942513036
2025-06-19 11:52:20,REAL,2912822095,10250,2912832345,2942523286
2025-06-19 11:52:22,REAL,2912832345,10255,2912842600,2942533541
2025-06-19 11:52:24,FAKE,2912842600,241,2912842841,2942543798
2025-06-19 11:52:26,FAKE,2912842841,244,2912843085,2942554051
2025-06-19 11:52:28,REAL,2912843085,10309,2912853394,2942564360
2025-06-19 11:52:30,REAL,2912853394,6488,2912859882,2942570848
2025-06-19 11:52:32,FAKE,2912859882,243,2912860125,2942571332
2025-06-19 11:52:34,REAL,2912860125,485,2912860610,2942571817
2025-06-19 11:52:36,REAL,2912860610,5245,2912865855,2942577062
2025-06-19 11:52:38,REAL,2912865855,11401,2912877256,2942588463
2025-06-19 11:52:40,REAL,2912877256,10320,2912887576,2942598783
2025-06-19 11:52:42,FAKE,2912887576,244,2912887820,2942609037
2025-06-19 11:52:44,REAL,2912887820,10259,2912898079,2942619296
2025-06-19 11:52:46,REAL,2912898079,10322,2912908401,2942629618
2025-06-19 11:52:48,REAL,2912908401,10245,2912918646,2942639863
2025-06-19 11:52:50,REAL,2912918646,10259,2912928905,2942650122
2025-06-19 11:52:52,REAL,2912928905,1272,2912930177,2942651394
2025-06-19 11:52:54,REAL,2912930177,493,2912930670,2942651887
2025-06-19 11:52:56,REAL,2912930670,479,2912931149,2942652366
2025-06-19 11:52:58,REAL,2912931149,485,2912931634,2942652851
2025-06-19 11:53:00,FAKE,2912931634,243,2912931877,2942653335
2025-06-19 11:53:02,REAL,2912931877,482,2912932359,2942653817
2025-06-19 11:53:04,REAL,2912932359,487,2912932846,2942654304
2025-06-19 11:53:06,REAL,2912932846,486,2912933332,2942654790
2025-06-19 11:53:08,REAL,2912933332,480,2912933812,2942655270
2025-06-19 11:53:10,FAKE,2912933812,243,2912934055,2942655755
2025-06-19 11:53:12,REAL,2912934055,544,2912934599,2942656299
2025-06-19 11:53:14,REAL,2912934599,541,2912935140,2942656840
2025-06-19 11:53:16,REAL,2912935140,481,2912935621,2942657321
2025-06-19 11:53:18,REAL,2912935621,487,2912936108,2942657808
2025-06-19 11:53:20,FAKE,2912936108,241,2912936349,2942658298
2025-06-19 11:53:22,FAKE,2912936349,238,2912936587,2942658777
2025-06-19 11:53:24,REAL,2912936587,486,2912937073,2942659263
2025-06-19 11:53:26,FAKE,2912937073,238,2912937311,2942659746
2025-06-19 11:53:28,REAL,2912937311,483,2912937794,2942660229
2025-06-19 11:53:30,REAL,2912937794,11718,2912949512,2942671947
2025-06-19 11:53:32,REAL,2912949512,10323,2912959835,2942682270
2025-06-19 11:53:34,REAL,2912959835,10252,2912970087,2942692522
2025-06-19 11:53:36,REAL,2912970087,10247,2912980334,2942702769
2025-06-19 11:53:38,FAKE,2912980334,241,2912980575,2942713084
2025-06-19 11:53:40,REAL,2912980575,10258,2912990833,2942723342
2025-06-19 11:53:42,FAKE,2912990833,244,2912991077,2942733588
2025-06-19 11:53:44,REAL,2912991077,5405,2912996482,2942738993
2025-06-19 11:53:46,REAL,2912996482,243,2912996725,2942739236
2025-06-19 11:53:48,REAL,2912996725,484,2912997209,2942739720
2025-06-19 11:53:50,REAL,2912997209,483,2912997692,2942740203
2025-06-19 11:53:52,FAKE,2912997692,241,2912997933,2942740688
2025-06-19 11:53:54,REAL,2912997933,492,2912998425,2942741180
2025-06-19 11:53:56,REAL,2912998425,483,2912998908,2942741663
2025-06-19 11:53:58,REAL,2912998908,543,2912999451,2942742206
2025-06-19 11:54:00,REAL,2912999451,1276,2913000727,2942743482
2025-06-19 11:54:02,REAL,2913000727,11898,2913012625,2942755380
2025-06-19 11:54:04,REAL,2913012625,10247,2913022872,2942765627
2025-06-19 11:54:06,REAL,2913022872,10256,2913033128,2942775883
2025-06-19 11:54:08,REAL,2913033128,10323,2913043451,2942786206
2025-06-19 11:54:10,REAL,2913043451,10256,2913053707,2942796462
2025-06-19 11:54:12,REAL,2913053707,10251,2913063958,2942806713
2025-06-19 11:54:14,REAL,2913063958,10316,2913074274,2942817029
2025-06-19 11:54:16,REAL,2913074274,4513,2913078787,2942821542
2025-06-19 11:54:18,REAL,2913078787,485,2913079272,2942822027
2025-06-19 11:54:20,REAL,2913079272,483,2913079755,2942822510
2025-06-19 11:54:22,REAL,2913079755,485,2913080240,2942822995
2025-06-19 11:54:24,FAKE,2913080240,238,2913080478,2942823471
2025-06-19 11:54:26,FAKE,2913080478,238,2913080716,2942823949
2025-06-19 11:54:28,REAL,2913080716,479,2913081195,2942824428
2025-06-19 11:54:30,REAL,2913081195,482,2913081677,2942824910
2025-06-19 11:54:32,FAKE,2913081677,244,2913081921,2942825388
2025-06-19 11:54:34,REAL,2913081921,487,2913082408,2942825875
2025-06-19 11:54:36,FAKE,2913082408,243,2913082651,2942826360
2025-06-19 11:54:38,REAL,2913082651,489,2913083140,2942826849
2025-06-19 11:54:40,REAL,2913083140,481,2913083621,2942827330
2025-06-19 11:54:42,REAL,2913083621,487,2913084108,2942827817
2025-06-19 11:54:44,REAL,2913084108,547,2913084655,2942828364
2025-06-19 11:54:46,FAKE,2913084655,243,2913084898,2942828840
2025-06-19 11:54:48,REAL,2913084898,535,2913085433,2942829375
2025-06-19 11:54:50,REAL,2913085433,488,2913085921,2942829863
2025-06-19 11:54:52,FAKE,2913085921,244,2913086165,2942830345
2025-06-19 11:54:54,REAL,2913086165,8147,2913094312,2942838492
2025-06-19 11:54:56,REAL,2913094312,10646,2913104958,2942849138
2025-06-19 11:54:58,REAL,2913104958,10252,2913115210,2942859390
2025-06-19 11:55:00,REAL,2913115210,10324,2913125534,2942869714
2025-06-19 11:55:02,FAKE,2913125534,238,2913125772,2942879967
2025-06-19 11:55:04,FAKE,2913125772,241,2913126013,2942890217
2025-06-19 11:55:06,FAKE,2913126013,244,2913126257,2942900534
2025-06-19 11:55:08,FAKE,2913126257,243,2913126500,2942909000
2025-06-19 11:55:10,FAKE,2913126500,244,2913126744,2942909485
2025-06-19 11:55:12,FAKE,2913126744,241,2913126985,2942909962
2025-06-19 11:55:14,REAL,2913126985,2733,2913129718,2942912695
2025-06-19 11:55:16,REAL,2913129718,14346,2913144064,2942927041
2025-06-19 11:55:18,FAKE,2913144064,243,2913144307,2942937358
2025-06-19 11:55:20,FAKE,2913144307,238,2913144545,2942947617
2025-06-19 11:55:22,REAL,2913144545,10246,2913154791,2942957863
2025-06-19 11:55:24,REAL,2913154791,10249,2913165040,2942968112
2025-06-19 11:55:26,FAKE,2913165040,238,2913165278,2942978359
2025-06-19 11:55:28,FAKE,2913165278,243,2913165521,2942988734
2025-06-19 11:55:30,REAL,2913165521,3323,2913168844,2942992057
2025-06-19 11:55:32,REAL,2913168844,478,2913169322,2942992535
2025-06-19 11:55:34,REAL,2913169322,481,2913169803,2942993016
2025-06-19 11:55:36,REAL,2913169803,8940,2913178743,2943001956
2025-06-19 11:55:38,FAKE,2913178743,238,2913178981,2943012544
2025-06-19 11:55:40,FAKE,2913178981,243,2913179224,2943022798
2025-06-19 11:55:42,REAL,2913179224,10251,2913189475,2943033049
2025-06-19 11:55:44,FAKE,2913189475,241,2913189716,2943043298
2025-06-19 11:55:46,REAL,2913189716,10253,2913199969,2943053551
2025-06-19 11:55:48,REAL,2913199969,10250,2913210219,2943063801
2025-06-19 11:55:50,REAL,2913210219,7942,2913218161,2943071743
2025-06-19 11:55:52,REAL,2913218161,480,2913218641,2943072223
2025-06-19 11:55:54,FAKE,2913218641,241,2913218882,2943072708
2025-06-19 11:55:56,REAL,2913218882,479,2913219361,2943073187
2025-06-19 11:55:58,REAL,2913219361,485,2913219846,2943073672
2025-06-19 11:56:00,REAL,2913219846,483,2913220329,2943074155
2025-06-19 11:56:02,REAL,2913220329,479,2913220808,2943074634
2025-06-19 11:56:04,REAL,2913220808,488,2913221296,2943075122
2025-06-19 11:56:06,REAL,2913221296,478,2913221774,2943075600
2025-06-19 11:56:08,FAKE,2913221774,241,2913222015,2943076080
2025-06-19 11:56:10,REAL,2913222015,476,2913222491,2943076556
2025-06-19 11:56:12,REAL,2913222491,484,2913222975,2943077040
2025-06-19 11:56:14,FAKE,2913222975,238,2913223213,2943077577
2025-06-19 11:56:16,FAKE,2913223213,241,2913223454,2943078056
2025-06-19 11:56:18,REAL,2913223454,488,2913223942,2943078544
2025-06-19 11:56:20,REAL,2913223942,483,2913224425,2943079027
2025-06-19 11:56:22,REAL,2913224425,537,2913224962,2943079564
2025-06-19 11:56:24,REAL,2913224962,485,2913225447,2943080049
2025-06-19 11:56:26,REAL,2913225447,482,2913225929,2943080531
2025-06-19 11:56:28,REAL,2913225929,490,2913226419,2943081021
2025-06-19 11:56:30,REAL,2913226419,489,2913226908,2943081510
2025-06-19 11:56:32,FAKE,2913226908,243,2913227151,2943081993
2025-06-19 11:56:34,REAL,2913227151,486,2913227637,2943082479
2025-06-19 11:56:36,REAL,2913227637,482,2913228119,2943082961
2025-06-19 11:56:38,FAKE,2913228119,244,2913228363,2943083451
2025-06-19 11:56:40,REAL,2913228363,10582,2913238945,2943094033
2025-06-19 11:56:42,REAL,2913238945,10639,2913249584,2943104672
2025-06-19 11:56:44,FAKE,2913249584,241,2913249825,2943114918
2025-06-19 11:56:46,REAL,2913249825,10321,2913260146,2943125239
2025-06-19 11:56:48,REAL,2913260146,10245,2913270391,2943135484
2025-06-19 11:56:50,FAKE,2913270391,244,2913270635,2943145799
2025-06-19 11:56:52,REAL,2913270635,10255,2913280890,2943156054
2025-06-19 11:56:54,REAL,2913280890,6691,2913287581,2943162745
2025-06-19 11:56:56,REAL,2913287581,483,2913288064,2943163228
2025-06-19 11:56:58,FAKE,2913288064,243,2913288307,2943163717
2025-06-19 11:57:00,REAL,2913288307,488,2913288795,2943164205
2025-06-19 11:57:02,FAKE,2913288795,244,2913289039,2943164740
2025-06-19 11:57:04,REAL,2913289039,484,2913289523,2943165224
2025-06-19 11:57:06,FAKE,2913289523,244,2913289767,2943165708
2025-06-19 11:57:08,FAKE,2913289767,244,2913290011,2943166194
2025-06-19 11:57:10,REAL,2913290011,476,2913290487,2943166670
2025-06-19 11:57:12,REAL,2913290487,486,2913290973,2943167156
2025-06-19 11:57:14,REAL,2913290973,483,2913291456,2943167639
2025-06-19 11:57:16,REAL,2913291456,486,2913291942,2943168125
2025-06-19 11:57:18,REAL,2913291942,480,2913292422,2943168605
2025-06-19 11:57:20,REAL,2913292422,479,2913292901,2943169084
2025-06-19 11:57:22,REAL,2913292901,486,2913293387,2943169570
2025-06-19 11:57:24,FAKE,2913293387,244,2913293631,2943170051
2025-06-19 11:57:26,REAL,2913293631,545,2913294176,2943170596
2025-06-19 11:57:28,FAKE,2913294176,241,2913294417,2943171085
2025-06-19 11:57:30,FAKE,2913294417,244,2913294661,2943171565
2025-06-19 11:57:32,FAKE,2913294661,241,2913294902,2943172049
2025-06-19 11:57:34,FAKE,2913294902,244,2913295146,2943172531
2025-06-19 11:57:36,FAKE,2913295146,238,2913295384,2943173015
2025-06-19 11:57:38,FAKE,2913295384,243,2913295627,2943173495
2025-06-19 11:57:40,REAL,2913295627,483,2913296110,2943173978
2025-06-19 11:57:42,FAKE,2913296110,241,2913296351,2943180149
2025-06-19 11:57:44,FAKE,2913296351,238,2913296589,2943191261
2025-06-19 11:57:46,REAL,2913296589,10314,2913306903,2943201575
2025-06-19 11:57:48,REAL,2913306903,10247,2913317150,2943211822
2025-06-19 11:57:50,FAKE,2913317150,241,2913317391,2943222142
2025-06-19 11:57:52,REAL,2913317391,10309,2913327700,2943232451
2025-06-19 11:57:54,REAL,2913327700,10252,2913337952,2943242703
2025-06-19 11:57:56,REAL,2913337952,10319,2913348271,2943253022
2025-06-19 11:57:58,REAL,2913348271,883,2913349154,2943253905
2025-06-19 11:58:00,REAL,2913349154,489,2913349643,2943254394
2025-06-19 11:58:02,REAL,2913349643,482,2913350125,2943254876
2025-06-19 11:58:04,FAKE,2913350125,244,2913350369,2943255368
2025-06-19 11:58:06,REAL,2913350369,483,2913350852,2943255851
2025-06-19 11:58:08,REAL,2913350852,479,2913351331,2943256330
2025-06-19 11:58:10,REAL,2913351331,487,2913351818,2943256817
2025-06-19 11:58:12,REAL,2913351818,490,2913352308,2943257307
2025-06-19 11:58:14,FAKE,2913352308,238,2913352546,2943263866
2025-06-19 11:58:16,FAKE,2913352546,244,2913352790,2943275446
2025-06-19 11:58:18,FAKE,2913352790,238,2913353028,2943285756
2025-06-19 11:58:20,REAL,2913353028,10252,2913363280,2943296008
2025-06-19 11:58:22,REAL,2913363280,10249,2913373529,2943306257
2025-06-19 11:58:24,REAL,2913373529,10319,2913383848,2943316576
2025-06-19 11:58:26,FAKE,2913383848,243,2913384091,2943326836
2025-06-19 11:58:28,FAKE,2913384091,244,2913384335,2943336892
2025-06-19 11:58:30,REAL,2913384335,476,2913384811,2943337368
2025-06-19 11:58:32,REAL,2913384811,490,2913385301,2943337858
2025-06-19 11:58:34,REAL,2913385301,477,2913385778,2943338335
2025-06-19 11:58:36,REAL,2913385778,484,2913386262,2943338819
2025-06-19 11:58:38,REAL,2913386262,482,2913386744,2943339301
2025-06-19 11:58:40,FAKE,2913386744,238,2913386982,2943339844
2025-06-19 11:58:42,REAL,2913386982,479,2913387461,2943340323
2025-06-19 11:58:44,FAKE,2913387461,241,2913387702,2943340809
2025-06-19 11:58:46,REAL,2913387702,7349,2913395051,2943348158
2025-06-19 11:58:48,REAL,2913395051,11189,2913406240,2943359347
2025-06-19 11:58:50,FAKE,2913406240,243,2913406483,2943369664
2025-06-19 11:58:52,REAL,2913406483,10251,2913416734,2943379915
2025-06-19 11:58:54,REAL,2913416734,10257,2913426991,2943390172
2025-06-19 11:58:56,REAL,2913426991,10251,2913437242,2943400423
2025-06-19 11:58:58,REAL,2913437242,10320,2913447562,2943410743
2025-06-19 11:59:00,REAL,2913447562,9400,2913456962,2943420143
2025-06-19 11:59:02,REAL,2913456962,493,2913457455,2943420636
2025-06-19 11:59:04,REAL,2913457455,479,2913457934,2943421115
2025-06-19 11:59:06,REAL,2913457934,1886,2913459820,2943423001
2025-06-19 11:59:08,REAL,2913459820,11238,2913471058,2943434239
2025-06-19 11:59:10,FAKE,2913471058,243,2913471301,2943444493
2025-06-19 11:59:12,REAL,2913471301,10252,2913481553,2943454745
2025-06-19 11:59:14,REAL,2913481553,10322,2913491875,2943465067
2025-06-19 11:59:16,REAL,2913491875,10249,2913502124,2943475316
2025-06-19 11:59:18,REAL,2913502124,10314,2913512438,2943485630
2025-06-19 11:59:20,REAL,2913512438,10245,2913522683,2943495875
2025-06-19 11:59:22,FAKE,2913522683,243,2913522926,2943499998
2025-06-19 11:59:24,REAL,2913522926,489,2913523415,2943500487
2025-06-19 11:59:26,REAL,2913523415,482,2913523897,2943500969
2025-06-19 11:59:28,REAL,2913523897,488,2913524385,2943501457
2025-06-19 11:59:30,FAKE,2913524385,243,2913524628,2943501998
2025-06-19 11:59:32,REAL,2913524628,482,2913525110,2943502480
2025-06-19 11:59:34,REAL,2913525110,480,2913525590,2943502960
2025-06-19 11:59:36,REAL,2913525590,484,2913526074,2943503444
2025-06-19 11:59:38,REAL,2913526074,2340,2913528414,2943505784
2025-06-19 11:59:40,FAKE,2913528414,243,2913528657,2943520521
2025-06-19 11:59:42,REAL,2913528657,10315,2913538972,2943530836
2025-06-19 11:59:44,FAKE,2913538972,244,2913539216,2943541090
2025-06-19 11:59:46,FAKE,2913539216,244,2913539460,2943551344
2025-06-19 11:59:48,FAKE,2913539460,238,2913539698,2943561666
2025-06-19 11:59:50,FAKE,2913539698,243,2913539941,2943571921
2025-06-19 11:59:52,REAL,2913539941,10251,2913550192,2943582172
2025-06-19 11:59:54,FAKE,2913550192,244,2913550436,2943585691
2025-06-19 11:59:56,REAL,2913550436,477,2913550913,2943586168
2025-06-19 11:59:58,REAL,2913550913,485,2913551398,2943586653
2025-06-19 12:00:00,FAKE,2913551398,241,2913551639,2943595199
2025-06-19 12:00:02,FAKE,2913551639,241,2913551880,2943605905
2025-06-19 12:00:04,REAL,2913551880,10251,2913562131,2943616156
2025-06-19 12:00:06,REAL,2913562131,10249,2913572380,2943626405
2025-06-19 12:00:08,REAL,2913572380,10316,2913582696,2943636721
2025-06-19 12:00:10,REAL,2913582696,10251,2913592947,2943646972
2025-06-19 12:00:12,REAL,2913592947,10325,2913603272,2943657297
2025-06-19 12:00:14,REAL,2913603272,8068,2913611340,2943665365
2025-06-19 12:00:16,REAL,2913611340,486,2913611826,2943665851
2025-06-19 12:00:18,REAL,2913611826,539,2913612365,2943666390
2025-06-19 12:00:20,FAKE,2913612365,244,2913612609,2943666877
2025-06-19 12:00:22,REAL,2913612609,485,2913613094,2943667362
2025-06-19 12:00:24,REAL,2913613094,475,2913613569,2943667837
2025-06-19 12:00:26,REAL,2913613569,482,2913614051,2943668319
2025-06-19 12:00:28,REAL,2913614051,475,2913614526,2943668794
2025-06-19 12:00:30,REAL,2913614526,480,2913615006,2943669274
2025-06-19 12:00:32,REAL,2913615006,491,2913615497,2943669765
2025-06-19 12:00:34,FAKE,2913615497,241,2913615738,2943670251
2025-06-19 12:00:36,REAL,2913615738,484,2913616222,2943670735
2025-06-19 12:00:38,FAKE,2913616222,243,2913616465,2943671272
2025-06-19 12:00:40,FAKE,2913616465,243,2913616708,2943671759
2025-06-19 12:00:42,REAL,2913616708,488,2913617196,2943672247
2025-06-19 12:00:44,FAKE,2913617196,241,2913617437,2943672729
2025-06-19 12:00:46,FAKE,2913617437,244,2913617681,2943673209
2025-06-19 12:00:48,REAL,2913617681,487,2913618168,2943673696
2025-06-19 12:00:50,REAL,2913618168,487,2913618655,2943674183
2025-06-19 12:00:52,REAL,2913618655,4388,2913623043,2943678571
2025-06-19 12:00:54,REAL,2913623043,11106,2913634149,2943689677
2025-06-19 12:00:56,REAL,2913634149,10319,2913644468,2943699996
2025-06-19 12:00:58,REAL,2913644468,10254,2913654722,2943710250
2025-06-19 12:01:00,REAL,2913654722,10317,2913665039,2943720567
2025-06-19 12:01:02,REAL,2913665039,10250,2913675289,2943730817
2025-06-19 12:01:04,REAL,2913675289,10314,2913685603,2943741131
2025-06-19 12:01:06,FAKE,2913685603,244,2913685847,2943751376
2025-06-19 12:01:08,REAL,2913685847,2256,2913688103,2943753632
2025-06-19 12:01:10,FAKE,2913688103,243,2913688346,2943754122
2025-06-19 12:01:12,REAL,2913688346,483,2913688829,2943754605
2025-06-19 12:01:14,REAL,2913688829,493,2913689322,2943755098
2025-06-19 12:01:16,REAL,2913689322,482,2913689804,2943755580
2025-06-19 12:01:18,REAL,2913689804,483,2913690287,2943756063
2025-06-19 12:01:20,FAKE,2913690287,243,2913690530,2943756542
2025-06-19 12:01:22,FAKE,2913690530,241,2913690771,2943757021
2025-06-19 12:01:24,REAL,2913690771,4984,2913695755,2943762005
2025-06-19 12:01:26,REAL,2913695755,11388,2913707143,2943773393
2025-06-19 12:01:28,REAL,2913707143,10256,2913717399,2943783649
2025-06-19 12:01:30,REAL,2913717399,10253,2913727652,2943793902
2025-06-19 12:01:32,FAKE,2913727652,243,2913727895,2943804155
2025-06-19 12:01:34,FAKE,2913727895,238,2913728133,2943814405
2025-06-19 12:01:36,REAL,2913728133,10256,2913738389,2943824661
2025-06-19 12:01:38,REAL,2913738389,10256,2913748645,2943834917
2025-06-19 12:01:40,REAL,2913748645,1542,2913750187,2943836459
2025-06-19 12:01:42,REAL,2913750187,479,2913750666,2943836938
2025-06-19 12:01:44,REAL,2913750666,487,2913751153,2943837425
2025-06-19 12:01:46,REAL,2913751153,480,2913751633,2943837905
2025-06-19 12:01:48,REAL,2913751633,490,2913752123,2943838395
2025-06-19 12:01:50,REAL,2913752123,477,2913752600,2943838872
2025-06-19 12:01:52,FAKE,2913752600,241,2913752841,2943839362
2025-06-19 12:01:54,REAL,2913752841,483,2913753324,2943839845
2025-06-19 12:01:56,REAL,2913753324,5440,2913758764,2943845285
2025-06-19 12:01:58,FAKE,2913758764,241,2913759005,2943856587
2025-06-19 12:02:00,FAKE,2913759005,238,2913759243,2943866903
2025-06-19 12:02:02,FAKE,2913759243,241,2913759484,2943877155
2025-06-19 12:02:04,REAL,2913759484,10249,2913769733,2943887404
2025-06-19 12:02:06,REAL,2913769733,10311,2913780044,2943897715
2025-06-19 12:02:08,FAKE,2913780044,241,2913780285,2943907957
2025-06-19 12:02:10,REAL,2913780285,10320,2913790605,2943918277
2025-06-19 12:02:12,REAL,2913790605,879,2913791484,2943919156
2025-06-19 12:02:14,FAKE,2913791484,244,2913791728,2943919645
2025-06-19 12:02:16,REAL,2913791728,478,2913792206,2943920123
2025-06-19 12:02:18,REAL,2913792206,11665,2913803871,2943931788
2025-06-19 12:02:20,REAL,2913803871,10320,2913814191,2943942108
2025-06-19 12:02:22,REAL,2913814191,10255,2913824446,2943952363
2025-06-19 12:02:24,REAL,2913824446,10255,2913834701,2943962618
2025-06-19 12:02:26,REAL,2913834701,10243,2913844944,2943972861
2025-06-19 12:02:28,REAL,2913844944,10252,2913855196,2943983113
2025-06-19 12:02:30,FAKE,2913855196,244,2913855440,2943993435
2025-06-19 12:02:32,FAKE,2913855440,238,2913855678,2943998873
2025-06-19 12:02:34,REAL,2913855678,475,2913856153,2943999348
2025-06-19 12:02:36,FAKE,2913856153,243,2913856396,2943999889
2025-06-19 12:02:38,REAL,2913856396,489,2913856885,2944000378
2025-06-19 12:02:40,FAKE,2913856885,243,2913857128,2944000856
2025-06-19 12:02:42,FAKE,2913857128,241,2913857369,2944001335
2025-06-19 12:02:44,REAL,2913857369,480,2913857849,2944001815
2025-06-19 12:02:46,FAKE,2913857849,243,2913858092,2944002305
2025-06-19 12:02:48,REAL,2913858092,482,2913858574,2944002787
2025-06-19 12:02:50,REAL,2913858574,487,2913859061,2944003274
2025-06-19 12:02:52,REAL,2913859061,475,2913859536,2944003749
2025-06-19 12:02:54,FAKE,2913859536,238,2913859774,2944004236
2025-06-19 12:02:56,REAL,2913859774,533,2913860307,2944004769
2025-06-19 12:02:58,REAL,2913860307,486,2913860793,2944005255
2025-06-19 12:03:00,FAKE,2913860793,238,2913861031,2944005741
2025-06-19 12:03:02,FAKE,2913861031,243,2913861274,2944006230
2025-06-19 12:03:04,FAKE,2913861274,241,2913861515,2944006723
2025-06-19 12:03:06,REAL,2913861515,486,2913862001,2944007209
2025-06-19 12:03:08,FAKE,2913862001,243,2913862244,2944007693
2025-06-19 12:03:10,REAL,2913862244,483,2913862727,2944008176
2025-06-19 12:03:12,REAL,2913862727,481,2913863208,2944008657
2025-06-19 12:03:14,REAL,2913863208,534,2913863742,2944009191
2025-06-19 12:03:16,FAKE,2913863742,244,2913863986,2944009679
2025-06-19 12:03:18,REAL,2913863986,488,2913864474,2944010167
2025-06-19 12:03:20,FAKE,2913864474,243,2913864717,2944010643
2025-06-19 12:03:22,REAL,2913864717,485,2913865202,2944011128
2025-06-19 12:03:24,REAL,2913865202,480,2913865682,2944011608
2025-06-19 12:03:26,REAL,2913865682,482,2913866164,2944012090
2025-06-19 12:03:28,FAKE,2913866164,241,2913866405,2944012570
2025-06-19 12:03:30,REAL,2913866405,489,2913866894,2944013059
2025-06-19 12:03:32,FAKE,2913866894,241,2913867135,2944013540
2025-06-19 12:03:34,REAL,2913867135,546,2913867681,2944014086
2025-06-19 12:03:36,REAL,2913867681,490,2913868171,2944014576
2025-06-19 12:03:38,REAL,2913868171,487,2913868658,2944015063
2025-06-19 12:03:40,REAL,2913868658,488,2913869146,2944015551
2025-06-19 12:03:42,FAKE,2913869146,241,2913869387,2944016033
2025-06-19 12:03:44,REAL,2913869387,492,2913869879,2944016525
2025-06-19 12:03:46,REAL,2913869879,480,2913870359,2944017005
2025-06-19 12:03:48,FAKE,2913870359,241,2913870600,2944017493
2025-06-19 12:03:50,REAL,2913870600,482,2913871082,2944017975
2025-06-19 12:03:52,REAL,2913871082,478,2913871560,2944018453
2025-06-19 12:03:54,REAL,2913871560,534,2913872094,2944018987
2025-06-19 12:03:56,FAKE,2913872094,244,2913872338,2944019478
2025-06-19 12:03:58,REAL,2913872338,479,2913872817,2944019957
2025-06-19 12:04:00,FAKE,2913872817,238,2913873055,2944020439
2025-06-19 12:04:02,REAL,2913873055,482,2913873537,2944020921
2025-06-19 12:04:04,REAL,2913873537,486,2913874023,2944021407
2025-06-19 12:04:06,REAL,2913874023,492,2913874515,2944021899
2025-06-19 12:04:08,FAKE,2913874515,241,2913874756,2944022374
2025-06-19 12:04:10,FAKE,2913874756,241,2913874997,2944022852
2025-06-19 12:04:12,REAL,2913874997,485,2913875482,2944023337
2025-06-19 12:04:14,REAL,2913875482,9281,2913884763,2944032618
2025-06-19 12:04:16,FAKE,2913884763,244,2913885007,2944043198
2025-06-19 12:04:18,REAL,2913885007,10253,2913895260,2944053451
2025-06-19 12:04:20,REAL,2913895260,10252,2913905512,2944063703
2025-06-19 12:04:22,FAKE,2913905512,243,2913905755,2944073955
2025-06-19 12:04:24,FAKE,2913905755,244,2913905999,2944084213
2025-06-19 12:04:26,REAL,2913905999,10259,2913916258,2944094472
2025-06-19 12:04:28,REAL,2913916258,8199,2913924457,2944102671
2025-06-19 12:04:30,REAL,2913924457,482,2913924939,2944103153
2025-06-19 12:04:32,FAKE,2913924939,238,2913925177,2944103696
2025-06-19 12:04:34,FAKE,2913925177,238,2913925415,2944107154
2025-06-19 12:04:36,FAKE,2913925415,241,2913925656,2944121839
2025-06-19 12:04:38,FAKE,2913925656,241,2913925897,2944132098
2025-06-19 12:04:40,REAL,2913925897,10319,2913936216,2944142417
2025-06-19 12:04:42,REAL,2913936216,10255,2913946471,2944152672
2025-06-19 12:04:44,FAKE,2913946471,244,2913946715,2944162926
2025-06-19 12:04:46,REAL,2913946715,10252,2913956967,2944173178
2025-06-19 12:04:48,REAL,2913956967,10321,2913967288,2944183499
2025-06-19 12:04:50,REAL,2913967288,2927,2913970215,2944186426
2025-06-19 12:04:52,FAKE,2913970215,243,2913970458,2944186912
2025-06-19 12:04:54,FAKE,2913970458,243,2913970701,2944187398
2025-06-19 12:04:56,REAL,2913970701,487,2913971188,2944187885
2025-06-19 12:04:58,REAL,2913971188,488,2913971676,2944188373
2025-06-19 12:05:00,FAKE,2913971676,241,2913971917,2944188858
2025-06-19 12:05:02,FAKE,2913971917,243,2913972160,2944189343
2025-06-19 12:05:04,FAKE,2913972160,238,2913972398,2944189822
2025-06-19 12:05:06,REAL,2913972398,4121,2913976519,2944193943
2025-06-19 12:05:08,FAKE,2913976519,243,2913976762,2944205580
2025-06-19 12:05:10,REAL,2913976762,10312,2913987074,2944215892
2025-06-19 12:05:12,REAL,2913987074,10303,2913997377,2944226195
2025-06-19 12:05:14,REAL,2913997377,10320,2914007697,2944236515
2025-06-19 12:05:16,FAKE,2914007697,238,2914007935,2944246768
2025-06-19 12:05:18,REAL,2914007935,10314,2914018249,2944257082
2025-06-19 12:05:20,REAL,2914018249,11236,2914029485,2944268318
2025-06-19 12:05:22,REAL,2914029485,1282,2914030767,2944269600
2025-06-19 12:05:24,FAKE,2914030767,241,2914031008,2944270086
2025-06-19 12:05:26,REAL,2914031008,485,2914031493,2944270571
2025-06-19 12:05:28,FAKE,2914031493,243,2914031736,2944271055
2025-06-19 12:05:30,REAL,2914031736,479,2914032215,2944271534
2025-06-19 12:05:32,FAKE,2914032215,243,2914032458,2944272022
2025-06-19 12:05:34,REAL,2914032458,486,2914032944,2944272508
2025-06-19 12:05:36,FAKE,2914032944,244,2914033188,2944272995
2025-06-19 12:05:38,REAL,2914033188,485,2914033673,2944273480
2025-06-19 12:05:40,REAL,2914033673,486,2914034159,2944273966
2025-06-19 12:05:42,FAKE,2914034159,244,2914034403,2944274450
2025-06-19 12:05:44,FAKE,2914034403,243,2914034646,2944274930
2025-06-19 12:05:46,REAL,2914034646,479,2914035125,2944275409
2025-06-19 12:05:48,FAKE,2914035125,243,2914035368,2944275895
2025-06-19 12:05:50,REAL,2914035368,483,2914035851,2944276378
2025-06-19 12:05:52,FAKE,2914035851,241,2914036092,2944276916
2025-06-19 12:05:54,FAKE,2914036092,243,2914036335,2944277407
2025-06-19 12:05:56,FAKE,2914036335,241,2914036576,2944277887
2025-06-19 12:05:58,REAL,2914036576,535,2914037111,2944278422
2025-06-19 12:06:00,REAL,2914037111,486,2914037597,2944278908
2025-06-19 12:06:02,FAKE,2914037597,244,2914037841,2944279395
2025-06-19 12:06:04,REAL,2914037841,481,2914038322,2944279876
2025-06-19 12:06:06,REAL,2914038322,482,2914038804,2944280358
2025-06-19 12:06:08,REAL,2914038804,484,2914039288,2944280842
2025-06-19 12:06:10,FAKE,2914039288,244,2914039532,2944281322
2025-06-19 12:06:12,FAKE,2914039532,244,2914039776,2944281808
2025-06-19 12:06:14,FAKE,2914039776,241,2914040017,2944282287
2025-06-19 12:06:16,REAL,2914040017,482,2914040499,2944282769
2025-06-19 12:06:18,REAL,2914040499,476,2914040975,2944283245
2025-06-19 12:06:20,REAL,2914040975,488,2914041463,2944283733
2025-06-19 12:06:22,REAL,2914041463,479,2914041942,2944284212
2025-06-19 12:06:24,FAKE,2914041942,238,2914042180,2944284698
2025-06-19 12:06:26,REAL,2914042180,6054,2914048234,2944290752
2025-06-19 12:06:28,FAKE,2914048234,238,2914048472,2944302123
2025-06-19 12:06:30,FAKE,2914048472,243,2914048715,2944312365
2025-06-19 12:06:32,REAL,2914048715,10254,2914058969,2944322619
2025-06-19 12:06:34,REAL,2914058969,10316,2914069285,2944332935
2025-06-19 12:06:36,REAL,2914069285,10248,2914079533,2944343183
2025-06-19 12:06:38,REAL,2914079533,10254,2914089787,2944353437
2025-06-19 12:06:40,REAL,2914089787,10365,2914100152,2944363802
2025-06-19 12:06:42,FAKE,2914100152,238,2914100390,2944364481
2025-06-19 12:06:44,REAL,2914100390,483,2914100873,2944364964
2025-06-19 12:06:46,REAL,2914100873,491,2914101364,2944365455
2025-06-19 12:06:48,REAL,2914101364,490,2914101854,2944365945
2025-06-19 12:06:50,FAKE,2914101854,244,2914102098,2944366428
2025-06-19 12:06:52,REAL,2914102098,478,2914102576,2944366906
2025-06-19 12:06:54,FAKE,2914102576,238,2914102814,2944367391
2025-06-19 12:06:56,REAL,2914102814,486,2914103300,2944367877
2025-06-19 12:06:58,FAKE,2914103300,244,2914103544,2944368363
2025-06-19 12:07:00,REAL,2914103544,485,2914104029,2944368848
2025-06-19 12:07:02,FAKE,2914104029,238,2914104267,2944369330
2025-06-19 12:07:04,FAKE,2914104267,243,2914104510,2944369811
2025-06-19 12:07:06,FAKE,2914104510,243,2914104753,2944370294
2025-06-19 12:07:08,REAL,2914104753,492,2914105245,2944370786
2025-06-19 12:07:10,REAL,2914105245,481,2914105726,2944371267
2025-06-19 12:07:12,REAL,2914105726,485,2914106211,2944371752
2025-06-19 12:07:14,REAL,2914106211,490,2914106701,2944372242
2025-06-19 12:07:16,FAKE,2914106701,241,2914106942,2944372783
2025-06-19 12:07:18,REAL,2914106942,482,2914107424,2944373265
2025-06-19 12:07:20,REAL,2914107424,482,2914107906,2944373747
2025-06-19 12:07:22,FAKE,2914107906,243,2914108149,2944374230
2025-06-19 12:07:24,REAL,2914108149,485,2914108634,2944374715
2025-06-19 12:07:26,FAKE,2914108634,241,2914108875,2944375189
2025-06-19 12:07:28,REAL,2914108875,490,2914109365,2944375679
2025-06-19 12:07:30,REAL,2914109365,481,2914109846,2944376160
2025-06-19 12:07:32,REAL,2914109846,540,2914110386,2944376700
2025-06-19 12:07:34,REAL,2914110386,1741,2914112127,2944378441
2025-06-19 12:07:36,FAKE,2914112127,238,2914112365,2944392384
2025-06-19 12:07:38,REAL,2914112365,10314,2914122679,2944402698
2025-06-19 12:07:40,FAKE,2914122679,238,2914122917,2944412952
2025-06-19 12:07:42,REAL,2914122917,10258,2914133175,2944423210
2025-06-19 12:07:44,REAL,2914133175,10321,2914143496,2944433531
2025-06-19 12:07:46,REAL,2914143496,10244,2914153740,2944443775
2025-06-19 12:07:48,REAL,2914153740,10317,2914164057,2944454092
2025-06-19 12:07:50,FAKE,2914164057,241,2914164298,2944458403
2025-06-19 12:07:52,FAKE,2914164298,238,2914164536,2944458886
2025-06-19 12:07:54,REAL,2914164536,492,2914165028,2944459378
2025-06-19 12:07:56,FAKE,2914165028,238,2914165266,2944468718
2025-06-19 12:07:58,REAL,2914165266,12306,2914177572,2944481024
2025-06-19 12:08:00,REAL,2914177572,10252,2914187824,2944491276
2025-06-19 12:08:02,REAL,2914187824,10261,2914198085,2944501537
2025-06-19 12:08:04,REAL,2914198085,10243,2914208328,2944511780
2025-06-19 12:08:06,REAL,2914208328,10247,2914218575,2944522027
2025-06-19 12:08:08,REAL,2914218575,10315,2914228890,2944532342
2025-06-19 12:08:10,REAL,2914228890,8805,2914237695,2944541147
2025-06-19 12:08:12,REAL,2914237695,489,2914238184,2944541636
2025-06-19 12:08:14,REAL,2914238184,483,2914238667,2944542119
2025-06-19 12:08:16,REAL,2914238667,491,2914239158,2944542610
2025-06-19 12:08:18,REAL,2914239158,480,2914239638,2944543090
2025-06-19 12:08:20,FAKE,2914239638,241,2914239879,2944543579
2025-06-19 12:08:22,REAL,2914239879,546,2914240425,2944544125
2025-06-19 12:08:24,REAL,2914240425,488,2914240913,2944544613
2025-06-19 12:08:26,FAKE,2914240913,241,2914241154,2944545095
2025-06-19 12:08:28,REAL,2914241154,10260,2914251414,2944555355
2025-06-19 12:08:30,REAL,2914251414,12095,2914263509,2944567450
2025-06-19 12:08:32,REAL,2914263509,10312,2914273821,2944577762
2025-06-19 12:08:34,REAL,2914273821,10247,2914284068,2944588009
2025-06-19 12:08:36,FAKE,2914284068,244,2914284312,2944598267
2025-06-19 12:08:38,REAL,2914284312,10251,2914294563,2944608518
2025-06-19 12:08:40,FAKE,2914294563,243,2914294806,2944618835
2025-06-19 12:08:42,FAKE,2914294806,244,2914295050,2944627038
2025-06-19 12:08:44,FAKE,2914295050,241,2914295291,2944627527
2025-06-19 12:08:46,REAL,2914295291,485,2914295776,2944628012
2025-06-19 12:08:48,FAKE,2914295776,244,2914296020,2944628255
2025-06-19 12:08:50,REAL,2914296020,493,2914296513,2944628748
2025-06-19 12:08:52,REAL,2914296513,487,2914297000,2944629235
2025-06-19 12:08:54,FAKE,2914297000,241,2914297241,2944629714
2025-06-19 12:08:56,REAL,2914297241,482,2914297723,2944630196
2025-06-19 12:08:58,REAL,2914297723,484,2914298207,2944630680
2025-06-19 12:09:00,FAKE,2914298207,238,2914298445,2944631159
2025-06-19 12:09:02,REAL,2914298445,490,2914298935,2944631649
2025-06-19 12:09:04,REAL,2914298935,3536,2914302471,2944635185
2025-06-19 12:09:06,FAKE,2914302471,238,2914302709,2944646516
2025-06-19 12:09:08,FAKE,2914302709,243,2914302952,2944656766
2025-06-19 12:09:10,REAL,2914302952,10317,2914313269,2944667083
2025-06-19 12:09:12,REAL,2914313269,10258,2914323527,2944677341
2025-06-19 12:09:14,REAL,2914323527,10373,2914333900,2944687714
2025-06-19 12:09:16,FAKE,2914333900,244,2914334144,2944697961
2025-06-19 12:09:18,FAKE,2914334144,241,2914334385,2944708277
2025-06-19 12:09:20,REAL,2914334385,2654,2914337039,2944710931
2025-06-19 12:09:22,FAKE,2914337039,243,2914337282,2944711654
2025-06-19 12:09:24,REAL,2914337282,241,2914337523,2944711895
2025-06-19 12:09:26,REAL,2914337523,487,2914338010,2944712382
2025-06-19 12:09:28,REAL,2914338010,489,2914338499,2944712871
2025-06-19 12:09:30,FAKE,2914338499,238,2914338737,2944713362
2025-06-19 12:09:32,REAL,2914338737,544,2914339281,2944713906
2025-06-19 12:09:34,REAL,2914339281,474,2914339755,2944714380
2025-06-19 12:09:36,REAL,2914339755,479,2914340234,2944714859
2025-06-19 12:09:38,REAL,2914340234,475,2914340709,2944715334
2025-06-19 12:09:40,REAL,2914340709,481,2914341190,2944715815
2025-06-19 12:09:42,FAKE,2914341190,243,2914341433,2944716300
2025-06-19 12:09:44,REAL,2914341433,489,2914341922,2944716789
2025-06-19 12:09:46,REAL,2914341922,488,2914342410,2944717277
2025-06-19 12:09:48,FAKE,2914342410,244,2914342654,2944717770
2025-06-19 12:09:50,FAKE,2914342654,241,2914342895,2944718256
2025-06-19 12:09:52,REAL,2914342895,489,2914343384,2944718745
2025-06-19 12:09:54,REAL,2914343384,486,2914343870,2944719231
2025-06-19 12:09:56,REAL,2914343870,484,2914344354,2944719715
2025-06-19 12:09:58,REAL,2914344354,545,2914344899,2944720260
2025-06-19 12:10:00,REAL,2914344899,487,2914345386,2944720747
2025-06-19 12:10:02,FAKE,2914345386,244,2914345630,2944721232
2025-06-19 12:10:04,REAL,2914345630,492,2914346122,2944721724
2025-06-19 12:10:06,FAKE,2914346122,238,2914346360,2944722264
2025-06-19 12:10:08,FAKE,2914346360,241,2914346601,2944722754
2025-06-19 12:10:10,FAKE,2914346601,238,2914346839,2944723236
2025-06-19 12:10:12,FAKE,2914346839,241,2914347080,2944723724
2025-06-19 12:10:14,REAL,2914347080,476,2914347556,2944724200
2025-06-19 12:10:16,FAKE,2914347556,241,2914347797,2944724684
2025-06-19 12:10:18,FAKE,2914347797,238,2914348035,2944725167
2025-06-19 12:10:20,FAKE,2914348035,244,2914348279,2944725645
2025-06-19 12:10:22,REAL,2914348279,484,2914348763,2944726129
2025-06-19 12:10:24,REAL,2914348763,480,2914349243,2944726609
2025-06-19 12:10:26,REAL,2914349243,542,2914349785,2944727151
2025-06-19 12:10:28,REAL,2914349785,476,2914350261,2944727627
2025-06-19 12:10:30,REAL,2914350261,480,2914350741,2944728107
2025-06-19 12:10:32,REAL,2914350741,485,2914351226,2944728592
2025-06-19 12:10:34,REAL,2914351226,488,2914351714,2944729080
2025-06-19 12:10:36,REAL,2914351714,489,2914352203,2944729569
2025-06-19 12:10:38,FAKE,2914352203,238,2914352441,2944730058
2025-06-19 12:10:40,REAL,2914352441,489,2914352930,2944730547
2025-06-19 12:10:42,REAL,2914352930,477,2914353407,2944731024
2025-06-19 12:10:44,REAL,2914353407,477,2914353884,2944731501
2025-06-19 12:10:46,FAKE,2914353884,241,2914354125,2944731991
2025-06-19 12:10:48,FAKE,2914354125,244,2914354369,2944732473
2025-06-19 12:10:50,FAKE,2914354369,243,2914354612,2944732953
2025-06-19 12:10:52,REAL,2914354612,475,2914355087,2944733428
2025-06-19 12:10:54,REAL,2914355087,541,2914355628,2944733969
2025-06-19 12:10:56,FAKE,2914355628,244,2914355872,2944734510
2025-06-19 12:10:58,REAL,2914355872,483,2914356355,2944734993
2025-06-19 12:11:00,FAKE,2914356355,244,2914356599,2944735473
2025-06-19 12:11:02,FAKE,2914356599,241,2914356840,2944735954
2025-06-19 12:11:04,REAL,2914356840,482,2914357322,2944736436
2025-06-19 12:11:06,REAL,2914357322,483,2914357805,2944736919
2025-06-19 12:11:08,REAL,2914357805,484,2914358289,2944737403
2025-06-19 12:11:10,REAL,2914358289,492,2914358781,2944737895
2025-06-19 12:11:12,FAKE,2914358781,238,2914359019,2944738379
2025-06-19 12:11:14,REAL,2914359019,488,2914359507,2944738867
2025-06-19 12:11:16,REAL,2914359507,482,2914359989,2944739349
2025-06-19 12:11:18,FAKE,2914359989,241,2914360230,2944739833
2025-06-19 12:11:20,REAL,2914360230,540,2914360770,2944740373
2025-06-19 12:11:22,REAL,2914360770,484,2914361254,2944740857
2025-06-19 12:11:24,FAKE,2914361254,241,2914361495,2944741343
2025-06-19 12:11:26,REAL,2914361495,483,2914361978,2944741826
2025-06-19 12:11:28,REAL,2914361978,14615,2914376593,2944756441
2025-06-19 12:11:30,REAL,2914376593,10317,2914386910,2944766758
2025-06-19 12:11:32,REAL,2914386910,10255,2914397165,2944777013
2025-06-19 12:11:34,REAL,2914397165,10252,2914407417,2944787265
2025-06-19 12:11:36,REAL,2914407417,10320,2914417737,2944797585
2025-06-19 12:11:38,REAL,2914417737,10250,2914427987,2944807835
2025-06-19 12:11:40,REAL,2914427987,10253,2914438240,2944818088
2025-06-19 12:11:42,REAL,2914438240,5041,2914443281,2944823129
2025-06-19 12:11:44,REAL,2914443281,485,2914443766,2944823614
2025-06-19 12:11:46,REAL,2914443766,483,2914444249,2944824097
2025-06-19 12:11:48,REAL,2914444249,544,2914444793,2944824641
2025-06-19 12:11:50,REAL,2914444793,484,2914445277,2944825125
2025-06-19 12:11:52,REAL,2914445277,481,2914445758,2944825606
2025-06-19 12:11:54,REAL,2914445758,540,2914446298,2944826146
2025-06-19 12:11:56,REAL,2914446298,479,2914446777,2944826625
2025-06-19 12:11:58,REAL,2914446777,477,2914447254,2944827102
2025-06-19 12:12:00,REAL,2914447254,479,2914447733,2944827581
2025-06-19 12:12:02,REAL,2914447733,482,2914448215,2944828063
2025-06-19 12:12:04,FAKE,2914448215,241,2914448456,2944828548
2025-06-19 12:12:06,REAL,2914448456,488,2914448944,2944829036
2025-06-19 12:12:08,REAL,2914448944,1347,2914450291,2944830383
2025-06-19 12:12:10,REAL,2914450291,14809,2914465100,2944845192
2025-06-19 12:12:12,REAL,2914465100,10259,2914475359,2944855451
2025-06-19 12:12:14,REAL,2914475359,10321,2914485680,2944865772
2025-06-19 12:12:16,REAL,2914485680,10248,2914495928,2944876020
2025-06-19 12:12:18,REAL,2914495928,10253,2914506181,2944886273
2025-06-19 12:12:20,REAL,2914506181,10318,2914516499,2944896591
2025-06-19 12:12:22,REAL,2914516499,10254,2914526753,2944906845
2025-06-19 12:12:24,FAKE,2914526753,243,2914526996,2944911429
2025-06-19 12:12:26,REAL,2914526996,480,2914527476,2944911909
2025-06-19 12:12:28,REAL,2914527476,539,2914528015,2944912448
2025-06-19 12:12:30,REAL,2914528015,487,2914528502,2944912935
2025-06-19 12:12:32,FAKE,2914528502,241,2914528743,2944913412
2025-06-19 12:12:34,REAL,2914528743,484,2914529227,2944913896
2025-06-19 12:12:36,FAKE,2914529227,244,2914529471,2944914433
2025-06-19 12:12:38,FAKE,2914529471,238,2914529709,2944914913
2025-06-19 12:12:40,REAL,2914529709,7818,2914537527,2944922731
2025-06-19 12:12:42,REAL,2914537527,11179,2914548706,2944933910
2025-06-19 12:12:44,REAL,2914548706,10247,2914558953,2944944157
2025-06-19 12:12:46,REAL,2914558953,10247,2914569200,2944954404
2025-06-19 12:12:48,REAL,2914569200,10251,2914579451,2944964655
2025-06-19 12:12:50,REAL,2914579451,10247,2914589698,2944974902
2025-06-19 12:12:52,REAL,2914589698,10310,2914600008,2944985212
2025-06-19 12:12:54,FAKE,2914600008,244,2914600252,2944994338
2025-06-19 12:12:56,FAKE,2914600252,238,2914600490,2944994817
2025-06-19 12:12:58,REAL,2914600490,485,2914600975,2944995302
2025-06-19 12:13:00,FAKE,2914600975,243,2914601218,2944995786
2025-06-19 12:13:02,REAL,2914601218,484,2914601702,2944996270
2025-06-19 12:13:04,REAL,2914601702,482,2914602184,2944996752
2025-06-19 12:13:06,REAL,2914602184,538,2914602722,2944997290
2025-06-19 12:13:08,FAKE,2914602722,241,2914602963,2944997773
2025-06-19 12:13:10,FAKE,2914602963,244,2914603207,2944998315
2025-06-19 12:13:12,FAKE,2914603207,238,2914603445,2945006400
2025-06-19 12:13:14,REAL,2914603445,10653,2914614098,2945017053
2025-06-19 12:13:16,REAL,2914614098,10324,2914624422,2945027377
2025-06-19 12:13:18,FAKE,2914624422,243,2914624665,2945037628
2025-06-19 12:13:20,REAL,2914624665,10328,2914634993,2945047956
2025-06-19 12:13:22,FAKE,2914634993,238,2914635231,2945058202
2025-06-19 12:13:24,REAL,2914635231,10315,2914645546,2945068517
2025-06-19 12:13:26,REAL,2914645546,8535,2914654081,2945077052
2025-06-19 12:13:28,FAKE,2914654081,241,2914654322,2945077536
2025-06-19 12:13:30,FAKE,2914654322,243,2914654565,2945078029
2025-06-19 12:13:32,REAL,2914654565,489,2914655054,2945078518
2025-06-19 12:13:34,REAL,2914655054,482,2914655536,2945079000
2025-06-19 12:13:36,REAL,2914655536,484,2914656020,2945079484
2025-06-19 12:13:38,REAL,2914656020,536,2914656556,2945080020
2025-06-19 12:13:40,REAL,2914656556,483,2914657039,2945080503
2025-06-19 12:13:42,REAL,2914657039,485,2914657524,2945080988
2025-06-19 12:13:44,REAL,2914657524,491,2914658015,2945081479
2025-06-19 12:13:46,REAL,2914658015,486,2914658501,2945081965
2025-06-19 12:13:48,REAL,2914658501,481,2914658982,2945082446
2025-06-19 12:13:50,REAL,2914658982,535,2914659517,2945082981
2025-06-19 12:13:52,REAL,2914659517,476,2914659993,2945083457
2025-06-19 12:13:54,REAL,2914659993,486,2914660479,2945083943
2025-06-19 12:13:56,REAL,2914660479,485,2914660964,2945084428
2025-06-19 12:13:58,REAL,2914660964,485,2914661449,2945084913
2025-06-19 12:14:00,FAKE,2914661449,241,2914661690,2945085396
2025-06-19 12:14:02,REAL,2914661690,480,2914662170,2945085876
2025-06-19 12:14:04,REAL,2914662170,484,2914662654,2945086360
2025-06-19 12:14:06,REAL,2914662654,486,2914663140,2945086846
2025-06-19 12:14:08,FAKE,2914663140,244,2914663384,2945087334
2025-06-19 12:14:10,FAKE,2914663384,241,2914663625,2945087819
2025-06-19 12:14:12,REAL,2914663625,486,2914664111,2945088305
2025-06-19 12:14:14,REAL,2914664111,479,2914664590,2945088784
2025-06-19 12:14:16,REAL,2914664590,491,2914665081,2945089275
2025-06-19 12:14:18,REAL,2914665081,490,2914665571,2945089765
2025-06-19 12:14:20,REAL,2914665571,486,2914666057,2945090251
2025-06-19 12:14:22,REAL,2914666057,536,2914666593,2945090787
2025-06-19 12:14:24,FAKE,2914666593,244,2914666837,2945091273
2025-06-19 12:14:26,FAKE,2914666837,238,2914667075,2945091763
2025-06-19 12:14:28,REAL,2914667075,478,2914667553,2945092241
2025-06-19 12:14:30,REAL,2914667553,546,2914668099,2945092787
2025-06-19 12:14:32,FAKE,2914668099,241,2914668340,2945093272
2025-06-19 12:14:34,REAL,2914668340,482,2914668822,2945093754
2025-06-19 12:14:36,FAKE,2914668822,244,2914669066,2945094238
2025-06-19 12:14:38,REAL,2914669066,490,2914669556,2945094728
2025-06-19 12:14:40,FAKE,2914669556,243,2914669799,2945095218
2025-06-19 12:14:42,REAL,2914669799,481,2914670280,2945095699
2025-06-19 12:14:44,FAKE,2914670280,243,2914670523,2945096185
2025-06-19 12:14:46,REAL,2914670523,491,2914671014,2945096676
2025-06-19 12:14:48,REAL,2914671014,475,2914671489,2945097151
2025-06-19 12:14:50,REAL,2914671489,482,2914671971,2945097633
2025-06-19 12:14:52,FAKE,2914671971,243,2914672214,2945098114
2025-06-19 12:14:54,FAKE,2914672214,244,2914672458,2945098600
2025-06-19 12:14:56,REAL,2914672458,484,2914672942,2945099084
2025-06-19 12:14:58,REAL,2914672942,479,2914673421,2945099563
2025-06-19 12:15:00,REAL,2914673421,485,2914673906,2945100048
2025-06-19 12:15:02,REAL,2914673906,484,2914674390,2945100532
2025-06-19 12:15:04,REAL,2914674390,486,2914674876,2945101018
2025-06-19 12:15:06,REAL,2914674876,534,2914675410,2945101552
2025-06-19 12:15:08,FAKE,2914675410,244,2914675654,2945102030
2025-06-19 12:15:10,REAL,2914675654,474,2914676128,2945102504
2025-06-19 12:15:12,FAKE,2914676128,241,2914676369,2945103046
2025-06-19 12:15:14,REAL,2914676369,10456,2914686825,2945113502
2025-06-19 12:15:16,REAL,2914686825,10383,2914697208,2945123885
2025-06-19 12:15:18,REAL,2914697208,10254,2914707462,2945134139
2025-06-19 12:15:20,REAL,2914707462,10318,2914717780,2945144457
2025-06-19 12:15:22,REAL,2914717780,10258,2914728038,2945154715
2025-06-19 12:15:24,FAKE,2914728038,241,2914728279,2945164977
2025-06-19 12:15:26,REAL,2914728279,10324,2914738603,2945175301
2025-06-19 12:15:28,FAKE,2914738603,241,2914738844,2945181730
2025-06-19 12:15:30,FAKE,2914738844,243,2914739087,2945182220
2025-06-19 12:15:32,REAL,2914739087,484,2914739571,2945182704
2025-06-19 12:15:34,REAL,2914739571,479,2914740050,2945183183
2025-06-19 12:15:36,FAKE,2914740050,241,2914740291,2945183665
2025-06-19 12:15:38,REAL,2914740291,486,2914740777,2945184151
2025-06-19 12:15:40,REAL,2914740777,485,2914741262,2945184636
2025-06-19 12:15:42,REAL,2914741262,485,2914741747,2945185121
2025-06-19 12:15:44,REAL,2914741747,482,2914742229,2945185603
2025-06-19 12:15:46,REAL,2914742229,11445,2914753674,2945197048
2025-06-19 12:15:48,REAL,2914753674,10328,2914764002,2945207376
2025-06-19 12:15:50,REAL,2914764002,10249,2914774251,2945217625
2025-06-19 12:15:52,REAL,2914774251,10299,2914784550,2945227924
2025-06-19 12:15:54,REAL,2914784550,10254,2914794804,2945238178
2025-06-19 12:15:56,REAL,2914794804,10326,2914805130,2945248504
2025-06-19 12:15:58,FAKE,2914805130,241,2914805371,2945258759
2025-06-19 12:16:00,REAL,2914805371,5829,2914811200,2945264588
2025-06-19 12:16:02,REAL,2914811200,476,2914811676,2945265064
2025-06-19 12:16:04,REAL,2914811676,486,2914812162,2945265550
2025-06-19 12:16:06,REAL,2914812162,484,2914812646,2945266034
2025-06-19 12:16:08,FAKE,2914812646,238,2914812884,2945266524
2025-06-19 12:16:10,REAL,2914812884,484,2914813368,2945267008
2025-06-19 12:16:12,REAL,2914813368,489,2914813857,2945267497
2025-06-19 12:16:14,FAKE,2914813857,238,2914814095,2945267973
2025-06-19 12:16:16,REAL,2914814095,476,2914814571,2945268449
2025-06-19 12:16:18,FAKE,2914814571,244,2914814815,2945280303
2025-06-19 12:16:20,REAL,2914814815,10251,2914825066,2945290554
2025-06-19 12:16:22,REAL,2914825066,10320,2914835386,2945300874
2025-06-19 12:16:24,REAL,2914835386,10254,2914845640,2945311128
2025-06-19 12:16:26,REAL,2914845640,10320,2914855960,2945321448
2025-06-19 12:16:28,REAL,2914855960,10260,2914866220,2945331708
2025-06-19 12:16:30,REAL,2914866220,10315,2914876535,2945342023
2025-06-19 12:16:32,FAKE,2914876535,243,2914876778,2945347260
2025-06-19 12:16:34,FAKE,2914876778,244,2914877022,2945347793
2025-06-19 12:16:36,REAL,2914877022,484,2914877506,2945348277
2025-06-19 12:16:38,FAKE,2914877506,243,2914877749,2945348760
2025-06-19 12:16:40,FAKE,2914877749,243,2914877992,2945349244
2025-06-19 12:16:42,FAKE,2914877992,238,2914878230,2945349731
2025-06-19 12:16:44,FAKE,2914878230,244,2914878474,2945350212
2025-06-19 12:16:46,REAL,2914878474,482,2914878956,2945350694
2025-06-19 12:16:48,REAL,2914878956,1288,2914880244,2945351982
2025-06-19 12:16:50,REAL,2914880244,14743,2914894987,2945366725
2025-06-19 12:16:52,REAL,2914894987,10250,2914905237,2945376975
2025-06-19 12:16:54,REAL,2914905237,10317,2914915554,2945387292
2025-06-19 12:16:56,FAKE,2914915554,238,2914915792,2945398012
2025-06-19 12:16:58,REAL,2914915792,9797,2914925589,2945407809
2025-06-19 12:17:00,REAL,2914925589,10321,2914935910,2945418130
2025-06-19 12:17:02,REAL,2914935910,10252,2914946162,2945428382
2025-06-19 12:17:04,REAL,2914946162,4565,2914950727,2945432947
2025-06-19 12:17:06,REAL,2914950727,487,2914951214,2945433434
2025-06-19 12:17:08,REAL,2914951214,483,2914951697,2945433917
2025-06-19 12:17:10,REAL,2914951697,482,2914952179,2945434399
2025-06-19 12:17:12,REAL,2914952179,483,2914952662,2945434882
2025-06-19 12:17:14,REAL,2914952662,485,2914953147,2945435367
2025-06-19 12:17:16,FAKE,2914953147,238,2914953385,2945435852
2025-06-19 12:17:18,FAKE,2914953385,243,2914953628,2945436335
2025-06-19 12:17:20,FAKE,2914953628,243,2914953871,2945438538
2025-06-19 12:17:22,REAL,2914953871,11632,2914965503,2945450170
2025-06-19 12:17:24,REAL,2914965503,10261,2914975764,2945460431
2025-06-19 12:17:26,REAL,2914975764,10255,2914986019,2945470686
2025-06-19 12:17:28,REAL,2914986019,10309,2914996328,2945480995
2025-06-19 12:17:30,FAKE,2914996328,238,2914996566,2945491243
2025-06-19 12:17:32,REAL,2914996566,10317,2915006883,2945501560
2025-06-19 12:17:34,FAKE,2915006883,244,2915007127,2945511820
2025-06-19 12:17:36,FAKE,2915007127,241,2915007368,2945515865
2025-06-19 12:17:38,REAL,2915007368,489,2915007857,2945516354
2025-06-19 12:17:40,REAL,2915007857,479,2915008336,2945516833
2025-06-19 12:17:42,REAL,2915008336,478,2915008814,2945517311
2025-06-19 12:17:44,REAL,2915008814,491,2915009305,2945517802
2025-06-19 12:17:46,REAL,2915009305,481,2915009786,2945518283
2025-06-19 12:17:48,FAKE,2915009786,238,2915010024,2945518761
2025-06-19 12:17:50,REAL,2915010024,479,2915010503,2945519240
2025-06-19 12:17:52,REAL,2915010503,485,2915010988,2945519725
2025-06-19 12:17:54,REAL,2915010988,480,2915011468,2945520205
2025-06-19 12:17:56,REAL,2915011468,493,2915011961,2945520698
2025-06-19 12:17:58,FAKE,2915011961,244,2915012205,2945531026
2025-06-19 12:18:00,REAL,2915012205,11708,2915023913,2945542734
2025-06-19 12:18:02,REAL,2915023913,10321,2915034234,2945553055
2025-06-19 12:18:04,FAKE,2915034234,243,2915034477,2945563367
2025-06-19 12:18:06,REAL,2915034477,10316,2915044793,2945573683
2025-06-19 12:18:08,REAL,2915044793,10260,2915055053,2945583943
2025-06-19 12:18:10,FAKE,2915055053,238,2915055291,2945594266
2025-06-19 12:18:12,REAL,2915055291,8336,2915063627,2945602602
2025-06-19 12:18:14,REAL,2915063627,482,2915064109,2945603084
2025-06-19 12:18:16,REAL,2915064109,491,2915064600,2945603575
2025-06-19 12:18:18,REAL,2915064600,478,2915065078,2945604053
2025-06-19 12:18:20,FAKE,2915065078,241,2915065319,2945604534
2025-06-19 12:18:22,FAKE,2915065319,244,2915065563,2945605025
2025-06-19 12:18:24,FAKE,2915065563,243,2915065806,2945605510
2025-06-19 12:18:26,FAKE,2915065806,238,2915066044,2945605989
2025-06-19 12:18:28,REAL,2915066044,487,2915066531,2945606476
2025-06-19 12:18:30,REAL,2915066531,486,2915067017,2945606962
2025-06-19 12:18:32,REAL,2915067017,485,2915067502,2945607447
2025-06-19 12:18:34,REAL,2915067502,483,2915067985,2945607930
2025-06-19 12:18:36,REAL,2915067985,534,2915068519,2945608464
2025-06-19 12:18:38,REAL,2915068519,485,2915069004,2945608949
2025-06-19 12:18:40,REAL,2915069004,487,2915069491,2945609436
2025-06-19 12:18:42,REAL,2915069491,534,2915070025,2945609970
2025-06-19 12:18:44,REAL,2915070025,481,2915070506,2945610451
2025-06-19 12:18:46,REAL,2915070506,487,2915070993,2945610938
2025-06-19 12:18:48,FAKE,2915070993,238,2915071231,2945611423
2025-06-19 12:18:50,FAKE,2915071231,241,2915071472,2945611904
2025-06-19 12:18:52,REAL,2915071472,485,2915071957,2945612389
2025-06-19 12:18:54,FAKE,2915071957,241,2915072198,2945612874
2025-06-19 12:18:56,REAL,2915072198,9277,2915081475,2945622151
2025-06-19 12:18:58,REAL,2915081475,10643,2915092118,2945632794
2025-06-19 12:19:00,FAKE,2915092118,238,2915092356,2945643109
2025-06-19 12:19:02,REAL,2915092356,10248,2915102604,2945653357
2025-06-19 12:19:04,FAKE,2915102604,238,2915102842,2945663673
2025-06-19 12:19:06,REAL,2915102842,10254,2915113096,2945673927
2025-06-19 12:19:08,REAL,2915113096,10298,2915123394,2945684225
2025-06-19 12:19:10,FAKE,2915123394,241,2915123635,2945691700
2025-06-19 12:19:12,REAL,2915123635,481,2915124116,2945692181
2025-06-19 12:19:14,REAL,2915124116,476,2915124592,2945692657
2025-06-19 12:19:16,REAL,2915124592,484,2915125076,2945693141
2025-06-19 12:19:18,REAL,2915125076,481,2915125557,2945693622
2025-06-19 12:19:20,REAL,2915125557,494,2915126051,2945694116
2025-06-19 12:19:22,FAKE,2915126051,238,2915126289,2945694604
2025-06-19 12:19:24,FAKE,2915126289,243,2915126532,2945695087
2025-06-19 12:19:26,FAKE,2915126532,238,2915126770,2945695571
2025-06-19 12:19:28,REAL,2915126770,10385,2915137155,2945705956
2025-06-19 12:19:30,REAL,2915137155,10512,2915147667,2945716468
2025-06-19 12:19:32,FAKE,2915147667,244,2915147911,2945726719
2025-06-19 12:19:34,FAKE,2915147911,244,2915148155,2945737027
2025-06-19 12:19:36,REAL,2915148155,10258,2915158413,2945747285
2025-06-19 12:19:38,FAKE,2915158413,244,2915158657,2945757590
2025-06-19 12:19:40,FAKE,2915158657,238,2915158895,2945767911
2025-06-19 12:19:42,REAL,2915158895,6749,2915165644,2945774660
2025-06-19 12:19:44,REAL,2915165644,485,2915166129,2945775145
2025-06-19 12:19:46,REAL,2915166129,476,2915166605,2945775621
2025-06-19 12:19:48,FAKE,2915166605,243,2915166848,2945776106
2025-06-19 12:19:50,REAL,2915166848,481,2915167329,2945776587
2025-06-19 12:19:52,FAKE,2915167329,241,2915167570,2945777072
2025-06-19 12:19:54,REAL,2915167570,480,2915168050,2945777552
2025-06-19 12:19:56,REAL,2915168050,483,2915168533,2945778035
2025-06-19 12:19:58,FAKE,2915168533,244,2915168777,2945778520
2025-06-19 12:20:00,REAL,2915168777,14610,2915183387,2945793130
2025-06-19 12:20:02,REAL,2915183387,10377,2915193764,2945803507
2025-06-19 12:20:04,FAKE,2915193764,241,2915194005,2945813825
2025-06-19 12:20:06,FAKE,2915194005,243,2915194248,2945824073
2025-06-19 12:20:08,REAL,2915194248,10316,2915204564,2945834389
2025-06-19 12:20:10,REAL,2915204564,10251,2915214815,2945844640
2025-06-19 12:20:12,REAL,2915214815,10311,2915225126,2945854951
2025-06-19 12:20:14,FAKE,2915225126,244,2915225370,2945861119
2025-06-19 12:20:16,REAL,2915225370,486,2915225856,2945861605
2025-06-19 12:20:18,FAKE,2915225856,244,2915226100,2945862087
2025-06-19 12:20:20,REAL,2915226100,479,2915226579,2945862566
2025-06-19 12:20:22,REAL,2915226579,485,2915227064,2945863051
2025-06-19 12:20:24,REAL,2915227064,481,2915227545,2945863532
2025-06-19 12:20:26,REAL,2915227545,485,2915228030,2945864017
2025-06-19 12:20:28,REAL,2915228030,486,2915228516,2945864503
2025-06-19 12:20:30,FAKE,2915228516,243,2915228759,2945864979
2025-06-19 12:20:32,REAL,2915228759,476,2915229235,2945865455
2025-06-19 12:20:34,REAL,2915229235,490,2915229725,2945865945
2025-06-19 12:20:36,REAL,2915229725,484,2915230209,2945866429
2025-06-19 12:20:38,REAL,2915230209,488,2915230697,2945866917
2025-06-19 12:20:40,FAKE,2915230697,243,2915230940,2945867466
2025-06-19 12:20:42,FAKE,2915230940,243,2915231183,2945867948
2025-06-19 12:20:44,REAL,2915231183,489,2915231672,2945868437
2025-06-19 12:20:46,FAKE,2915231672,241,2915231913,2945868919
2025-06-19 12:20:48,FAKE,2915231913,244,2915232157,2945869461
2025-06-19 12:20:50,REAL,2915232157,486,2915232643,2945869947
2025-06-19 12:20:52,REAL,2915232643,484,2915233127,2945870431
2025-06-19 12:20:54,FAKE,2915233127,244,2915233371,2945870915
2025-06-19 12:20:56,REAL,2915233371,475,2915233846,2945871390
2025-06-19 12:20:58,REAL,2915233846,483,2915234329,2945871873
2025-06-19 12:21:00,REAL,2915234329,487,2915234816,2945872360
2025-06-19 12:21:02,REAL,2915234816,5850,2915240666,2945878210
2025-06-19 12:21:04,REAL,2915240666,10712,2915251378,2945888922
2025-06-19 12:21:06,FAKE,2915251378,244,2915251622,2945899239
2025-06-19 12:21:08,REAL,2915251622,10248,2915261870,2945909487
2025-06-19 12:21:10,REAL,2915261870,10315,2915272185,2945919802
2025-06-19 12:21:12,FAKE,2915272185,243,2915272428,2945930051
2025-06-19 12:21:14,REAL,2915272428,10316,2915282744,2945940367
2025-06-19 12:21:16,REAL,2915282744,10191,2915292935,2945950558
2025-06-19 12:21:18,REAL,2915292935,476,2915293411,2945951034
2025-06-19 12:21:20,REAL,2915293411,483,2915293894,2945951517
2025-06-19 12:21:22,FAKE,2915293894,243,2915294137,2945952000
2025-06-19 12:21:24,REAL,2915294137,485,2915294622,2945952485
2025-06-19 12:21:26,FAKE,2915294622,238,2915294860,2945952978
2025-06-19 12:21:28,REAL,2915294860,480,2915295340,2945953458
2025-06-19 12:21:30,REAL,2915295340,483,2915295823,2945953941
2025-06-19 12:21:32,REAL,2915295823,485,2915296308,2945954426
2025-06-19 12:21:34,REAL,2915296308,484,2915296792,2945954910
2025-06-19 12:21:36,REAL,2915296792,477,2915297269,2945955387
2025-06-19 12:21:38,FAKE,2915297269,238,2915297507,2945955865
2025-06-19 12:21:40,REAL,2915297507,541,2915298048,2945956406
2025-06-19 12:21:42,REAL,2915298048,477,2915298525,2945956883
2025-06-19 12:21:44,REAL,2915298525,480,2915299005,2945957363
2025-06-19 12:21:46,REAL,2915299005,487,2915299492,2945957850
2025-06-19 12:21:48,FAKE,2915299492,238,2915299730,2945958330
2025-06-19 12:21:50,REAL,2915299730,547,2915300277,2945958877
2025-06-19 12:21:52,REAL,2915300277,485,2915300762,2945959362
2025-06-19 12:21:54,FAKE,2915300762,243,2915301005,2945959843
2025-06-19 12:21:56,REAL,2915301005,482,2915301487,2945960325
2025-06-19 12:21:58,REAL,2915301487,479,2915301966,2945960804
2025-06-19 12:22:00,REAL,2915301966,485,2915302451,2945961289
2025-06-19 12:22:02,REAL,2915302451,477,2915302928,2945961766
2025-06-19 12:22:04,FAKE,2915302928,238,2915303166,2945962258
2025-06-19 12:22:06,REAL,2915303166,8023,2915311189,2945970281
2025-06-19 12:22:08,REAL,2915311189,11107,2915322296,2945981388
2025-06-19 12:22:10,REAL,2915322296,10252,2915332548,2945991640
2025-06-19 12:22:12,FAKE,2915332548,243,2915332791,2946001956
2025-06-19 12:22:14,REAL,2915332791,10244,2915343035,2946012200
2025-06-19 12:22:16,FAKE,2915343035,241,2915343276,2946022513
2025-06-19 12:22:18,REAL,2915343276,10323,2915353599,2946032836
2025-06-19 12:22:20,REAL,2915353599,8929,2915362528,2946041765
2025-06-19 12:22:22,REAL,2915362528,477,2915363005,2946042242
2025-06-19 12:22:24,REAL,2915363005,479,2915363484,2946042721
2025-06-19 12:22:26,FAKE,2915363484,238,2915363722,2946043197
2025-06-19 12:22:28,FAKE,2915363722,238,2915363960,2946043672
2025-06-19 12:22:30,FAKE,2915363960,244,2915364204,2946044157
2025-06-19 12:22:32,REAL,2915364204,483,2915364687,2946044640
2025-06-19 12:22:34,FAKE,2915364687,241,2915364928,2946045124
2025-06-19 12:22:36,FAKE,2915364928,244,2915365172,2946045606
2025-06-19 12:22:38,FAKE,2915365172,243,2915365415,2946046085
2025-06-19 12:22:40,REAL,2915365415,477,2915365892,2946046562
2025-06-19 12:22:42,REAL,2915365892,477,2915366369,2946047039
2025-06-19 12:22:44,REAL,2915366369,487,2915366856,2946047526
2025-06-19 12:22:46,FAKE,2915366856,243,2915367099,2946048007
2025-06-19 12:22:48,REAL,2915367099,480,2915367579,2946048487
2025-06-19 12:22:50,REAL,2915367579,486,2915368065,2946048973
2025-06-19 12:22:52,REAL,2915368065,548,2915368613,2946049521
2025-06-19 12:22:54,FAKE,2915368613,243,2915368856,2946050068
2025-06-19 12:22:56,REAL,2915368856,487,2915369343,2946050555
2025-06-19 12:22:58,FAKE,2915369343,238,2915369581,2946051038
2025-06-19 12:23:00,REAL,2915369581,489,2915370070,2946051527
2025-06-19 12:23:02,REAL,2915370070,486,2915370556,2946052013
2025-06-19 12:23:04,REAL,2915370556,483,2915371039,2946052496
2025-06-19 12:23:06,REAL,2915371039,488,2915371527,2946052984
2025-06-19 12:23:08,FAKE,2915371527,243,2915371770,2946053470
2025-06-19 12:23:10,FAKE,2915371770,238,2915372008,2946053947
2025-06-19 12:23:12,FAKE,2915372008,244,2915372252,2946054431
2025-06-19 12:23:14,REAL,2915372252,484,2915372736,2946054915
2025-06-19 12:23:16,REAL,2915372736,484,2915373220,2946055399
2025-06-19 12:23:18,FAKE,2915373220,241,2915373461,2946055878
2025-06-19 12:23:20,REAL,2915373461,9405,2915382866,2946065283
2025-06-19 12:23:22,REAL,2915382866,10444,2915393310,2946075727
2025-06-19 12:23:24,REAL,2915393310,10252,2915403562,2946085979
2025-06-19 12:23:26,REAL,2915403562,10316,2915413878,2946096295
2025-06-19 12:23:28,FAKE,2915413878,243,2915414121,2946106544
2025-06-19 12:23:30,REAL,2915414121,10309,2915424430,2946116853
2025-06-19 12:23:32,REAL,2915424430,10311,2915434741,2946127164
2025-06-19 12:23:34,FAKE,2915434741,244,2915434985,2946134785
2025-06-19 12:23:36,FAKE,2915434985,244,2915435229,2946135264
2025-06-19 12:23:38,REAL,2915435229,486,2915435715,2946135750
2025-06-19 12:23:40,REAL,2915435715,484,2915436199,2946136234
2025-06-19 12:23:42,REAL,2915436199,476,2915436675,2946136710
2025-06-19 12:23:44,FAKE,2915436675,244,2915436919,2946137199
2025-06-19 12:23:46,REAL,2915436919,491,2915437410,2946137690
2025-06-19 12:23:48,REAL,2915437410,484,2915437894,2946138174
2025-06-19 12:23:50,REAL,2915437894,488,2915438382,2946138662
2025-06-19 12:23:52,FAKE,2915438382,241,2915438623,2946139150
2025-06-19 12:23:54,FAKE,2915438623,243,2915438866,2946139627
2025-06-19 12:23:56,REAL,2915438866,484,2915439350,2946140111
2025-06-19 12:23:58,FAKE,2915439350,241,2915439591,2946140595
2025-06-19 12:24:00,REAL,2915439591,485,2915440076,2946141080
2025-06-19 12:24:02,REAL,2915440076,481,2915440557,2946141561
2025-06-19 12:24:04,REAL,2915440557,479,2915441036,2946142040
2025-06-19 12:24:06,REAL,2915441036,537,2915441573,2946142577
2025-06-19 12:24:08,REAL,2915441573,10195,2915451768,2946152772
2025-06-19 12:24:10,REAL,2915451768,10445,2915462213,2946163217
2025-06-19 12:24:12,REAL,2915462213,10310,2915472523,2946173527
2025-06-19 12:24:14,REAL,2915472523,10246,2915482769,2946183773
2025-06-19 12:24:16,FAKE,2915482769,243,2915483012,2946194029
2025-06-19 12:24:18,REAL,2915483012,10250,2915493262,2946204279
2025-06-19 12:24:20,REAL,2915493262,10261,2915503523,2946214540
2025-06-19 12:24:22,REAL,2915503523,6692,2915510215,2946221232
2025-06-19 12:24:24,REAL,2915510215,483,2915510698,2946221715
2025-06-19 12:24:26,FAKE,2915510698,238,2915510936,2946222202
2025-06-19 12:24:28,REAL,2915510936,485,2915511421,2946222687
2025-06-19 12:24:30,FAKE,2915511421,244,2915511665,2946223170
2025-06-19 12:24:32,REAL,2915511665,482,2915512147,2946223652
2025-06-19 12:24:34,FAKE,2915512147,238,2915512385,2946224132
2025-06-19 12:24:36,REAL,2915512385,488,2915512873,2946224620
2025-06-19 12:24:38,REAL,2915512873,488,2915513361,2946225108
2025-06-19 12:24:40,REAL,2915513361,485,2915513846,2946225593
2025-06-19 12:24:42,REAL,2915513846,540,2915514386,2946226133
2025-06-19 12:24:44,FAKE,2915514386,244,2915514630,2946226614
2025-06-19 12:24:46,REAL,2915514630,492,2915515122,2946227106
2025-06-19 12:24:48,REAL,2915515122,487,2915515609,2946227593
2025-06-19 12:24:50,FAKE,2915515609,243,2915515852,2946228078
2025-06-19 12:24:52,REAL,2915515852,542,2915516394,2946228620
2025-06-19 12:24:54,REAL,2915516394,482,2915516876,2946229102
2025-06-19 12:24:56,FAKE,2915516876,243,2915517119,2946229592
2025-06-19 12:24:58,REAL,2915517119,486,2915517605,2946230078
2025-06-19 12:25:00,FAKE,2915517605,238,2915517843,2946230563
2025-06-19 12:25:02,REAL,2915517843,488,2915518331,2946231051
2025-06-19 12:25:04,REAL,2915518331,487,2915518818,2946231538
2025-06-19 12:25:06,FAKE,2915518818,243,2915519061,2946232025
2025-06-19 12:25:08,REAL,2915519061,484,2915519545,2946232509
2025-06-19 12:25:10,REAL,2915519545,6293,2915525838,2946238802
2025-06-19 12:25:12,REAL,2915525838,11046,2915536884,2946249848
2025-06-19 12:25:14,FAKE,2915536884,238,2915537122,2946260174
2025-06-19 12:25:16,REAL,2915537122,10307,2915547429,2946270481
2025-06-19 12:25:18,REAL,2915547429,10246,2915557675,2946280727
2025-06-19 12:25:20,REAL,2915557675,10312,2915567987,2946291039
2025-06-19 12:25:22,REAL,2915567987,10257,2915578244,2946301296
2025-06-19 12:25:24,REAL,2915578244,10246,2915588490,2946311542
2025-06-19 12:25:26,REAL,2915588490,875,2915589365,2946312417
2025-06-19 12:25:28,FAKE,2915589365,241,2915589606,2946312903
2025-06-19 12:25:30,FAKE,2915589606,243,2915589849,2946313388
2025-06-19 12:25:32,FAKE,2915589849,238,2915590087,2946313635
2025-06-19 12:25:34,FAKE,2915590087,241,2915590328,2946314121
2025-06-19 12:25:36,REAL,2915590328,487,2915590815,2946314608
2025-06-19 12:25:38,REAL,2915590815,479,2915591294,2946315087
2025-06-19 12:25:40,REAL,2915591294,476,2915591770,2946315563
2025-06-19 12:25:42,FAKE,2915591770,238,2915592008,2946322451
2025-06-19 12:25:44,FAKE,2915592008,243,2915592251,2946333701
2025-06-19 12:25:46,REAL,2915592251,10254,2915602505,2946343955
2025-06-19 12:25:48,REAL,2915602505,10252,2915612757,2946354207
2025-06-19 12:25:50,REAL,2915612757,10253,2915623010,2946364460
2025-06-19 12:25:52,REAL,2915623010,10311,2915633321,2946374771
2025-06-19 12:25:54,REAL,2915633321,10307,2915643628,2946385078
2025-06-19 12:25:56,FAKE,2915643628,241,2915643869,2946395135
2025-06-19 12:25:58,REAL,2915643869,483,2915644352,2946395618
2025-06-19 12:26:00,FAKE,2915644352,238,2915644590,2946396101
2025-06-19 12:26:02,REAL,2915644590,480,2915645070,2946396581
2025-06-19 12:26:04,FAKE,2915645070,244,2915645314,2946397060
2025-06-19 12:26:06,REAL,2915645314,487,2915645801,2946397547
2025-06-19 12:26:08,FAKE,2915645801,241,2915646042,2946398030
2025-06-19 12:26:10,REAL,2915646042,477,2915646519,2946398507
2025-06-19 12:26:12,REAL,2915646519,480,2915646999,2946398987
2025-06-19 12:26:14,FAKE,2915646999,243,2915647242,2946406008
2025-06-19 12:26:16,REAL,2915647242,11041,2915658283,2946417049
2025-06-19 12:26:18,REAL,2915658283,10252,2915668535,2946427301
2025-06-19 12:26:20,REAL,2915668535,10318,2915678853,2946437619
2025-06-19 12:26:22,REAL,2915678853,10249,2915689102,2946447868
2025-06-19 12:26:24,REAL,2915689102,10248,2915699350,2946458116
2025-06-19 12:26:26,REAL,2915699350,10249,2915709599,2946468365
2025-06-19 12:26:28,FAKE,2915709599,244,2915709843,2946477757
2025-06-19 12:26:30,REAL,2915709843,538,2915710381,2946478295
2025-06-19 12:26:32,FAKE,2915710381,244,2915710625,2946478777
2025-06-19 12:26:34,REAL,2915710625,486,2915711111,2946479263
2025-06-19 12:26:36,REAL,2915711111,494,2915711605,2946479757
2025-06-19 12:26:38,REAL,2915711605,479,2915712084,2946480236
2025-06-19 12:26:40,REAL,2915712084,481,2915712565,2946480717
2025-06-19 12:26:42,REAL,2915712565,485,2915713050,2946481202
2025-06-19 12:26:44,FAKE,2915713050,244,2915713294,2946481688
2025-06-19 12:26:46,FAKE,2915713294,244,2915713538,2946482170
2025-06-19 12:26:48,FAKE,2915713538,241,2915713779,2946482651
2025-06-19 12:26:50,REAL,2915713779,476,2915714255,2946483127
2025-06-19 12:26:52,FAKE,2915714255,243,2915714498,2946483612
2025-06-19 12:26:54,REAL,2915714498,482,2915714980,2946484094
2025-06-19 12:26:56,REAL,2915714980,488,2915715468,2946484582
2025-06-19 12:26:58,FAKE,2915715468,241,2915715709,2946485122
2025-06-19 12:27:00,REAL,2915715709,484,2915716193,2946485606
2025-06-19 12:27:02,REAL,2915716193,483,2915716676,2946486089
2025-06-19 12:27:04,FAKE,2915716676,238,2915716914,2946486576
2025-06-19 12:27:06,REAL,2915716914,547,2915717461,2946487123
2025-06-19 12:27:08,REAL,2915717461,485,2915717946,2946487608
2025-06-19 12:27:10,REAL,2915717946,487,2915718433,2946488095
2025-06-19 12:27:12,FAKE,2915718433,244,2915718677,2946488581
2025-06-19 12:27:14,REAL,2915718677,491,2915719168,2946489072
2025-06-19 12:27:16,FAKE,2915719168,241,2915719409,2946489557
2025-06-19 12:27:18,REAL,2915719409,482,2915719891,2946490039
2025-06-19 12:27:20,REAL,2915719891,481,2915720372,2946490520
2025-06-19 12:27:22,FAKE,2915720372,241,2915720613,2946490995
2025-06-19 12:27:24,FAKE,2915720613,243,2915720856,2946491485
2025-06-19 12:27:26,REAL,2915720856,485,2915721341,2946491970
2025-06-19 12:27:28,REAL,2915721341,477,2915721818,2946492447
2025-06-19 12:27:30,FAKE,2915721818,241,2915722059,2946492929
2025-06-19 12:27:32,FAKE,2915722059,238,2915722297,2946493412
2025-06-19 12:27:34,FAKE,2915722297,243,2915722540,2946505119
2025-06-19 12:27:36,REAL,2915722540,11714,2915734254,2946516833
2025-06-19 12:27:38,REAL,2915734254,10247,2915744501,2946527080
2025-06-19 12:27:40,FAKE,2915744501,238,2915744739,2946537393
2025-06-19 12:27:42,REAL,2915744739,10321,2915755060,2946547714
2025-06-19 12:27:44,FAKE,2915755060,241,2915755301,2946557964
2025-06-19 12:27:46,FAKE,2915755301,238,2915755539,2946568279
2025-06-19 12:27:48,REAL,2915755539,7877,2915763416,2946576156
2025-06-19 12:27:50,FAKE,2915763416,244,2915763660,2946576646
2025-06-19 12:27:52,REAL,2915763660,477,2915764137,2946577123
2025-06-19 12:27:54,REAL,2915764137,486,2915764623,2946577609
2025-06-19 12:27:56,REAL,2915764623,492,2915765115,2946578101
2025-06-19 12:27:58,REAL,2915765115,483,2915765598,2946578584
2025-06-19 12:28:00,REAL,2915765598,536,2915766134,2946579120
2025-06-19 12:28:02,REAL,2915766134,485,2915766619,2946579605
2025-06-19 12:28:04,REAL,2915766619,485,2915767104,2946580090
2025-06-19 12:28:06,REAL,2915767104,486,2915767590,2946580576
2025-06-19 12:28:08,REAL,2915767590,485,2915768075,2946581061
2025-06-19 12:28:10,FAKE,2915768075,244,2915768319,2946581544
2025-06-19 12:28:12,REAL,2915768319,487,2915768806,2946582031
2025-06-19 12:28:14,REAL,2915768806,489,2915769295,2946582520
2025-06-19 12:28:16,REAL,2915769295,539,2915769834,2946583059
2025-06-19 12:28:18,FAKE,2915769834,238,2915770072,2946583544
2025-06-19 12:28:20,REAL,2915770072,482,2915770554,2946584026
2025-06-19 12:28:22,REAL,2915770554,483,2915771037,2946584509
2025-06-19 12:28:24,REAL,2915771037,482,2915771519,2946584991
2025-06-19 12:28:26,FAKE,2915771519,241,2915771760,2946585532
2025-06-19 12:28:28,REAL,2915771760,488,2915772248,2946586020
2025-06-19 12:28:30,REAL,2915772248,481,2915772729,2946586501
2025-06-19 12:28:32,REAL,2915772729,493,2915773222,2946586994
2025-06-19 12:28:34,FAKE,2915773222,244,2915773466,2946587472
2025-06-19 12:28:36,FAKE,2915773466,244,2915773710,2946587957
2025-06-19 12:28:38,FAKE,2915773710,238,2915773948,2946588442
2025-06-19 12:28:40,REAL,2915773948,490,2915774438,2946588932
2025-06-19 12:28:42,REAL,2915774438,481,2915774919,2946589413
2025-06-19 12:28:44,REAL,2915774919,492,2915775411,2946589905
2025-06-19 12:28:46,REAL,2915775411,489,2915775900,2946590394
2025-06-19 12:28:48,REAL,2915775900,10392,2915786292,2946600786
2025-06-19 12:28:50,FAKE,2915786292,241,2915786533,2946611174
2025-06-19 12:28:52,FAKE,2915786533,241,2915786774,2946621499
2025-06-19 12:28:54,REAL,2915786774,10300,2915797074,2946631799
2025-06-19 12:28:56,FAKE,2915797074,238,2915797312,2946642044
2025-06-19 12:28:58,FAKE,2915797312,241,2915797553,2946652298
2025-06-19 12:29:00,REAL,2915797553,10321,2915807874,2946662619
2025-06-19 12:29:02,REAL,2915807874,6627,2915814501,2946669246
2025-06-19 12:29:04,REAL,2915814501,475,2915814976,2946669721
2025-06-19 12:29:06,FAKE,2915814976,243,2915815219,2946670204
2025-06-19 12:29:08,REAL,2915815219,481,2915815700,2946670685
2025-06-19 12:29:10,FAKE,2915815700,238,2915815938,2946671176
2025-06-19 12:29:12,REAL,2915815938,479,2915816417,2946671655
2025-06-19 12:29:14,FAKE,2915816417,243,2915816660,2946672133
2025-06-19 12:29:16,REAL,2915816660,475,2915817135,2946672608
2025-06-19 12:29:18,REAL,2915817135,480,2915817615,2946673088
2025-06-19 12:29:20,REAL,2915817615,11169,2915828784,2946684257
2025-06-19 12:29:22,REAL,2915828784,10249,2915839033,2946694506
2025-06-19 12:29:24,REAL,2915839033,10323,2915849356,2946704829
2025-06-19 12:29:26,REAL,2915849356,10252,2915859608,2946715081
2025-06-19 12:29:28,REAL,2915859608,10247,2915869855,2946725328
2025-06-19 12:29:30,REAL,2915869855,10325,2915880180,2946735653
2025-06-19 12:29:32,REAL,2915880180,10257,2915890437,2946745910
2025-06-19 12:29:34,REAL,2915890437,6036,2915896473,2946751946
2025-06-19 12:29:36,FAKE,2915896473,238,2915896711,2946752427
2025-06-19 12:29:38,REAL,2915896711,485,2915897196,2946752912
2025-06-19 12:29:40,REAL,2915897196,481,2915897677,2946753393
2025-06-19 12:29:42,REAL,2915897677,482,2915898159,2946753875
2025-06-19 12:29:44,FAKE,2915898159,241,2915898400,2946754356
2025-06-19 12:29:46,REAL,2915898400,547,2915898947,2946754903
2025-06-19 12:29:48,REAL,2915898947,493,2915899440,2946755396
2025-06-19 12:29:50,REAL,2915899440,491,2915899931,2946755887
2025-06-19 12:29:52,REAL,2915899931,482,2915900413,2946756369
2025-06-19 12:29:54,REAL,2915900413,493,2915900906,2946756862
2025-06-19 12:29:56,REAL,2915900906,485,2915901391,2946757347
2025-06-19 12:29:58,REAL,2915901391,482,2915901873,2946757829
2025-06-19 12:30:00,FAKE,2915901873,244,2915902117,2946758368
2025-06-19 12:30:02,REAL,2915902117,484,2915902601,2946758852
2025-06-19 12:30:04,REAL,2915902601,481,2915903082,2946759333
2025-06-19 12:30:06,REAL,2915903082,483,2915903565,2946759816
2025-06-19 12:30:08,REAL,2915903565,478,2915904043,2946760294
2025-06-19 12:30:10,REAL,2915904043,484,2915904527,2946760778
2025-06-19 12:30:12,REAL,2915904527,489,2915905016,2946761267
2025-06-19 12:30:14,REAL,2915905016,537,2915905553,2946761804
2025-06-19 12:30:16,REAL,2915905553,483,2915906036,2946762287
2025-06-19 12:30:18,FAKE,2915906036,241,2915906277,2946762768
2025-06-19 12:30:20,FAKE,2915906277,238,2915906515,2946763261
2025-06-19 12:30:22,REAL,2915906515,489,2915907004,2946763750
2025-06-19 12:30:24,FAKE,2915907004,244,2915907248,2946764232
2025-06-19 12:30:26,REAL,2915907248,478,2915907726,2946764710
2025-06-19 12:30:28,REAL,2915907726,486,2915908212,2946765196
2025-06-19 12:30:30,FAKE,2915908212,244,2915908456,2946765684
2025-06-19 12:30:32,REAL,2915908456,479,2915908935,2946766163
2025-06-19 12:30:34,FAKE,2915908935,241,2915909176,2946766654
2025-06-19 12:30:36,REAL,2915909176,490,2915909666,2946767144
2025-06-19 12:30:38,REAL,2915909666,487,2915910153,2946767631
2025-06-19 12:30:40,REAL,2915910153,542,2915910695,2946768173
2025-06-19 12:30:42,REAL,2915910695,539,2915911234,2946768712
2025-06-19 12:30:44,REAL,2915911234,484,2915911718,2946769196
2025-06-19 12:30:46,REAL,2915911718,482,2915912200,2946769678
2025-06-19 12:30:48,REAL,2915912200,491,2915912691,2946770169
2025-06-19 12:30:50,REAL,2915912691,494,2915913185,2946770663
2025-06-19 12:30:52,REAL,2915913185,479,2915913664,2946771142
2025-06-19 12:30:54,REAL,2915913664,478,2915914142,2946771620
2025-06-19 12:30:56,REAL,2915914142,482,2915914624,2946772102
2025-06-19 12:30:58,REAL,2915914624,481,2915915105,2946772583
2025-06-19 12:31:00,REAL,2915915105,484,2915915589,2946773067
2025-06-19 12:31:02,REAL,2915915589,486,2915916075,2946773553
2025-06-19 12:31:04,REAL,2915916075,491,2915916566,2946774044
2025-06-19 12:31:06,REAL,2915916566,540,2915917106,2946774584
2025-06-19 12:31:08,FAKE,2915917106,238,2915917344,2946775076
2025-06-19 12:31:10,REAL,2915917344,478,2915917822,2946775554
2025-06-19 12:31:12,FAKE,2915917822,238,2915918060,2946776041
2025-06-19 12:31:14,REAL,2915918060,484,2915918544,2946776525
2025-06-19 12:31:16,FAKE,2915918544,238,2915918782,2946777004
2025-06-19 12:31:18,REAL,2915918782,487,2915919269,2946777491
2025-06-19 12:31:20,REAL,2915919269,486,2915919755,2946777977
2025-06-19 12:31:22,REAL,2915919755,545,2915920300,2946778522
2025-06-19 12:31:24,FAKE,2915920300,238,2915920538,2946779010
2025-06-19 12:31:26,REAL,2915920538,486,2915921024,2946779496
2025-06-19 12:31:28,FAKE,2915921024,244,2915921268,2946779988
2025-06-19 12:31:30,REAL,2915921268,486,2915921754,2946780474
2025-06-19 12:31:32,REAL,2915921754,546,2915922300,2946781020
2025-06-19 12:31:34,FAKE,2915922300,241,2915922541,2946781506
2025-06-19 12:31:36,FAKE,2915922541,241,2915922782,2946781993
2025-06-19 12:31:38,FAKE,2915922782,243,2915923025,2946782483
2025-06-19 12:31:40,REAL,2915923025,487,2915923512,2946782970
2025-06-19 12:31:42,REAL,2915923512,8754,2915932266,2946791724
2025-06-19 12:31:44,REAL,2915932266,10924,2915943190,2946802648
2025-06-19 12:31:46,REAL,2915943190,10311,2915953501,2946812959
2025-06-19 12:31:48,REAL,2915953501,10252,2915963753,2946823211
2025-06-19 12:31:50,REAL,2915963753,10252,2915974005,2946833463
2025-06-19 12:31:52,FAKE,2915974005,241,2915974246,2946843779
2025-06-19 12:31:54,REAL,2915974246,10250,2915984496,2946854029
2025-06-19 12:31:56,REAL,2915984496,8465,2915992961,2946862494
2025-06-19 12:31:58,FAKE,2915992961,244,2915993205,2946862975
2025-06-19 12:32:00,FAKE,2915993205,241,2915993446,2946863459
2025-06-19 12:32:02,REAL,2915993446,487,2915993933,2946863946
2025-06-19 12:32:04,REAL,2915993933,483,2915994416,2946864429
2025-06-19 12:32:06,REAL,2915994416,478,2915994894,2946864907
2025-06-19 12:32:08,REAL,2915994894,532,2915995426,2946865439
2025-06-19 12:32:10,REAL,2915995426,475,2915995901,2946865914
2025-06-19 12:32:12,REAL,2915995901,483,2915996384,2946866397
2025-06-19 12:32:14,REAL,2915996384,11250,2916007634,2946877647
2025-06-19 12:32:16,REAL,2916007634,11502,2916019136,2946889149
2025-06-19 12:32:18,FAKE,2916019136,244,2916019380,2946899467
2025-06-19 12:32:20,REAL,2916019380,10247,2916029627,2946909714
2025-06-19 12:32:22,FAKE,2916029627,243,2916029870,2946919964
2025-06-19 12:32:24,FAKE,2916029870,241,2916030111,2946930212
2025-06-19 12:32:26,REAL,2916030111,10254,2916040365,2946940466
2025-06-19 12:32:28,FAKE,2916040365,244,2916040609,2946948343
2025-06-19 12:32:30,REAL,2916040609,482,2916041091,2946948825
2025-06-19 12:32:32,FAKE,2916041091,241,2916041332,2946949311
2025-06-19 12:32:34,REAL,2916041332,488,2916041820,2946949799
2025-06-19 12:32:36,FAKE,2916041820,244,2916042064,2946950283
2025-06-19 12:32:38,REAL,2916042064,477,2916042541,2946950760
2025-06-19 12:32:40,FAKE,2916042541,241,2916042782,2946951242
2025-06-19 12:32:42,FAKE,2916042782,238,2916043020,2946951774
2025-06-19 12:32:44,REAL,2916043020,481,2916043501,2946952255
2025-06-19 12:32:46,REAL,2916043501,10131,2916053632,2946962386
2025-06-19 12:32:48,REAL,2916053632,10586,2916064218,2946972972
2025-06-19 12:32:50,FAKE,2916064218,243,2916064461,2946983286
2025-06-19 12:32:52,FAKE,2916064461,241,2916064702,2946993541
2025-06-19 12:32:54,REAL,2916064702,10322,2916075024,2947003863
2025-06-19 12:32:56,REAL,2916075024,10251,2916085275,2947014114
2025-06-19 12:32:58,REAL,2916085275,10243,2916095518,2947024357
2025-06-19 12:33:00,REAL,2916095518,7211,2916102729,2947031568
2025-06-19 12:33:02,REAL,2916102729,483,2916103212,2947032051
2025-06-19 12:33:04,REAL,2916103212,483,2916103695,2947032534
2025-06-19 12:33:06,FAKE,2916103695,238,2916103933,2947033016
2025-06-19 12:33:08,REAL,2916103933,489,2916104422,2947033505
2025-06-19 12:33:10,REAL,2916104422,479,2916104901,2947033984
2025-06-19 12:33:12,REAL,2916104901,485,2916105386,2947034469
2025-06-19 12:33:14,REAL,2916105386,482,2916105868,2947034951
2025-06-19 12:33:16,REAL,2916105868,489,2916106357,2947035440
2025-06-19 12:33:18,FAKE,2916106357,238,2916106595,2947035990
2025-06-19 12:33:20,REAL,2916106595,483,2916107078,2947036473
2025-06-19 12:33:22,REAL,2916107078,489,2916107567,2947036962
2025-06-19 12:33:24,REAL,2916107567,481,2916108048,2947037443
2025-06-19 12:33:26,REAL,2916108048,538,2916108586,2947037981
2025-06-19 12:33:28,REAL,2916108586,485,2916109071,2947038466
2025-06-19 12:33:30,REAL,2916109071,485,2916109556,2947038951
2025-06-19 12:33:32,REAL,2916109556,481,2916110037,2947039432
2025-06-19 12:33:34,REAL,2916110037,476,2916110513,2947039908
2025-06-19 12:33:36,REAL,2916110513,483,2916110996,2947040391
2025-06-19 12:33:38,REAL,2916110996,484,2916111480,2947040875
2025-06-19 12:33:40,FAKE,2916111480,243,2916111723,2947041357
2025-06-19 12:33:42,REAL,2916111723,487,2916112210,2947041844
2025-06-19 12:33:44,REAL,2916112210,478,2916112688,2947042322
2025-06-19 12:33:46,REAL,2916112688,491,2916113179,2947042813
2025-06-19 12:33:48,REAL,2916113179,475,2916113654,2947043288
2025-06-19 12:33:50,REAL,2916113654,476,2916114130,2947043764
2025-06-19 12:33:52,REAL,2916114130,486,2916114616,2947044250
2025-06-19 12:33:54,REAL,2916114616,541,2916115157,2947044791
2025-06-19 12:33:56,REAL,2916115157,487,2916115644,2947045278
2025-06-19 12:33:58,REAL,2916115644,484,2916116128,2947045762
2025-06-19 12:34:00,FAKE,2916116128,244,2916116372,2947046244
2025-06-19 12:34:02,REAL,2916116372,487,2916116859,2947046731
2025-06-19 12:34:04,FAKE,2916116859,241,2916117100,2947047207
2025-06-19 12:34:06,REAL,2916117100,482,2916117582,2947047689
2025-06-19 12:34:08,REAL,2916117582,542,2916118124,2947048231
2025-06-19 12:34:10,REAL,2916118124,486,2916118610,2947048717
2025-06-19 12:34:12,REAL,2916118610,480,2916119090,2947049197
2025-06-19 12:34:14,REAL,2916119090,483,2916119573,2947049680
2025-06-19 12:34:16,REAL,2916119573,494,2916120067,2947050174
2025-06-19 12:34:18,REAL,2916120067,482,2916120549,2947050656
2025-06-19 12:34:20,REAL,2916120549,494,2916121043,2947051150
2025-06-19 12:34:22,FAKE,2916121043,238,2916121281,2947062925
2025-06-19 12:34:24,FAKE,2916121281,238,2916121519,2947073174
2025-06-19 12:34:26,FAKE,2916121519,243,2916121762,2947083431
2025-06-19 12:34:28,FAKE,2916121762,243,2916122005,2947093748
2025-06-19 12:34:30,REAL,2916122005,10309,2916132314,2947104057
2025-06-19 12:34:32,REAL,2916132314,10247,2916142561,2947114304
2025-06-19 12:34:34,REAL,2916142561,10252,2916152813,2947124556
2025-06-19 12:34:36,FAKE,2916152813,243,2916153056,2947129927
2025-06-19 12:34:38,REAL,2916153056,477,2916153533,2947130404
2025-06-19 12:34:40,REAL,2916153533,485,2916154018,2947130889
2025-06-19 12:34:42,REAL,2916154018,6695,2916160713,2947137584
2025-06-19 12:34:44,FAKE,2916160713,243,2916160956,2947148382
2025-06-19 12:34:46,FAKE,2916160956,244,2916161200,2947158702
2025-06-19 12:34:48,REAL,2916161200,10246,2916171446,2947168948
2025-06-19 12:34:50,REAL,2916171446,10312,2916181758,2947179260
2025-06-19 12:34:52,FAKE,2916181758,241,2916181999,2947189514
2025-06-19 12:34:54,REAL,2916181999,10317,2916192316,2947199831
2025-06-19 12:34:56,REAL,2916192316,9861,2916202177,2947209692
2025-06-19 12:34:58,REAL,2916202177,488,2916202665,2947210180
2025-06-19 12:35:00,REAL,2916202665,482,2916203147,2947210662
2025-06-19 12:35:02,REAL,2916203147,486,2916203633,2947211148
2025-06-19 12:35:04,REAL,2916203633,480,2916204113,2947211628
2025-06-19 12:35:06,FAKE,2916204113,241,2916204354,2947212168
2025-06-19 12:35:08,REAL,2916204354,482,2916204836,2947212650
2025-06-19 12:35:10,REAL,2916204836,491,2916205327,2947213141
2025-06-19 12:35:12,FAKE,2916205327,243,2916205570,2947213621
2025-06-19 12:35:14,REAL,2916205570,484,2916206054,2947214105
2025-06-19 12:35:16,REAL,2916206054,486,2916206540,2947214591
2025-06-19 12:35:18,REAL,2916206540,486,2916207026,2947215077
2025-06-19 12:35:20,FAKE,2916207026,243,2916207269,2947215564
2025-06-19 12:35:22,FAKE,2916207269,244,2916207513,2947216047
2025-06-19 12:35:24,FAKE,2916207513,241,2916207754,2947216536
2025-06-19 12:35:26,REAL,2916207754,480,2916208234,2947217016
2025-06-19 12:35:28,FAKE,2916208234,243,2916208477,2947217561
2025-06-19 12:35:30,REAL,2916208477,481,2916208958,2947218042
2025-06-19 12:35:32,REAL,2916208958,490,2916209448,2947218532
2025-06-19 12:35:34,REAL,2916209448,487,2916209935,2947219019
2025-06-19 12:35:36,FAKE,2916209935,238,2916210173,2947219502
2025-06-19 12:35:38,REAL,2916210173,490,2916210663,2947219992
2025-06-19 12:35:40,REAL,2916210663,542,2916211205,2947220534
2025-06-19 12:35:42,REAL,2916211205,485,2916211690,2947221019
2025-06-19 12:35:44,REAL,2916211690,489,2916212179,2947221508
2025-06-19 12:35:46,REAL,2916212179,483,2916212662,2947221991
2025-06-19 12:35:48,REAL,2916212662,490,2916213152,2947222481
2025-06-19 12:35:50,FAKE,2916213152,238,2916213390,2947222964
2025-06-19 12:35:52,REAL,2916213390,487,2916213877,2947223451
2025-06-19 12:35:54,REAL,2916213877,476,2916214353,2947223927
2025-06-19 12:35:56,REAL,2916214353,482,2916214835,2947224409
2025-06-19 12:35:58,REAL,2916214835,484,2916215319,2947224893
2025-06-19 12:36:00,REAL,2916215319,483,2916215802,2947225376
2025-06-19 12:36:02,REAL,2916215802,481,2916216283,2947225857
2025-06-19 12:36:04,REAL,2916216283,490,2916216773,2947226347
2025-06-19 12:36:06,REAL,2916216773,487,2916217260,2947226834
2025-06-19 12:36:08,REAL,2916217260,484,2916217744,2947227318
2025-06-19 12:36:10,FAKE,2916217744,244,2916217988,2947227803
2025-06-19 12:36:12,REAL,2916217988,487,2916218475,2947228290
2025-06-19 12:36:14,REAL,2916218475,547,2916219022,2947228837
2025-06-19 12:36:16,FAKE,2916219022,238,2916219260,2947229381
2025-06-19 12:36:18,REAL,2916219260,484,2916219744,2947229865
2025-06-19 12:36:20,REAL,2916219744,483,2916220227,2947230348
2025-06-19 12:36:22,FAKE,2916220227,243,2916220470,2947230835
2025-06-19 12:36:24,REAL,2916220470,486,2916220956,2947231321
2025-06-19 12:36:26,REAL,2916220956,478,2916221434,2947231799
2025-06-19 12:36:28,REAL,2916221434,480,2916221914,2947232279
2025-06-19 12:36:30,REAL,2916221914,485,2916222399,2947232764
2025-06-19 12:36:32,FAKE,2916222399,241,2916222640,2947233254
2025-06-19 12:36:34,FAKE,2916222640,238,2916222878,2947233732
2025-06-19 12:36:36,REAL,2916222878,479,2916223357,2947234211
2025-06-19 12:36:38,REAL,2916223357,11191,2916234548,2947245402
2025-06-19 12:36:40,REAL,2916234548,11707,2916246255,2947257109
2025-06-19 12:36:42,REAL,2916246255,10245,2916256500,2947267354
2025-06-19 12:36:44,REAL,2916256500,10317,2916266817,2947277671
2025-06-19 12:36:46,FAKE,2916266817,243,2916267060,2947287918
2025-06-19 12:36:48,REAL,2916267060,10320,2916277380,2947298238
2025-06-19 12:36:50,FAKE,2916277380,241,2916277621,2947308495
2025-06-19 12:36:52,REAL,2916277621,8198,2916285819,2947316693
2025-06-19 12:36:54,REAL,2916285819,485,2916286304,2947317178
2025-06-19 12:36:56,REAL,2916286304,492,2916286796,2947317670
2025-06-19 12:36:58,FAKE,2916286796,238,2916287034,2947318145
2025-06-19 12:37:00,FAKE,2916287034,241,2916287275,2947318628
2025-06-19 12:37:02,REAL,2916287275,491,2916287766,2947319119
2025-06-19 12:37:04,REAL,2916287766,483,2916288249,2947319602
2025-06-19 12:37:06,REAL,2916288249,478,2916288727,2947320080
2025-06-19 12:37:08,REAL,2916288727,478,2916289205,2947320558
2025-06-19 12:37:10,REAL,2916289205,11661,2916300866,2947332219
2025-06-19 12:37:12,REAL,2916300866,11508,2916312374,2947343727
2025-06-19 12:37:14,FAKE,2916312374,241,2916312615,2947354043
2025-06-19 12:37:16,FAKE,2916312615,238,2916312853,2947364298
2025-06-19 12:37:18,REAL,2916312853,10253,2916323106,2947374551
2025-06-19 12:37:20,REAL,2916323106,10308,2916333414,2947384859
2025-06-19 12:37:22,REAL,2916333414,10250,2916343664,2947395109
2025-06-19 12:37:24,REAL,2916343664,7552,2916351216,2947402661
2025-06-19 12:37:26,REAL,2916351216,493,2916351709,2947403154
2025-06-19 12:37:28,REAL,2916351709,542,2916352251,2947403696
2025-06-19 12:37:30,REAL,2916352251,484,2916352735,2947404180
2025-06-19 12:37:32,REAL,2916352735,481,2916353216,2947404661
2025-06-19 12:37:34,REAL,2916353216,493,2916353709,2947405154
2025-06-19 12:37:36,REAL,2916353709,485,2916354194,2947405639
2025-06-19 12:37:38,FAKE,2916354194,244,2916354438,2947406128
2025-06-19 12:37:40,REAL,2916354438,476,2916354914,2947406604
2025-06-19 12:37:42,REAL,2916354914,480,2916355394,2947407084
2025-06-19 12:37:44,FAKE,2916355394,241,2916355635,2947407568
2025-06-19 12:37:46,REAL,2916355635,484,2916356119,2947408052
2025-06-19 12:37:48,REAL,2916356119,493,2916356612,2947408545
2025-06-19 12:37:50,REAL,2916356612,481,2916357093,2947409026
2025-06-19 12:37:52,REAL,2916357093,476,2916357569,2947409502
2025-06-19 12:37:54,FAKE,2916357569,238,2916357807,2947410045
2025-06-19 12:37:56,REAL,2916357807,490,2916358297,2947410535
2025-06-19 12:37:58,FAKE,2916358297,244,2916358541,2947411020
2025-06-19 12:38:00,FAKE,2916358541,243,2916358784,2947411504
2025-06-19 12:38:02,REAL,2916358784,478,2916359262,2947411982
2025-06-19 12:38:04,FAKE,2916359262,238,2916359500,2947412526
2025-06-19 12:38:06,REAL,2916359500,486,2916359986,2947413012
2025-06-19 12:38:08,FAKE,2916359986,238,2916360224,2947413496
2025-06-19 12:38:10,REAL,2916360224,486,2916360710,2947413982
2025-06-19 12:38:12,REAL,2916360710,4323,2916365033,2947418305
2025-06-19 12:38:14,REAL,2916365033,10990,2916376023,2947429295
2025-06-19 12:38:16,FAKE,2916376023,241,2916376264,2947439544
2025-06-19 12:38:18,REAL,2916376264,10252,2916386516,2947449796
2025-06-19 12:38:20,REAL,2916386516,10253,2916396769,2947460049
2025-06-19 12:38:22,FAKE,2916396769,244,2916397013,2947470304
2025-06-19 12:38:24,REAL,2916397013,10247,2916407260,2947480551
2025-06-19 12:38:26,REAL,2916407260,10249,2916417509,2947490800
2025-06-19 12:38:28,REAL,2916417509,1728,2916419237,2947492528
2025-06-19 12:38:30,REAL,2916419237,485,2916419722,2947493013
2025-06-19 12:38:32,REAL,2916419722,483,2916420205,2947493496
2025-06-19 12:38:34,REAL,2916420205,482,2916420687,2947493978
2025-06-19 12:38:36,REAL,2916420687,488,2916421175,2947494466
2025-06-19 12:38:38,FAKE,2916421175,238,2916421413,2947495010
2025-06-19 12:38:40,REAL,2916421413,477,2916421890,2947495487
2025-06-19 12:38:42,FAKE,2916421890,243,2916422133,2947495970
2025-06-19 12:38:44,FAKE,2916422133,241,2916422374,2947496455
2025-06-19 12:38:46,FAKE,2916422374,238,2916422612,2947496939
2025-06-19 12:38:48,FAKE,2916422612,243,2916422855,2947497422
2025-06-19 12:38:50,REAL,2916422855,480,2916423335,2947497902
2025-06-19 12:38:52,FAKE,2916423335,238,2916423573,2947498391
2025-06-19 12:38:54,REAL,2916423573,483,2916424056,2947498874
2025-06-19 12:38:56,FAKE,2916424056,244,2916424300,2947499358
2025-06-19 12:38:58,FAKE,2916424300,238,2916424538,2947499903
2025-06-19 12:39:00,REAL,2916424538,491,2916425029,2947500394
2025-06-19 12:39:02,REAL,2916425029,484,2916425513,2947500878
2025-06-19 12:39:04,REAL,2916425513,480,2916425993,2947501358
2025-06-19 12:39:06,REAL,2916425993,475,2916426468,2947501833
2025-06-19 12:39:08,REAL,2916426468,482,2916426950,2947502315
2025-06-19 12:39:10,FAKE,2916426950,243,2916427193,2947502790
2025-06-19 12:39:12,REAL,2916427193,488,2916427681,2947503278
2025-06-19 12:39:14,REAL,2916427681,541,2916428222,2947503819
2025-06-19 12:39:16,REAL,2916428222,492,2916428714,2947504311
2025-06-19 12:39:18,REAL,2916428714,484,2916429198,2947504795
2025-06-19 12:39:20,FAKE,2916429198,238,2916429436,2947505274
2025-06-19 12:39:22,FAKE,2916429436,244,2916429680,2947505749
2025-06-19 12:39:24,REAL,2916429680,484,2916430164,2947506233
2025-06-19 12:39:26,REAL,2916430164,488,2916430652,2947506721
2025-06-19 12:39:28,REAL,2916430652,487,2916431139,2947507208
2025-06-19 12:39:30,REAL,2916431139,484,2916431623,2947507692
2025-06-19 12:39:32,REAL,2916431623,491,2916432114,2947508183
2025-06-19 12:39:34,FAKE,2916432114,244,2916432358,2947508668
2025-06-19 12:39:36,FAKE,2916432358,238,2916432596,2947509153
2025-06-19 12:39:38,REAL,2916432596,477,2916433073,2947509630
2025-06-19 12:39:40,REAL,2916433073,484,2916433557,2947510114
2025-06-19 12:39:42,REAL,2916433557,480,2916434037,2947510594
2025-06-19 12:39:44,REAL,2916434037,477,2916434514,2947511071
2025-06-19 12:39:46,FAKE,2916434514,244,2916434758,2947511618
2025-06-19 12:39:48,FAKE,2916434758,238,2916434996,2947518575
2025-06-19 12:39:50,FAKE,2916434996,241,2916435237,2947529483
2025-06-19 12:39:52,REAL,2916435237,10309,2916445546,2947539792
2025-06-19 12:39:54,REAL,2916445546,10256,2916455802,2947550048
2025-06-19 12:39:56,FAKE,2916455802,243,2916456045,2947560361
2025-06-19 12:39:58,REAL,2916456045,10257,2916466302,2947570618
2025-06-19 12:40:00,REAL,2916466302,10254,2916476556,2947580872
2025-06-19 12:40:02,REAL,2916476556,9660,2916486216,2947590532
2025-06-19 12:40:04,REAL,2916486216,491,2916486707,2947591023
2025-06-19 12:40:06,REAL,2916486707,486,2916487193,2947591509
2025-06-19 12:40:08,REAL,2916487193,475,2916487668,2947591984
2025-06-19 12:40:10,REAL,2916487668,480,2916488148,2947592464
2025-06-19 12:40:12,REAL,2916488148,484,2916488632,2947592948
2025-06-19 12:40:14,REAL,2916488632,489,2916489121,2947593437
2025-06-19 12:40:16,REAL,2916489121,480,2916489601,2947593917
2025-06-19 12:40:18,REAL,2916489601,480,2916490081,2947594397
2025-06-19 12:40:20,REAL,2916490081,488,2916490569,2947594885
2025-06-19 12:40:22,REAL,2916490569,487,2916491056,2947595372
2025-06-19 12:40:24,FAKE,2916491056,238,2916491294,2947595850
2025-06-19 12:40:26,REAL,2916491294,599,2916491893,2947596449
2025-06-19 12:40:28,REAL,2916491893,486,2916492379,2947596935
2025-06-19 12:40:30,REAL,2916492379,487,2916492866,2947597422
2025-06-19 12:40:32,REAL,2916492866,475,2916493341,2947597897
2025-06-19 12:40:34,REAL,2916493341,484,2916493825,2947598381
2025-06-19 12:40:36,REAL,2916493825,482,2916494307,2947598863
2025-06-19 12:40:38,REAL,2916494307,492,2916494799,2947599355
2025-06-19 12:40:40,REAL,2916494799,491,2916495290,2947599846
2025-06-19 12:40:42,REAL,2916495290,486,2916495776,2947600332
2025-06-19 12:40:44,REAL,2916495776,483,2916496259,2947600815
2025-06-19 12:40:46,REAL,2916496259,489,2916496748,2947601304
2025-06-19 12:40:48,REAL,2916496748,479,2916497227,2947601783
2025-06-19 12:40:50,FAKE,2916497227,238,2916497465,2947602264
2025-06-19 12:40:52,REAL,2916497465,482,2916497947,2947602746
2025-06-19 12:40:54,FAKE,2916497947,238,2916498185,2947603232
2025-06-19 12:40:56,FAKE,2916498185,238,2916498423,2947603718
2025-06-19 12:40:58,REAL,2916498423,482,2916498905,2947604200
2025-06-19 12:41:00,FAKE,2916498905,244,2916499149,2947604684
2025-06-19 12:41:02,FAKE,2916499149,238,2916499387,2947605224
2025-06-19 12:41:04,REAL,2916499387,540,2916499927,2947605764
2025-06-19 12:41:06,REAL,2916499927,491,2916500418,2947606255
2025-06-19 12:41:08,REAL,2916500418,482,2916500900,2947606737
2025-06-19 12:41:10,FAKE,2916500900,241,2916501141,2947607220
2025-06-19 12:41:12,FAKE,2916501141,244,2916501385,2947607699
2025-06-19 12:41:14,REAL,2916501385,492,2916501877,2947608191
2025-06-19 12:41:16,REAL,2916501877,488,2916502365,2947608679
2025-06-19 12:41:18,REAL,2916502365,482,2916502847,2947609161
2025-06-19 12:41:20,FAKE,2916502847,243,2916503090,2947609644
2025-06-19 12:41:22,FAKE,2916503090,244,2916503334,2947610122
2025-06-19 12:41:24,REAL,2916503334,486,2916503820,2947610608
2025-06-19 12:41:26,FAKE,2916503820,243,2916504063,2947611087
2025-06-19 12:41:28,REAL,2916504063,484,2916504547,2947611571
2025-06-19 12:41:30,FAKE,2916504547,241,2916504788,2947612059
2025-06-19 12:41:32,FAKE,2916504788,241,2916505029,2947612538
2025-06-19 12:41:34,FAKE,2916505029,243,2916505272,2947613024
2025-06-19 12:41:36,REAL,2916505272,484,2916505756,2947613508
2025-06-19 12:41:38,REAL,2916505756,541,2916506297,2947614049
2025-06-19 12:41:40,REAL,2916506297,492,2916506789,2947614541
2025-06-19 12:41:42,REAL,2916506789,547,2916507336,2947615088
2025-06-19 12:41:44,FAKE,2916507336,243,2916507579,2947615571
2025-06-19 12:41:46,REAL,2916507579,483,2916508062,2947616054
2025-06-19 12:41:48,REAL,2916508062,482,2916508544,2947616536
2025-06-19 12:41:50,FAKE,2916508544,244,2916508788,2947617025
2025-06-19 12:41:52,FAKE,2916508788,244,2916509032,2947617502
2025-06-19 12:41:54,REAL,2916509032,477,2916509509,2947617979
2025-06-19 12:41:56,REAL,2916509509,487,2916509996,2947618466
2025-06-19 12:41:58,FAKE,2916509996,244,2916510240,2947618955
2025-06-19 12:42:00,FAKE,2916510240,244,2916510484,2947619448
2025-06-19 12:42:02,REAL,2916510484,479,2916510963,2947619927
2025-06-19 12:42:04,REAL,2916510963,481,2916511444,2947620408
2025-06-19 12:42:06,REAL,2916511444,476,2916511920,2947620884
2025-06-19 12:42:08,REAL,2916511920,482,2916512402,2947621366
2025-06-19 12:42:10,FAKE,2916512402,238,2916512640,2947621848
2025-06-19 12:42:12,REAL,2916512640,534,2916513174,2947622382
2025-06-19 12:42:14,FAKE,2916513174,241,2916513415,2947622872
2025-06-19 12:42:16,FAKE,2916513415,244,2916513659,2947634660
2025-06-19 12:42:18,REAL,2916513659,11642,2916525301,2947646302
2025-06-19 12:42:20,REAL,2916525301,10248,2916535549,2947656550
2025-06-19 12:42:22,REAL,2916535549,10010,2916545559,2947666560
2025-06-19 12:42:24,REAL,2916545559,10316,2916555875,2947676876
2025-06-19 12:42:26,FAKE,2916555875,238,2916556113,2947687124
2025-06-19 12:42:28,REAL,2916556113,10259,2916566372,2947697383
2025-06-19 12:42:30,REAL,2916566372,7351,2916573723,2947704734
2025-06-19 12:42:32,REAL,2916573723,479,2916574202,2947705213
2025-06-19 12:42:34,REAL,2916574202,542,2916574744,2947705755
2025-06-19 12:42:36,REAL,2916574744,481,2916575225,2947706236
2025-06-19 12:42:38,FAKE,2916575225,241,2916575466,2947706710
2025-06-19 12:42:40,REAL,2916575466,492,2916575958,2947707202
2025-06-19 12:42:42,FAKE,2916575958,243,2916576201,2947707686
2025-06-19 12:42:44,FAKE,2916576201,243,2916576444,2947708168
2025-06-19 12:42:46,FAKE,2916576444,238,2916576682,2947708652
2025-06-19 12:42:48,FAKE,2916576682,238,2916576920,2947719253
2025-06-19 12:42:50,FAKE,2916576920,244,2916577164,2947729642
2025-06-19 12:42:52,REAL,2916577164,10243,2916587407,2947739885
2025-06-19 12:42:54,REAL,2916587407,10255,2916597662,2947750140
2025-06-19 12:42:56,REAL,2916597662,10321,2916607983,2947760461
2025-06-19 12:42:58,REAL,2916607983,10314,2916618297,2947770775
2025-06-19 12:43:00,REAL,2916618297,10321,2916628618,2947781096
2025-06-19 12:43:02,REAL,2916628618,6620,2916635238,2947787716
2025-06-19 12:43:04,REAL,2916635238,481,2916635719,2947788197
2025-06-19 12:43:06,REAL,2916635719,488,2916636207,2947788685
2025-06-19 12:43:08,REAL,2916636207,480,2916636687,2947789165
2025-06-19 12:43:10,REAL,2916636687,493,2916637180,2947789658
2025-06-19 12:43:12,REAL,2916637180,483,2916637663,2947790141
2025-06-19 12:43:14,REAL,2916637663,485,2916638148,2947790626
2025-06-19 12:43:16,REAL,2916638148,479,2916638627,2947791105
2025-06-19 12:43:18,FAKE,2916638627,243,2916638870,2947791589
2025-06-19 12:43:20,REAL,2916638870,11988,2916650858,2947803577
2025-06-19 12:43:22,REAL,2916650858,10247,2916661105,2947813824
2025-06-19 12:43:24,REAL,2916661105,10250,2916671355,2947824074
2025-06-19 12:43:26,FAKE,2916671355,238,2916671593,2947834325
2025-06-19 12:43:28,REAL,2916671593,10249,2916681842,2947844574
2025-06-19 12:43:30,FAKE,2916681842,244,2916682086,2947854824
2025-06-19 12:43:32,FAKE,2916682086,238,2916682324,2947865145
2025-06-19 12:43:34,FAKE,2916682324,243,2916682567,2947871171
2025-06-19 12:43:36,REAL,2916682567,483,2916683050,2947871654
2025-06-19 12:43:38,REAL,2916683050,476,2916683526,2947872130
2025-06-19 12:43:40,REAL,2916683526,483,2916684009,2947872613
2025-06-19 12:43:42,REAL,2916684009,544,2916684553,2947873157
2025-06-19 12:43:44,REAL,2916684553,488,2916685041,2947873645
2025-06-19 12:43:46,REAL,2916685041,488,2916685529,2947874133
2025-06-19 12:43:48,REAL,2916685529,476,2916686005,2947874609
2025-06-19 12:43:50,FAKE,2916686005,241,2916686246,2947875099
2025-06-19 12:43:52,FAKE,2916686246,241,2916686487,2947887220
2025-06-19 12:43:54,FAKE,2916686487,238,2916686725,2947897475
2025-06-19 12:43:56,REAL,2916686725,10252,2916696977,2947907727
2025-06-19 12:43:58,REAL,2916696977,10310,2916707287,2947918037
2025-06-19 12:44:00,REAL,2916707287,10259,2916717546,2947928296
2025-06-19 12:44:02,REAL,2916717546,10249,2916727795,2947938545
2025-06-19 12:44:04,FAKE,2916727795,241,2916728036,2947948849
2025-06-19 12:44:06,REAL,2916728036,5431,2916733467,2947954280
2025-06-19 12:44:08,FAKE,2916733467,243,2916733710,2947954760
2025-06-19 12:44:10,REAL,2916733710,494,2916734204,2947955254
2025-06-19 12:44:12,REAL,2916734204,480,2916734684,2947955734
2025-06-19 12:44:14,FAKE,2916734684,243,2916734927,2947956223
2025-06-19 12:44:16,FAKE,2916734927,238,2916735165,2947956717
2025-06-19 12:44:18,REAL,2916735165,476,2916735641,2947957193
2025-06-19 12:44:20,REAL,2916735641,487,2916736128,2947957680
2025-06-19 12:44:22,REAL,2916736128,759,2916736887,2947958439
2025-06-19 12:44:24,REAL,2916736887,12314,2916749201,2947970753
2025-06-19 12:44:26,FAKE,2916749201,241,2916749442,2947981005
2025-06-19 12:44:28,REAL,2916749442,10306,2916759748,2947991311
2025-06-19 12:44:30,FAKE,2916759748,241,2916759989,2948001568
2025-06-19 12:44:32,REAL,2916759989,10252,2916770241,2948011820
2025-06-19 12:44:34,FAKE,2916770241,243,2916770484,2948022070
2025-06-19 12:44:36,FAKE,2916770484,238,2916770722,2948032327
2025-06-19 12:44:38,FAKE,2916770722,241,2916770963,2948037099
2025-06-19 12:44:40,REAL,2916770963,489,2916771452,2948037588
2025-06-19 12:44:42,REAL,2916771452,482,2916771934,2948038070
2025-06-19 12:44:44,REAL,2916771934,487,2916772421,2948038557
2025-06-19 12:44:46,REAL,2916772421,479,2916772900,2948039036
2025-06-19 12:44:48,FAKE,2916772900,241,2916773141,2948039516
2025-06-19 12:44:50,REAL,2916773141,547,2916773688,2948040063
2025-06-19 12:44:52,FAKE,2916773688,244,2916773932,2948040548
2025-06-19 12:44:54,FAKE,2916773932,243,2916774175,2948041023
2025-06-19 12:44:56,FAKE,2916774175,241,2916774416,2948041506
2025-06-19 12:44:58,FAKE,2916774416,243,2916774659,2948041997
2025-06-19 12:45:00,REAL,2916774659,545,2916775204,2948042542
2025-06-19 12:45:02,REAL,2916775204,484,2916775688,2948043026
2025-06-19 12:45:04,REAL,2916775688,478,2916776166,2948043504
2025-06-19 12:45:06,REAL,2916776166,482,2916776648,2948043986
2025-06-19 12:45:08,REAL,2916776648,485,2916777133,2948044471
2025-06-19 12:45:10,FAKE,2916777133,244,2916777377,2948044954
2025-06-19 12:45:12,REAL,2916777377,537,2916777914,2948045491
2025-06-19 12:45:14,FAKE,2916777914,243,2916778157,2948045970
2025-06-19 12:45:16,FAKE,2916778157,243,2916778400,2948046450
2025-06-19 12:45:18,REAL,2916778400,489,2916778889,2948046939
2025-06-19 12:45:20,FAKE,2916778889,243,2916779132,2948047428
2025-06-19 12:45:22,FAKE,2916779132,243,2916779375,2948047906
2025-06-19 12:45:24,REAL,2916779375,490,2916779865,2948048396
2025-06-19 12:45:26,REAL,2916779865,492,2916780357,2948048888
2025-06-19 12:45:28,REAL,2916780357,492,2916780849,2948049380
2025-06-19 12:45:30,FAKE,2916780849,243,2916781092,2948049867
2025-06-19 12:45:32,REAL,2916781092,479,2916781571,2948050346
2025-06-19 12:45:34,REAL,2916781571,594,2916782165,2948050940
2025-06-19 12:45:36,REAL,2916782165,478,2916782643,2948051418
2025-06-19 12:45:38,REAL,2916782643,491,2916783134,2948051909
2025-06-19 12:45:40,REAL,2916783134,487,2916783621,2948052396
2025-06-19 12:45:42,REAL,2916783621,491,2916784112,2948052887
2025-06-19 12:45:44,FAKE,2916784112,241,2916784353,2948053374
2025-06-19 12:45:46,FAKE,2916784353,238,2916784591,2948053865
2025-06-19 12:45:48,FAKE,2916784591,244,2916784835,2948054347
2025-06-19 12:45:50,REAL,2916784835,487,2916785322,2948054834
2025-06-19 12:45:52,REAL,2916785322,3058,2916788380,2948057892
2025-06-19 12:45:54,FAKE,2916788380,238,2916788618,2948069401
2025-06-19 12:45:56,REAL,2916788618,10323,2916798941,2948079724
2025-06-19 12:45:58,REAL,2916798941,10306,2916809247,2948090030
2025-06-19 12:46:00,REAL,2916809247,10257,2916819504,2948100287
2025-06-19 12:46:02,FAKE,2916819504,244,2916819748,2948110608
2025-06-19 12:46:04,REAL,2916819748,10260,2916830008,2948120868
2025-06-19 12:46:06,FAKE,2916830008,241,2916830249,2948131191
2025-06-19 12:46:08,FAKE,2916830249,244,2916830493,2948134515
2025-06-19 12:46:10,REAL,2916830493,486,2916830979,2948135001
2025-06-19 12:46:12,REAL,2916830979,487,2916831466,2948135488
2025-06-19 12:46:14,REAL,2916831466,483,2916831949,2948135971
2025-06-19 12:46:16,REAL,2916831949,489,2916832438,2948136460
2025-06-19 12:46:18,FAKE,2916832438,241,2916832679,2948136953
2025-06-19 12:46:20,REAL,2916832679,538,2916833217,2948137491
2025-06-19 12:46:22,REAL,2916833217,487,2916833704,2948137978
2025-06-19 12:46:24,FAKE,2916833704,243,2916833947,2948138456
2025-06-19 12:46:26,FAKE,2916833947,243,2916834190,2948138943
2025-06-19 12:46:28,REAL,2916834190,538,2916834728,2948139481
2025-06-19 12:46:30,REAL,2916834728,478,2916835206,2948139959
2025-06-19 12:46:32,REAL,2916835206,484,2916835690,2948140443
2025-06-19 12:46:34,FAKE,2916835690,243,2916835933,2948140922
2025-06-19 12:46:36,REAL,2916835933,483,2916836416,2948141405
2025-06-19 12:46:38,REAL,2916836416,481,2916836897,2948141886
2025-06-19 12:46:40,FAKE,2916836897,243,2916837140,2948142360
2025-06-19 12:46:42,REAL,2916837140,547,2916837687,2948142907
2025-06-19 12:46:44,REAL,2916837687,481,2916838168,2948143388
2025-06-19 12:46:46,REAL,2916838168,487,2916838655,2948143875
2025-06-19 12:46:48,REAL,2916838655,483,2916839138,2948144358
2025-06-19 12:46:50,REAL,2916839138,486,2916839624,2948144844
2025-06-19 12:46:52,FAKE,2916839624,241,2916839865,2948145324
2025-06-19 12:46:54,REAL,2916839865,475,2916840340,2948145799
2025-06-19 12:46:56,FAKE,2916840340,241,2916840581,2948146281
2025-06-19 12:46:58,FAKE,2916840581,244,2916840825,2948146760
2025-06-19 12:47:00,REAL,2916840825,486,2916841311,2948147246
2025-06-19 12:47:02,REAL,2916841311,540,2916841851,2948147786
2025-06-19 12:47:04,FAKE,2916841851,238,2916842089,2948148267
2025-06-19 12:47:06,REAL,2916842089,4314,2916846403,2948152581
2025-06-19 12:47:08,REAL,2916846403,13759,2916860162,2948166340
2025-06-19 12:47:10,REAL,2916860162,10323,2916870485,2948176663
2025-06-19 12:47:12,REAL,2916870485,10242,2916880727,2948186905
2025-06-19 12:47:14,REAL,2916880727,10254,2916890981,2948197159
2025-06-19 12:47:16,REAL,2916890981,10319,2916901300,2948207478
2025-06-19 12:47:18,REAL,2916901300,10249,2916911549,2948217727
2025-06-19 12:47:20,REAL,2916911549,10313,2916921862,2948228040
2025-06-19 12:47:22,REAL,2916921862,1931,2916923793,2948229971
2025-06-19 12:47:24,FAKE,2916923793,244,2916924037,2948230445
2025-06-19 12:47:26,REAL,2916924037,485,2916924522,2948230930
2025-06-19 12:47:28,REAL,2916924522,13635,2916938157,2948244565
2025-06-19 12:47:30,REAL,2916938157,10516,2916948673,2948255081
2025-06-19 12:47:32,REAL,2916948673,10319,2916958992,2948265400
2025-06-19 12:47:34,REAL,2916958992,10253,2916969245,2948275653
2025-06-19 12:47:36,REAL,2916969245,10325,2916979570,2948285978
2025-06-19 12:47:38,REAL,2916979570,10247,2916989817,2948296225
2025-06-19 12:47:40,REAL,2916989817,10244,2917000061,2948306469
2025-06-19 12:47:42,REAL,2917000061,6553,2917006614,2948313022
2025-06-19 12:47:44,FAKE,2917006614,241,2917006855,2948313506
2025-06-19 12:47:46,REAL,2917006855,482,2917007337,2948313988
2025-06-19 12:47:48,REAL,2917007337,489,2917007826,2948314477
2025-06-19 12:47:50,REAL,2917007826,475,2917008301,2948314952
2025-06-19 12:47:52,REAL,2917008301,483,2917008784,2948315435
2025-06-19 12:47:54,FAKE,2917008784,238,2917009022,2948315916
2025-06-19 12:47:56,REAL,2917009022,489,2917009511,2948316405
2025-06-19 12:47:58,FAKE,2917009511,238,2917009749,2948316891
2025-06-19 12:48:00,REAL,2917009749,492,2917010241,2948317383
2025-06-19 12:48:02,REAL,2917010241,482,2917010723,2948317865
2025-06-19 12:48:04,REAL,2917010723,533,2917011256,2948318398
2025-06-19 12:48:06,REAL,2917011256,492,2917011748,2948318890
2025-06-19 12:48:08,REAL,2917011748,482,2917012230,2948319372
2025-06-19 12:48:10,FAKE,2917012230,241,2917012471,2948319853
2025-06-19 12:48:12,REAL,2917012471,539,2917013010,2948320392
2025-06-19 12:48:14,REAL,2917013010,487,2917013497,2948320879
2025-06-19 12:48:16,REAL,2917013497,492,2917013989,2948321371
2025-06-19 12:48:18,FAKE,2917013989,238,2917014227,2948321861
2025-06-19 12:48:20,FAKE,2917014227,243,2917014470,2948322347
2025-06-19 12:48:22,FAKE,2917014470,244,2917014714,2948322831
2025-06-19 12:48:24,REAL,2917014714,488,2917015202,2948323319
2025-06-19 12:48:26,REAL,2917015202,476,2917015678,2948323795
2025-06-19 12:48:28,FAKE,2917015678,238,2917015916,2948324278
2025-06-19 12:48:30,FAKE,2917015916,238,2917016154,2948324763
2025-06-19 12:48:32,REAL,2917016154,479,2917016633,2948325242
2025-06-19 12:48:34,REAL,2917016633,482,2917017115,2948325724
2025-06-19 12:48:36,REAL,2917017115,6829,2917023944,2948332553
2025-06-19 12:48:38,REAL,2917023944,13576,2917037520,2948346129
2025-06-19 12:48:40,REAL,2917037520,10315,2917047835,2948356444
2025-06-19 12:48:42,REAL,2917047835,10254,2917058089,2948366698
2025-06-19 12:48:44,REAL,2917058089,10253,2917068342,2948376951
2025-06-19 12:48:46,REAL,2917068342,10253,2917078595,2948387204
2025-06-19 12:48:48,FAKE,2917078595,241,2917078836,2948397516
2025-06-19 12:48:50,REAL,2917078836,10257,2917089093,2948407773
2025-06-19 12:48:52,FAKE,2917089093,244,2917089337,2948408262
2025-06-19 12:48:54,REAL,2917089337,480,2917089817,2948408742
2025-06-19 12:48:56,FAKE,2917089817,243,2917090060,2948409305
2025-06-19 12:48:58,REAL,2917090060,16583,2917106643,2948425888
2025-06-19 12:49:00,REAL,2917106643,10257,2917116900,2948436145
2025-06-19 12:49:02,REAL,2917116900,10256,2917127156,2948446401
2025-06-19 12:49:04,FAKE,2917127156,241,2917127397,2948456650
2025-06-19 12:49:06,FAKE,2917127397,244,2917127641,2948466971
2025-06-19 12:49:08,FAKE,2917127641,243,2917127884,2948477224
2025-06-19 12:49:10,REAL,2917127884,10242,2917138126,2948487466
2025-06-19 12:49:12,FAKE,2917138126,243,2917138369,2948492501
2025-06-19 12:49:14,REAL,2917138369,478,2917138847,2948492979
2025-06-19 12:49:16,REAL,2917138847,479,2917139326,2948493458
2025-06-19 12:49:18,FAKE,2917139326,241,2917139567,2948493943
2025-06-19 12:49:20,REAL,2917139567,486,2917140053,2948494429
2025-06-19 12:49:22,FAKE,2917140053,244,2917140297,2948494919
2025-06-19 12:49:24,FAKE,2917140297,241,2917140538,2948495397
2025-06-19 12:49:26,REAL,2917140538,485,2917141023,2948495882
2025-06-19 12:49:28,REAL,2917141023,1410,2917142433,2948497292
2025-06-19 12:49:30,FAKE,2917142433,241,2917142674,2948508732
2025-06-19 12:49:32,REAL,2917142674,10256,2917152930,2948518988
2025-06-19 12:49:34,FAKE,2917152930,241,2917153171,2948529306
2025-06-19 12:49:36,REAL,2917153171,10258,2917163429,2948539564
2025-06-19 12:49:38,REAL,2917163429,10316,2917173745,2948549880
2025-06-19 12:49:40,FAKE,2917173745,238,2917173983,2948560126
2025-06-19 12:49:42,REAL,2917173983,10703,2917184686,2948570829
2025-06-19 12:49:44,FAKE,2917184686,241,2917184927,2948574873
2025-06-19 12:49:46,REAL,2917184927,489,2917185416,2948575362
2025-06-19 12:49:48,REAL,2917185416,482,2917185898,2948575844
2025-06-19 12:49:50,FAKE,2917185898,244,2917186142,2948576383
2025-06-19 12:49:52,REAL,2917186142,483,2917186625,2948576866
2025-06-19 12:49:54,FAKE,2917186625,238,2917186863,2948577348
2025-06-19 12:49:56,REAL,2917186863,480,2917187343,2948577828
2025-06-19 12:49:58,REAL,2917187343,485,2917187828,2948578313
2025-06-19 12:50:00,REAL,2917187828,491,2917188319,2948578804
2025-06-19 12:50:02,REAL,2917188319,478,2917188797,2948579282
2025-06-19 12:50:04,REAL,2917188797,484,2917189281,2948579766
2025-06-19 12:50:06,REAL,2917189281,9215,2917198496,2948588981
2025-06-19 12:50:08,REAL,2917198496,10656,2917209152,2948599637
2025-06-19 12:50:10,REAL,2917209152,10322,2917219474,2948609959
2025-06-19 12:50:12,REAL,2917219474,10253,2917229727,2948620212
2025-06-19 12:50:14,FAKE,2917229727,243,2917229970,2948630467
2025-06-19 12:50:16,FAKE,2917229970,244,2917230214,2948640787
2025-06-19 12:50:18,FAKE,2917230214,238,2917230452,2948651035
2025-06-19 12:50:20,REAL,2917230452,8666,2917239118,2948659701
2025-06-19 12:50:22,FAKE,2917239118,238,2917239356,2948660192
2025-06-19 12:50:24,REAL,2917239356,480,2917239836,2948660672
2025-06-19 12:50:26,REAL,2917239836,484,2917240320,2948661156
2025-06-19 12:50:28,FAKE,2917240320,238,2917240558,2948661747
2025-06-19 12:50:30,REAL,2917240558,486,2917241044,2948662233
2025-06-19 12:50:32,REAL,2917241044,482,2917241526,2948662715
2025-06-19 12:50:34,FAKE,2917241526,243,2917241769,2948663197
2025-06-19 12:50:36,REAL,2917241769,485,2917242254,2948663682
2025-06-19 12:50:38,FAKE,2917242254,244,2917242498,2948664161
2025-06-19 12:50:40,FAKE,2917242498,244,2917242742,2948664637
2025-06-19 12:50:42,REAL,2917242742,488,2917243230,2948665125
2025-06-19 12:50:44,REAL,2917243230,493,2917243723,2948665618
2025-06-19 12:50:46,REAL,2917243723,480,2917244203,2948666098
2025-06-19 12:50:48,FAKE,2917244203,244,2917244447,2948666635
2025-06-19 12:50:50,REAL,2917244447,481,2917244928,2948667116
2025-06-19 12:50:52,REAL,2917244928,485,2917245413,2948667601
2025-06-19 12:50:54,REAL,2917245413,488,2917245901,2948668089
2025-06-19 12:50:56,FAKE,2917245901,238,2917246139,2948668573
2025-06-19 12:50:58,REAL,2917246139,485,2917246624,2948669058
2025-06-19 12:51:00,FAKE,2917246624,238,2917246862,2948669542
2025-06-19 12:51:02,REAL,2917246862,484,2917247346,2948670026
2025-06-19 12:51:04,FAKE,2917247346,238,2917247584,2948670507
2025-06-19 12:51:06,REAL,2917247584,485,2917248069,2948670992
2025-06-19 12:51:08,REAL,2917248069,482,2917248551,2948671474
2025-06-19 12:51:10,FAKE,2917248551,238,2917248789,2948672014
2025-06-19 12:51:12,REAL,2917248789,543,2917249332,2948672557
2025-06-19 12:51:14,REAL,2917249332,485,2917249817,2948673042
2025-06-19 12:51:16,FAKE,2917249817,244,2917250061,2948673529
2025-06-19 12:51:18,FAKE,2917250061,238,2917250299,2948674020
2025-06-19 12:51:20,REAL,2917250299,490,2917250789,2948674510
2025-06-19 12:51:22,FAKE,2917250789,244,2917251033,2948674998
2025-06-19 12:51:24,REAL,2917251033,3990,2917255023,2948678988
2025-06-19 12:51:26,REAL,2917255023,14536,2917269559,2948693524
2025-06-19 12:51:28,FAKE,2917269559,238,2917269797,2948703778
2025-06-19 12:51:30,REAL,2917269797,10262,2917280059,2948714040
2025-06-19 12:51:32,FAKE,2917280059,243,2917280302,2948724366
2025-06-19 12:51:34,REAL,2917280302,10254,2917290556,2948734620
2025-06-19 12:51:36,FAKE,2917290556,241,2917290797,2948744872
2025-06-19 12:51:38,REAL,2917290797,10319,2917301116,2948755191
2025-06-19 12:51:40,REAL,2917301116,2530,2917303646,2948757721
2025-06-19 12:51:42,REAL,2917303646,483,2917304129,2948758204
2025-06-19 12:51:44,REAL,2917304129,480,2917304609,2948758684
2025-06-19 12:51:46,REAL,2917304609,537,2917305146,2948759221
2025-06-19 12:51:48,FAKE,2917305146,244,2917305390,2948759709
2025-06-19 12:51:50,REAL,2917305390,476,2917305866,2948760185
2025-06-19 12:51:52,REAL,2917305866,494,2917306360,2948760679
2025-06-19 12:51:54,REAL,2917306360,483,2917306843,2948761162
2025-06-19 12:51:56,FAKE,2917306843,238,2917307081,2948761642
2025-06-19 12:51:58,REAL,2917307081,536,2917307617,2948762178
2025-06-19 12:52:00,FAKE,2917307617,238,2917307855,2948762671
2025-06-19 12:52:02,REAL,2917307855,481,2917308336,2948763152
2025-06-19 12:52:04,REAL,2917308336,488,2917308824,2948763640
2025-06-19 12:52:06,REAL,2917308824,543,2917309367,2948764183
2025-06-19 12:52:08,REAL,2917309367,479,2917309846,2948764662
2025-06-19 12:52:10,FAKE,2917309846,244,2917310090,2948765147
2025-06-19 12:52:12,REAL,2917310090,482,2917310572,2948765629
2025-06-19 12:52:14,FAKE,2917310572,243,2917310815,2948766113
2025-06-19 12:52:16,REAL,2917310815,483,2917311298,2948766596
2025-06-19 12:52:18,REAL,2917311298,481,2917311779,2948767077
2025-06-19 12:52:20,REAL,2917311779,480,2917312259,2948767557
2025-06-19 12:52:22,REAL,2917312259,489,2917312748,2948768046
2025-06-19 12:52:24,REAL,2917312748,484,2917313232,2948768530
2025-06-19 12:52:26,REAL,2917313232,488,2917313720,2948769018
2025-06-19 12:52:28,FAKE,2917313720,243,2917313963,2948774124
2025-06-19 12:52:30,REAL,2917313963,11244,2917325207,2948785368
2025-06-19 12:52:32,REAL,2917325207,10314,2917335521,2948795682
2025-06-19 12:52:34,REAL,2917335521,10254,2917345775,2948805936
2025-06-19 12:52:36,REAL,2917345775,10317,2917356092,2948816253
2025-06-19 12:52:38,REAL,2917356092,10249,2917366341,2948826502
2025-06-19 12:52:40,REAL,2917366341,10311,2917376652,2948836813
2025-06-19 12:52:42,REAL,2917376652,10309,2917386961,2948847122
2025-06-19 12:52:44,REAL,2917386961,1273,2917388234,2948848395
2025-06-19 12:52:46,REAL,2917388234,479,2917388713,2948848874
2025-06-19 12:52:48,REAL,2917388713,487,2917389200,2948849361
2025-06-19 12:52:50,REAL,2917389200,537,2917389737,2948849898
2025-06-19 12:52:52,REAL,2917389737,484,2917390221,2948850382
2025-06-19 12:52:54,REAL,2917390221,486,2917390707,2948850868
2025-06-19 12:52:56,REAL,2917390707,488,2917391195,2948851356
2025-06-19 12:52:58,REAL,2917391195,488,2917391683,2948851844
2025-06-19 12:53:00,REAL,2917391683,6427,2917398110,2948858271
2025-06-19 12:53:02,FAKE,2917398110,244,2917398354,2948869509
2025-06-19 12:53:04,FAKE,2917398354,241,2917398595,2948879832
2025-06-19 12:53:06,REAL,2917398595,10250,2917408845,2948890082
2025-06-19 12:53:08,REAL,2917408845,10323,2917419168,2948900405
2025-06-19 12:53:10,REAL,2917419168,10254,2917429422,2948910659
2025-06-19 12:53:12,REAL,2917429422,10257,2917439679,2948920916
2025-06-19 12:53:14,REAL,2917439679,10318,2917449997,2948931234
2025-06-19 12:53:16,REAL,2917449997,679,2917450676,2948931913
2025-06-19 12:53:18,FAKE,2917450676,244,2917450920,2948932404
2025-06-19 12:53:20,REAL,2917450920,481,2917451401,2948932885
2025-06-19 12:53:22,REAL,2917451401,535,2917451936,2948933420
2025-06-19 12:53:24,FAKE,2917451936,244,2917452180,2948933904
2025-06-19 12:53:26,REAL,2917452180,486,2917452666,2948934390
2025-06-19 12:53:28,FAKE,2917452666,243,2917452909,2948934925
2025-06-19 12:53:30,REAL,2917452909,478,2917453387,2948935403
2025-06-19 12:53:32,FAKE,2917453387,241,2917453628,2948942241
2025-06-19 12:53:34,FAKE,2917453628,244,2917453872,2948952766
2025-06-19 12:53:36,FAKE,2917453872,238,2917454110,2948963086
2025-06-19 12:53:38,REAL,2917454110,10323,2917464433,2948973409
2025-06-19 12:53:40,FAKE,2917464433,243,2917464676,2948983658
2025-06-19 12:53:42,REAL,2917464676,10314,2917474990,2948993972
2025-06-19 12:53:44,REAL,2917474990,10708,2917485698,2949004680
2025-06-19 12:53:46,REAL,2917485698,9332,2917495030,2949014012
2025-06-19 12:53:48,REAL,2917495030,475,2917495505,2949014487
2025-06-19 12:53:50,REAL,2917495505,484,2917495989,2949014971
2025-06-19 12:53:52,FAKE,2917495989,243,2917496232,2949016111
2025-06-19 12:53:54,REAL,2917496232,11972,2917508204,2949028083
2025-06-19 12:53:56,FAKE,2917508204,238,2917508442,2949038337
2025-06-19 12:53:58,REAL,2917508442,10324,2917518766,2949048661
2025-06-19 12:54:00,FAKE,2917518766,241,2917519007,2949058978
2025-06-19 12:54:02,REAL,2917519007,10250,2917529257,2949069228
2025-06-19 12:54:04,REAL,2917529257,10320,2917539577,2949079548
2025-06-19 12:54:06,FAKE,2917539577,244,2917539821,2949089795
2025-06-19 12:54:08,FAKE,2917539821,241,2917540062,2949094369
2025-06-19 12:54:10,REAL,2917540062,478,2917540540,2949094847
2025-06-19 12:54:12,REAL,2917540540,546,2917541086,2949095393
2025-06-19 12:54:14,REAL,2917541086,534,2917541620,2949095927
2025-06-19 12:54:16,REAL,2917541620,477,2917542097,2949096404
2025-06-19 12:54:18,FAKE,2917542097,238,2917542335,2949096889
2025-06-19 12:54:20,FAKE,2917542335,243,2917542578,2949097379
2025-06-19 12:54:22,REAL,2917542578,485,2917543063,2949097864
2025-06-19 12:54:24,REAL,2917543063,486,2917543549,2949098350
2025-06-19 12:54:26,FAKE,2917543549,241,2917543790,2949098840
2025-06-19 12:54:28,FAKE,2917543790,241,2917544031,2949099322
2025-06-19 12:54:30,REAL,2917544031,489,2917544520,2949099811
2025-06-19 12:54:32,REAL,2917544520,478,2917544998,2949100289
2025-06-19 12:54:34,REAL,2917544998,475,2917545473,2949100764
2025-06-19 12:54:36,REAL,2917545473,490,2917545963,2949101254
2025-06-19 12:54:38,FAKE,2917545963,243,2917546206,2949101742
2025-06-19 12:54:40,REAL,2917546206,478,2917546684,2949102220
2025-06-19 12:54:42,FAKE,2917546684,241,2917546925,2949102704
2025-06-19 12:54:44,FAKE,2917546925,238,2917547163,2949103248
2025-06-19 12:54:46,FAKE,2917547163,244,2917547407,2949111519
2025-06-19 12:54:48,FAKE,2917547407,243,2917547650,2949122360
2025-06-19 12:54:50,REAL,2917547650,10253,2917557903,2949132613
2025-06-19 12:54:52,REAL,2917557903,10247,2917568150,2949142860
2025-06-19 12:54:54,REAL,2917568150,10319,2917578469,2949153179
2025-06-19 12:54:56,REAL,2917578469,10253,2917588722,2949163432
2025-06-19 12:54:58,FAKE,2917588722,241,2917588963,2949173736
2025-06-19 12:55:00,REAL,2917588963,8470,2917597433,2949182206
2025-06-19 12:55:02,FAKE,2917597433,244,2917597677,2949182695
2025-06-19 12:55:04,REAL,2917597677,479,2917598156,2949183174
2025-06-19 12:55:06,REAL,2917598156,485,2917598641,2949183659
2025-06-19 12:55:08,REAL,2917598641,491,2917599132,2949184150
2025-06-19 12:55:10,REAL,2917599132,481,2917599613,2949184631
2025-06-19 12:55:12,REAL,2917599613,482,2917600095,2949185113
2025-06-19 12:55:14,REAL,2917600095,484,2917600579,2949185597
2025-06-19 12:55:16,REAL,2917600579,538,2917601117,2949186135
2025-06-19 12:55:18,REAL,2917601117,485,2917601602,2949186620
2025-06-19 12:55:20,FAKE,2917601602,243,2917601845,2949187107
2025-06-19 12:55:22,FAKE,2917601845,241,2917602086,2949187585
2025-06-19 12:55:24,REAL,2917602086,487,2917602573,2949188072
2025-06-19 12:55:26,REAL,2917602573,477,2917603050,2949188549
2025-06-19 12:55:28,REAL,2917603050,491,2917603541,2949189040
2025-06-19 12:55:30,REAL,2917603541,482,2917604023,2949189522
2025-06-19 12:55:32,REAL,2917604023,474,2917604497,2949189996
2025-06-19 12:55:34,REAL,2917604497,478,2917604975,2949190474
2025-06-19 12:55:36,FAKE,2917604975,241,2917605216,2949190950
2025-06-19 12:55:38,FAKE,2917605216,244,2917605460,2949191427
2025-06-19 12:55:40,FAKE,2917605460,243,2917605703,2949191911
2025-06-19 12:55:42,FAKE,2917605703,244,2917605947,2949192448
2025-06-19 12:55:44,REAL,2917605947,487,2917606434,2949192935
2025-06-19 12:55:46,REAL,2917606434,545,2917606979,2949193480
2025-06-19 12:55:48,FAKE,2917606979,238,2917607217,2949193964
2025-06-19 12:55:50,REAL,2917607217,486,2917607703,2949194450
2025-06-19 12:55:52,REAL,2917607703,485,2917608188,2949194935
2025-06-19 12:55:54,REAL,2917608188,484,2917608672,2949195419
2025-06-19 12:55:56,FAKE,2917608672,241,2917608913,2949195897
2025-06-19 12:55:58,REAL,2917608913,486,2917609399,2949196383
2025-06-19 12:56:00,REAL,2917609399,480,2917609879,2949196863
2025-06-19 12:56:02,FAKE,2917609879,244,2917610123,2949197423
2025-06-19 12:56:04,REAL,2917610123,487,2917610610,2949197910
2025-06-19 12:56:06,FAKE,2917610610,244,2917610854,2949198394
2025-06-19 12:56:08,REAL,2917610854,484,2917611338,2949198878
2025-06-19 12:56:10,FAKE,2917611338,241,2917611579,2949199357
2025-06-19 12:56:12,FAKE,2917611579,243,2917611822,2949199847
2025-06-19 12:56:14,REAL,2917611822,477,2917612299,2949200324
2025-06-19 12:56:16,REAL,2917612299,477,2917612776,2949200801
2025-06-19 12:56:18,REAL,2917612776,545,2917613321,2949201346
2025-06-19 12:56:20,REAL,2917613321,486,2917613807,2949201832
2025-06-19 12:56:22,REAL,2917613807,483,2917614290,2949202315
2025-06-19 12:56:24,REAL,2917614290,479,2917614769,2949202794
2025-06-19 12:56:26,REAL,2917614769,487,2917615256,2949203281
2025-06-19 12:56:28,REAL,2917615256,546,2917615802,2949203827
2025-06-19 12:56:30,REAL,2917615802,486,2917616288,2949204313
2025-06-19 12:56:32,REAL,2917616288,479,2917616767,2949204792
2025-06-19 12:56:34,REAL,2917616767,487,2917617254,2949205279
2025-06-19 12:56:36,REAL,2917617254,485,2917617739,2949205764
2025-06-19 12:56:38,REAL,2917617739,486,2917618225,2949206250
2025-06-19 12:56:40,REAL,2917618225,484,2917618709,2949206734
2025-06-19 12:56:42,FAKE,2917618709,243,2917618952,2949207219
2025-06-19 12:56:44,REAL,2917618952,477,2917619429,2949207696
2025-06-19 12:56:46,REAL,2917619429,485,2917619914,2949208181
2025-06-19 12:56:48,FAKE,2917619914,243,2917620157,2949208719
2025-06-19 12:56:50,REAL,2917620157,481,2917620638,2949209200
2025-06-19 12:56:52,FAKE,2917620638,244,2917620882,2949209689
2025-06-19 12:56:54,FAKE,2917620882,243,2917621125,2949210167
2025-06-19 12:56:56,FAKE,2917621125,244,2917621369,2949210658
2025-06-19 12:56:58,REAL,2917621369,5935,2917627304,2949216593
2025-06-19 12:57:00,REAL,2917627304,14086,2917641390,2949230679
2025-06-19 12:57:02,FAKE,2917641390,238,2917641628,2949241001
2025-06-19 12:57:04,FAKE,2917641628,238,2917641866,2949251249
2025-06-19 12:57:06,REAL,2917641866,10318,2917652184,2949261567
2025-06-19 12:57:08,REAL,2917652184,10255,2917662439,2949271822
2025-06-19 12:57:10,REAL,2917662439,10314,2917672753,2949282136
2025-06-19 12:57:12,FAKE,2917672753,244,2917672997,2949292387
2025-06-19 12:57:14,FAKE,2917672997,244,2917673241,2949293659
2025-06-19 12:57:16,REAL,2917673241,483,2917673724,2949294142
2025-06-19 12:57:18,REAL,2917673724,492,2917674216,2949294634
2025-06-19 12:57:20,REAL,2917674216,479,2917674695,2949295113
2025-06-19 12:57:22,REAL,2917674695,474,2917675169,2949295587
2025-06-19 12:57:24,FAKE,2917675169,244,2917675413,2949296079
2025-06-19 12:57:26,REAL,2917675413,479,2917675892,2949296558
2025-06-19 12:57:28,REAL,2917675892,543,2917676435,2949297101
2025-06-19 12:57:30,REAL,2917676435,12041,2917688476,2949309142
2025-06-19 12:57:32,FAKE,2917688476,243,2917688719,2949319385
2025-06-19 12:57:34,REAL,2917688719,10249,2917698968,2949329634
2025-06-19 12:57:36,REAL,2917698968,10319,2917709287,2949339953
2025-06-19 12:57:38,REAL,2917709287,10249,2917719536,2949350202
2025-06-19 12:57:40,FAKE,2917719536,238,2917719774,2949360459
2025-06-19 12:57:42,REAL,2917719774,10255,2917730029,2949370714
2025-06-19 12:57:44,REAL,2917730029,5828,2917735857,2949376542
2025-06-19 12:57:46,REAL,2917735857,485,2917736342,2949377027
2025-06-19 12:57:48,FAKE,2917736342,238,2917736580,2949377502
2025-06-19 12:57:50,REAL,2917736580,538,2917737118,2949378040
2025-06-19 12:57:52,REAL,2917737118,482,2917737600,2949378522
2025-06-19 12:57:54,REAL,2917737600,476,2917738076,2949378998
2025-06-19 12:57:56,REAL,2917738076,491,2917738567,2949379489
2025-06-19 12:57:58,REAL,2917738567,533,2917739100,2949380022
2025-06-19 12:58:00,REAL,2917739100,487,2917739587,2949380509
2025-06-19 12:58:02,FAKE,2917739587,244,2917739831,2949380992
2025-06-19 12:58:04,REAL,2917739831,484,2917740315,2949381476
2025-06-19 12:58:06,REAL,2917740315,483,2917740798,2949381959
2025-06-19 12:58:08,FAKE,2917740798,244,2917741042,2949382444
2025-06-19 12:58:10,REAL,2917741042,485,2917741527,2949382929
2025-06-19 12:58:12,REAL,2917741527,480,2917742007,2949383409
2025-06-19 12:58:14,REAL,2917742007,487,2917742494,2949383896
2025-06-19 12:58:16,REAL,2917742494,485,2917742979,2949384381
2025-06-19 12:58:18,REAL,2917742979,483,2917743462,2949384864
2025-06-19 12:58:20,FAKE,2917743462,243,2917743705,2949385347
2025-06-19 12:58:22,REAL,2917743705,485,2917744190,2949385832
2025-06-19 12:58:24,REAL,2917744190,480,2917744670,2949386312
2025-06-19 12:58:26,FAKE,2917744670,243,2917744913,2949386858
2025-06-19 12:58:28,REAL,2917744913,479,2917745392,2949387337
2025-06-19 12:58:30,REAL,2917745392,535,2917745927,2949387872
2025-06-19 12:58:32,FAKE,2917745927,238,2917746165,2949388353
2025-06-19 12:58:34,REAL,2917746165,484,2917746649,2949388837
2025-06-19 12:58:36,REAL,2917746649,483,2917747132,2949389320
2025-06-19 12:58:38,REAL,2917747132,490,2917747622,2949389810
2025-06-19 12:58:40,FAKE,2917747622,241,2917747863,2949390287
2025-06-19 12:58:42,FAKE,2917747863,241,2917748104,2949390772
2025-06-19 12:58:44,REAL,2917748104,485,2917748589,2949391257
2025-06-19 12:58:46,REAL,2917748589,490,2917749079,2949391747
2025-06-19 12:58:48,FAKE,2917749079,244,2917749323,2949392237
2025-06-19 12:58:50,FAKE,2917749323,241,2917749564,2949392724
2025-06-19 12:58:52,FAKE,2917749564,244,2917749808,2949393209
2025-06-19 12:58:54,REAL,2917749808,8078,2917757886,2949401287
2025-06-19 12:58:56,REAL,2917757886,10707,2917768593,2949411994
2025-06-19 12:58:58,FAKE,2917768593,238,2917768831,2949422320
2025-06-19 12:59:00,REAL,2917768831,10250,2917779081,2949432570
2025-06-19 12:59:02,REAL,2917779081,10316,2917789397,2949442886
2025-06-19 12:59:04,REAL,2917789397,10305,2917799702,2949453191
2025-06-19 12:59:06,REAL,2917799702,10320,2917810022,2949463511
2025-06-19 12:59:08,REAL,2917810022,9131,2917819153,2949472642
2025-06-19 12:59:10,FAKE,2917819153,243,2917819396,2949472888
2025-06-19 12:59:12,FAKE,2917819396,244,2917819640,2949473373
2025-06-19 12:59:14,REAL,2917819640,2406,2917822046,2949475779
2025-06-19 12:59:16,REAL,2917822046,14094,2917836140,2949489873
2025-06-19 12:59:18,REAL,2917836140,10255,2917846395,2949500128
2025-06-19 12:59:20,REAL,2917846395,10315,2917856710,2949510443
2025-06-19 12:59:22,REAL,2917856710,10254,2917866964,2949520697
2025-06-19 12:59:24,REAL,2917866964,10243,2917877207,2949530940
2025-06-19 12:59:26,FAKE,2917877207,244,2917877451,2949541257
2025-06-19 12:59:28,REAL,2917877451,10247,2917887698,2949551504
2025-06-19 12:59:30,REAL,2917887698,3841,2917891539,2949555345
2025-06-19 12:59:32,FAKE,2917891539,238,2917891777,2949555835
2025-06-19 12:59:34,REAL,2917891777,485,2917892262,2949556320
2025-06-19 12:59:36,REAL,2917892262,9661,2917901923,2949565981
2025-06-19 12:59:38,FAKE,2917901923,241,2917902164,2949577008
2025-06-19 12:59:40,REAL,2917902164,10259,2917912423,2949587267
2025-06-19 12:59:42,REAL,2917912423,10311,2917922734,2949597578
2025-06-19 12:59:44,REAL,2917922734,10244,2917932978,2949607822
2025-06-19 12:59:46,REAL,2917932978,10254,2917943232,2949618076
2025-06-19 12:59:48,FAKE,2917943232,241,2917943473,2949628393
2025-06-19 12:59:50,REAL,2917943473,8400,2917951873,2949636793
2025-06-19 12:59:52,REAL,2917951873,485,2917952358,2949637278
2025-06-19 12:59:54,REAL,2917952358,481,2917952839,2949637759
2025-06-19 12:59:56,FAKE,2917952839,243,2917953082,2949640625
2025-06-19 12:59:58,REAL,2917953082,14344,2917967426,2949654969
2025-06-19 13:00:00,REAL,2917967426,10323,2917977749,2949665292
2025-06-19 13:00:02,REAL,2917977749,10248,2917987997,2949675540
2025-06-19 13:00:04,REAL,2917987997,10252,2917998249,2949685792
2025-06-19 13:00:06,REAL,2917998249,10317,2918008566,2949696109
2025-06-19 13:00:08,REAL,2918008566,10243,2918018809,2949706352
2025-06-19 13:00:10,FAKE,2918018809,243,2918019052,2949716664
2025-06-19 13:00:12,FAKE,2918019052,241,2918019293,2949719789
2025-06-19 13:00:14,FAKE,2918019293,243,2918019536,2949720269
2025-06-19 13:00:16,REAL,2918019536,538,2918020074,2949720807
2025-06-19 13:00:18,REAL,2918020074,494,2918020568,2949721301
2025-06-19 13:00:20,REAL,2918020568,488,2918021056,2949721789
2025-06-19 13:00:22,FAKE,2918021056,244,2918021300,2949722278
2025-06-19 13:00:24,FAKE,2918021300,243,2918021543,2949722764
2025-06-19 13:00:26,REAL,2918021543,486,2918022029,2949723250
2025-06-19 13:00:28,REAL,2918022029,3854,2918025883,2949727104
2025-06-19 13:00:30,FAKE,2918025883,238,2918026121,2949738739
2025-06-19 13:00:32,REAL,2918026121,10255,2918036376,2949748994
2025-06-19 13:00:34,REAL,2918036376,10255,2918046631,2949759249
2025-06-19 13:00:36,REAL,2918046631,10314,2918056945,2949769563
2025-06-19 13:00:38,REAL,2918056945,10256,2918067201,2949779819
2025-06-19 13:00:40,REAL,2918067201,10252,2918077453,2949790071
2025-06-19 13:00:42,REAL,2918077453,10319,2918087772,2949800390
2025-06-19 13:00:44,REAL,2918087772,2470,2918090242,2949802860
2025-06-19 13:00:46,FAKE,2918090242,241,2918090483,2949803343
2025-06-19 13:00:48,FAKE,2918090483,244,2918090727,2949803835
2025-06-19 13:00:50,FAKE,2918090727,241,2918090968,2949804317
2025-06-19 13:00:52,REAL,2918090968,539,2918091507,2949804856
2025-06-19 13:00:54,REAL,2918091507,484,2918091991,2949805340
2025-06-19 13:00:56,REAL,2918091991,491,2918092482,2949805831
2025-06-19 13:00:58,REAL,2918092482,481,2918092963,2949806312
2025-06-19 13:01:00,REAL,2918092963,4855,2918097818,2949811167
2025-06-19 13:01:02,REAL,2918097818,11384,2918109202,2949822551
2025-06-19 13:01:04,FAKE,2918109202,243,2918109445,2949832870
2025-06-19 13:01:06,REAL,2918109445,10255,2918119700,2949843125
2025-06-19 13:01:08,FAKE,2918119700,244,2918119944,2949853444
2025-06-19 13:01:10,REAL,2918119944,10248,2918130192,2949863692
2025-06-19 13:01:12,FAKE,2918130192,244,2918130436,2949874006
2025-06-19 13:01:14,REAL,2918130436,10320,2918140756,2949884326
2025-06-19 13:01:16,REAL,2918140756,1878,2918142634,2949886204
2025-06-19 13:01:18,REAL,2918142634,490,2918143124,2949886694
2025-06-19 13:01:20,REAL,2918143124,475,2918143599,2949887169
2025-06-19 13:01:22,FAKE,2918143599,243,2918143842,2949887646
2025-06-19 13:01:24,REAL,2918143842,486,2918144328,2949888132
2025-06-19 13:01:26,FAKE,2918144328,238,2918144566,2949888614
2025-06-19 13:01:28,FAKE,2918144566,243,2918144809,2949889094
2025-06-19 13:01:30,REAL,2918144809,546,2918145355,2949889640
2025-06-19 13:01:32,FAKE,2918145355,243,2918145598,2949894953
2025-06-19 13:01:34,REAL,2918145598,11587,2918157185,2949906540
2025-06-19 13:01:36,REAL,2918157185,10326,2918167511,2949916866
2025-06-19 13:01:38,REAL,2918167511,10253,2918177764,2949927119
2025-06-19 13:01:40,REAL,2918177764,10260,2918188024,2949937379
2025-06-19 13:01:42,FAKE,2918188024,244,2918188268,2949947695
2025-06-19 13:01:44,REAL,2918188268,10250,2918198518,2949957945
2025-06-19 13:01:46,FAKE,2918198518,243,2918198761,2949968195
2025-06-19 13:01:48,REAL,2918198761,1282,2918200043,2949969477
2025-06-19 13:01:50,REAL,2918200043,492,2918200535,2949969969
2025-06-19 13:01:52,REAL,2918200535,486,2918201021,2949970455
2025-06-19 13:01:54,FAKE,2918201021,238,2918201259,2949970936
2025-06-19 13:01:56,FAKE,2918201259,244,2918201503,2949971421
2025-06-19 13:01:58,REAL,2918201503,489,2918201992,2949971910
2025-06-19 13:02:00,FAKE,2918201992,243,2918202235,2949972400
2025-06-19 13:02:02,REAL,2918202235,484,2918202719,2949972884
2025-06-19 13:02:04,REAL,2918202719,7163,2918209882,2949980047
2025-06-19 13:02:06,REAL,2918209882,13551,2918223433,2949993598
2025-06-19 13:02:08,FAKE,2918223433,241,2918223674,2950003919
2025-06-19 13:02:10,REAL,2918223674,10257,2918233931,2950014176
2025-06-19 13:02:12,REAL,2918233931,10317,2918244248,2950024493
2025-06-19 13:02:14,REAL,2918244248,10247,2918254495,2950034740
2025-06-19 13:02:16,FAKE,2918254495,243,2918254738,2950044990
2025-06-19 13:02:18,REAL,2918254738,10254,2918264992,2950055244
2025-06-19 13:02:20,REAL,2918264992,687,2918265679,2950055931
2025-06-19 13:02:22,REAL,2918265679,482,2918266161,2950056413
2025-06-19 13:02:24,FAKE,2918266161,241,2918266402,2950056897
2025-06-19 13:02:26,REAL,2918266402,15679,2918282081,2950072576
2025-06-19 13:02:28,FAKE,2918282081,243,2918282324,2950082893
2025-06-19 13:02:30,FAKE,2918282324,241,2918282565,2950093148
2025-06-19 13:02:32,FAKE,2918282565,244,2918282809,2950103460
2025-06-19 13:02:34,REAL,2918282809,10254,2918293063,2950113714
2025-06-19 13:02:36,FAKE,2918293063,238,2918293301,2950124026
2025-06-19 13:02:38,REAL,2918293301,10246,2918303547,2950134272
2025-06-19 13:02:40,REAL,2918303547,5166,2918308713,2950139438
2025-06-19 13:02:42,FAKE,2918308713,244,2918308957,2950139982
2025-06-19 13:02:44,FAKE,2918308957,243,2918309200,2950140465
2025-06-19 13:02:46,FAKE,2918309200,241,2918309441,2950140949
2025-06-19 13:02:48,REAL,2918309441,482,2918309923,2950141431
2025-06-19 13:02:50,REAL,2918309923,486,2918310409,2950141917
2025-06-19 13:02:52,REAL,2918310409,484,2918310893,2950142401
2025-06-19 13:02:54,REAL,2918310893,480,2918311373,2950142881
2025-06-19 13:02:56,REAL,2918311373,481,2918311854,2950143362
2025-06-19 13:02:58,REAL,2918311854,483,2918312337,2950143845
2025-06-19 13:03:00,REAL,2918312337,478,2918312815,2950144323
2025-06-19 13:03:02,REAL,2918312815,488,2918313303,2950144811
2025-06-19 13:03:04,REAL,2918313303,492,2918313795,2950145303
2025-06-19 13:03:06,REAL,2918313795,480,2918314275,2950145783
2025-06-19 13:03:08,REAL,2918314275,486,2918314761,2950146269
2025-06-19 13:03:10,REAL,2918314761,488,2918315249,2950146757
2025-06-19 13:03:12,REAL,2918315249,538,2918315787,2950147295
2025-06-19 13:03:14,REAL,2918315787,488,2918316275,2950147783
2025-06-19 13:03:16,FAKE,2918316275,244,2918316519,2950148269
2025-06-19 13:03:18,FAKE,2918316519,244,2918316763,2950148810
2025-06-19 13:03:20,REAL,2918316763,481,2918317244,2950149291
2025-06-19 13:03:22,FAKE,2918317244,241,2918317485,2950149770
2025-06-19 13:03:24,REAL,2918317485,478,2918317963,2950150248
2025-06-19 13:03:26,REAL,2918317963,490,2918318453,2950150738
2025-06-19 13:03:28,FAKE,2918318453,244,2918318697,2950152684
2025-06-19 13:03:30,REAL,2918318697,11969,2918330666,2950164653
2025-06-19 13:03:32,REAL,2918330666,10317,2918340983,2950174970
2025-06-19 13:03:34,REAL,2918340983,10259,2918351242,2950185229
2025-06-19 13:03:36,REAL,2918351242,10243,2918361485,2950195472
2025-06-19 13:03:38,REAL,2918361485,10250,2918371735,2950205722
2025-06-19 13:03:40,FAKE,2918371735,243,2918371978,2950216046
2025-06-19 13:03:42,REAL,2918371978,10251,2918382229,2950226297
2025-06-19 13:03:44,REAL,2918382229,3913,2918386142,2950230210
2025-06-19 13:03:46,REAL,2918386142,478,2918386620,2950230688
2025-06-19 13:03:48,REAL,2918386620,479,2918387099,2950231167
2025-06-19 13:03:50,FAKE,2918387099,244,2918387343,2950231647
2025-06-19 13:03:52,REAL,2918387343,533,2918387876,2950232180
2025-06-19 13:03:54,FAKE,2918387876,243,2918388119,2950232666
2025-06-19 13:03:56,REAL,2918388119,487,2918388606,2950233153
2025-06-19 13:03:58,FAKE,2918388606,243,2918388849,2950233641
2025-06-19 13:04:00,REAL,2918388849,491,2918389340,2950234132
2025-06-19 13:04:02,REAL,2918389340,481,2918389821,2950234613
2025-06-19 13:04:04,REAL,2918389821,484,2918390305,2950235097
2025-06-19 13:04:06,FAKE,2918390305,243,2918390548,2950235578
2025-06-19 13:04:08,REAL,2918390548,479,2918391027,2950236057
2025-06-19 13:04:10,REAL,2918391027,491,2918391518,2950236548
2025-06-19 13:04:12,REAL,2918391518,479,2918391997,2950237027
2025-06-19 13:04:14,REAL,2918391997,480,2918392477,2950237507
2025-06-19 13:04:16,REAL,2918392477,540,2918393017,2950238047
2025-06-19 13:04:18,REAL,2918393017,489,2918393506,2950238536
2025-06-19 13:04:20,FAKE,2918393506,241,2918393747,2950239026
2025-06-19 13:04:22,REAL,2918393747,475,2918394222,2950239501
2025-06-19 13:04:24,FAKE,2918394222,238,2918394460,2950239988
2025-06-19 13:04:26,REAL,2918394460,479,2918394939,2950240467
2025-06-19 13:04:28,REAL,2918394939,540,2918395479,2950241007
2025-06-19 13:04:30,REAL,2918395479,487,2918395966,2950241494
2025-06-19 13:04:32,REAL,2918395966,3856,2918399822,2950245350
2025-06-19 13:04:34,REAL,2918399822,15138,2918414960,2950260488
2025-06-19 13:04:36,FAKE,2918414960,241,2918415201,2950270807
2025-06-19 13:04:38,REAL,2918415201,10247,2918425448,2950281054
2025-06-19 13:04:40,REAL,2918425448,10253,2918435701,2950291307
2025-06-19 13:04:42,REAL,2918435701,10321,2918446022,2950301628
2025-06-19 13:04:44,REAL,2918446022,10254,2918456276,2950311882
2025-06-19 13:04:46,REAL,2918456276,10316,2918466592,2950322198
2025-06-19 13:04:48,REAL,2918466592,2660,2918469252,2950324858
2025-06-19 13:04:50,REAL,2918469252,479,2918469731,2950325337
2025-06-19 13:04:52,REAL,2918469731,481,2918470212,2950325818
2025-06-19 13:04:54,REAL,2918470212,481,2918470693,2950326299
2025-06-19 13:04:56,FAKE,2918470693,243,2918470936,2950326786
2025-06-19 13:04:58,REAL,2918470936,489,2918471425,2950327275
2025-06-19 13:05:00,REAL,2918471425,476,2918471901,2950327751
2025-06-19 13:05:02,REAL,2918471901,491,2918472392,2950328242
2025-06-19 13:05:04,FAKE,2918472392,243,2918472635,2950333012
2025-06-19 13:05:06,REAL,2918472635,11243,2918483878,2950344255
2025-06-19 13:05:08,REAL,2918483878,10255,2918494133,2950354510
2025-06-19 13:05:10,FAKE,2918494133,238,2918494371,2950364769
2025-06-19 13:05:12,REAL,2918494371,10318,2918504689,2950375087
2025-06-19 13:05:14,FAKE,2918504689,244,2918504933,2950385339
2025-06-19 13:05:16,REAL,2918504933,10257,2918515190,2950395596
2025-06-19 13:05:18,FAKE,2918515190,238,2918515428,2950405920
2025-06-19 13:05:20,FAKE,2918515428,238,2918515666,2950407925
2025-06-19 13:05:22,FAKE,2918515666,238,2918515904,2950408410
2025-06-19 13:05:24,REAL,2918515904,486,2918516390,2950408896
2025-06-19 13:05:26,FAKE,2918516390,243,2918516633,2950419550
2025-06-19 13:05:28,REAL,2918516633,10447,2918527080,2950429997
2025-06-19 13:05:30,REAL,2918527080,10249,2918537329,2950440246
2025-06-19 13:05:32,FAKE,2918537329,241,2918537570,2950450501
2025-06-19 13:05:34,REAL,2918537570,10320,2918547890,2950460821
2025-06-19 13:05:36,REAL,2918547890,10252,2918558142,2950471073
2025-06-19 13:05:38,FAKE,2918558142,243,2918558385,2950481325
2025-06-19 13:05:40,REAL,2918558385,6610,2918564995,2950487935
2025-06-19 13:05:42,REAL,2918564995,483,2918565478,2950488418
2025-06-19 13:05:44,FAKE,2918565478,238,2918565716,2950488898
2025-06-19 13:05:46,REAL,2918565716,487,2918566203,2950489385
2025-06-19 13:05:48,REAL,2918566203,486,2918566689,2950489871
2025-06-19 13:05:50,REAL,2918566689,485,2918567174,2950490356
2025-06-19 13:05:52,FAKE,2918567174,244,2918567418,2950490840
2025-06-19 13:05:54,REAL,2918567418,478,2918567896,2950491318
2025-06-19 13:05:56,REAL,2918567896,484,2918568380,2950491802
2025-06-19 13:05:58,REAL,2918568380,488,2918568868,2950492290
2025-06-19 13:06:00,FAKE,2918568868,241,2918569109,2950492782
2025-06-19 13:06:02,REAL,2918569109,483,2918569592,2950493265
2025-06-19 13:06:04,FAKE,2918569592,238,2918569830,2950493810
2025-06-19 13:06:06,FAKE,2918569830,238,2918570068,2950494296
2025-06-19 13:06:08,FAKE,2918570068,238,2918570306,2950505629
2025-06-19 13:06:10,FAKE,2918570306,244,2918570550,2950515949
2025-06-19 13:06:12,FAKE,2918570550,241,2918570791,2950526199
2025-06-19 13:06:14,REAL,2918570791,10252,2918581043,2950536451
2025-06-19 13:06:16,REAL,2918581043,10380,2918591423,2950546831
2025-06-19 13:06:18,REAL,2918591423,10255,2918601678,2950557086
2025-06-19 13:06:20,REAL,2918601678,10253,2918611931,2950567339
2025-06-19 13:06:22,FAKE,2918611931,238,2918612169,2950573170
2025-06-19 13:06:24,REAL,2918612169,482,2918612651,2950573652
2025-06-19 13:06:26,REAL,2918612651,481,2918613132,2950574133
2025-06-19 13:06:28,FAKE,2918613132,241,2918613373,2950574618
2025-06-19 13:06:30,REAL,2918613373,484,2918613857,2950575102
2025-06-19 13:06:32,FAKE,2918613857,241,2918614098,2950575590
2025-06-19 13:06:34,REAL,2918614098,480,2918614578,2950576070
2025-06-19 13:06:36,REAL,2918614578,482,2918615060,2950576552
2025-06-19 13:06:38,FAKE,2918615060,238,2918615298,2950577038
2025-06-19 13:06:40,REAL,2918615298,11918,2918627216,2950588956
2025-06-19 13:06:42,REAL,2918627216,10251,2918637467,2950599207
2025-06-19 13:06:44,REAL,2918637467,10326,2918647793,2950609533
2025-06-19 13:06:46,REAL,2918647793,10254,2918658047,2950619787
2025-06-19 13:06:48,FAKE,2918658047,238,2918658285,2950630096
2025-06-19 13:06:50,REAL,2918658285,10307,2918668592,2950640403
2025-06-19 13:06:52,REAL,2918668592,10312,2918678904,2950650715
2025-06-19 13:06:54,FAKE,2918678904,244,2918679148,2950655951
2025-06-19 13:06:56,FAKE,2918679148,243,2918679391,2950656439
2025-06-19 13:06:58,FAKE,2918679391,243,2918679634,2950656926
2025-06-19 13:07:00,REAL,2918679634,475,2918680109,2950657401
2025-06-19 13:07:02,REAL,2918680109,481,2918680590,2950657882
2025-06-19 13:07:04,FAKE,2918680590,244,2918680834,2950658365
2025-06-19 13:07:06,FAKE,2918680834,243,2918681077,2950658850
2025-06-19 13:07:08,FAKE,2918681077,238,2918681315,2950659336
2025-06-19 13:07:10,REAL,2918681315,1348,2918682663,2950660684
2025-06-19 13:07:12,FAKE,2918682663,241,2918682904,2950672126
2025-06-19 13:07:14,REAL,2918682904,10320,2918693224,2950682446
2025-06-19 13:07:16,FAKE,2918693224,243,2918693467,2950692704
2025-06-19 13:07:18,REAL,2918693467,10320,2918703787,2950703024
2025-06-19 13:07:20,REAL,2918703787,10255,2918714042,2950713279
2025-06-19 13:07:22,REAL,2918714042,10314,2918724356,2950723593
2025-06-19 13:07:24,REAL,2918724356,10261,2918734617,2950733854
2025-06-19 13:07:26,REAL,2918734617,4637,2918739254,2950738491
2025-06-19 13:07:28,REAL,2918739254,539,2918739793,2950739030
2025-06-19 13:07:30,REAL,2918739793,479,2918740272,2950739509
2025-06-19 13:07:32,REAL,2918740272,489,2918740761,2950739998
2025-06-19 13:07:34,REAL,2918740761,484,2918741245,2950740482
2025-06-19 13:07:36,FAKE,2918741245,243,2918741488,2950740963
2025-06-19 13:07:38,REAL,2918741488,476,2918741964,2950741439
2025-06-19 13:07:40,FAKE,2918741964,244,2918742208,2950741926
2025-06-19 13:07:42,REAL,2918742208,2007,2918744215,2950743933
2025-06-19 13:07:44,REAL,2918744215,14737,2918758952,2950758670
2025-06-19 13:07:46,REAL,2918758952,10253,2918769205,2950768923
2025-06-19 13:07:48,REAL,2918769205,10246,2918779451,2950779169
2025-06-19 13:07:50,FAKE,2918779451,244,2918779695,2950789482
2025-06-19 13:07:52,REAL,2918779695,10251,2918789946,2950799733
2025-06-19 13:07:54,FAKE,2918789946,241,2918790187,2950809990
2025-06-19 13:07:56,FAKE,2918790187,244,2918790431,2950820304
2025-06-19 13:07:58,REAL,2918790431,3980,2918794411,2950824284
2025-06-19 13:08:00,REAL,2918794411,490,2918794901,2950824774
2025-06-19 13:08:02,FAKE,2918794901,243,2918795144,2950825256
2025-06-19 13:08:04,REAL,2918795144,479,2918795623,2950825735
2025-06-19 13:08:06,REAL,2918795623,538,2918796161,2950826273
2025-06-19 13:08:08,REAL,2918796161,480,2918796641,2950826753
2025-06-19 13:08:10,REAL,2918796641,489,2918797130,2950827242
2025-06-19 13:08:12,REAL,2918797130,483,2918797613,2950827725
2025-06-19 13:08:14,REAL,2918797613,483,2918798096,2950828208
2025-06-19 13:08:16,FAKE,2918798096,238,2918798334,2950828693
2025-06-19 13:08:18,REAL,2918798334,485,2918798819,2950829178
2025-06-19 13:08:20,REAL,2918798819,478,2918799297,2950829656
2025-06-19 13:08:22,FAKE,2918799297,244,2918799541,2950830203
2025-06-19 13:08:24,REAL,2918799541,481,2918800022,2950830684
2025-06-19 13:08:26,FAKE,2918800022,244,2918800266,2950831173
2025-06-19 13:08:28,FAKE,2918800266,241,2918800507,2950831659
2025-06-19 13:08:30,FAKE,2918800507,238,2918800745,2950832143
2025-06-19 13:08:32,REAL,2918800745,486,2918801231,2950832629
2025-06-19 13:08:34,FAKE,2918801231,241,2918801472,2950833113
2025-06-19 13:08:36,FAKE,2918801472,238,2918801710,2950833603
2025-06-19 13:08:38,FAKE,2918801710,238,2918801948,2950834091
2025-06-19 13:08:40,FAKE,2918801948,238,2918802186,2950834578
2025-06-19 13:08:42,REAL,2918802186,487,2918802673,2950835065
2025-06-19 13:08:44,FAKE,2918802673,241,2918802914,2950835550
2025-06-19 13:08:46,FAKE,2918802914,243,2918803157,2950836099
2025-06-19 13:08:48,FAKE,2918803157,243,2918803400,2950836588
2025-06-19 13:08:50,REAL,2918803400,480,2918803880,2950837068
2025-06-19 13:08:52,REAL,2918803880,488,2918804368,2950837556
2025-06-19 13:08:54,REAL,2918804368,483,2918804851,2950838039
2025-06-19 13:08:56,REAL,2918804851,478,2918805329,2950838517
2025-06-19 13:08:58,REAL,2918805329,484,2918805813,2950839001
2025-06-19 13:09:00,FAKE,2918805813,244,2918806057,2950839548
2025-06-19 13:09:02,FAKE,2918806057,241,2918806298,2950840030
2025-06-19 13:09:04,REAL,2918806298,480,2918806778,2950840510
2025-06-19 13:09:06,REAL,2918806778,484,2918807262,2950840994
2025-06-19 13:09:08,REAL,2918807262,486,2918807748,2950841480
2025-06-19 13:09:10,REAL,2918807748,485,2918808233,2950841965
2025-06-19 13:09:12,FAKE,2918808233,244,2918808477,2950842455
2025-06-19 13:09:14,REAL,2918808477,486,2918808963,2950842941
2025-06-19 13:09:16,FAKE,2918808963,241,2918809204,2950843425
2025-06-19 13:09:18,REAL,2918809204,479,2918809683,2950843904
2025-06-19 13:09:20,FAKE,2918809683,243,2918809926,2950844389
2025-06-19 13:09:22,REAL,2918809926,488,2918810414,2950844877
2025-06-19 13:09:24,REAL,2918810414,536,2918810950,2950845413
2025-06-19 13:09:26,FAKE,2918810950,244,2918811194,2950845900
2025-06-19 13:09:28,REAL,2918811194,482,2918811676,2950846382
2025-06-19 13:09:30,REAL,2918811676,491,2918812167,2950846873
2025-06-19 13:09:32,FAKE,2918812167,238,2918812405,2950847361
2025-06-19 13:09:34,REAL,2918812405,480,2918812885,2950847841
2025-06-19 13:09:36,FAKE,2918812885,241,2918813126,2950848327
2025-06-19 13:09:38,REAL,2918813126,478,2918813604,2950848805
2025-06-19 13:09:40,REAL,2918813604,546,2918814150,2950849351
2025-06-19 13:09:42,REAL,2918814150,489,2918814639,2950849840
2025-06-19 13:09:44,FAKE,2918814639,238,2918814877,2950850324
2025-06-19 13:09:46,REAL,2918814877,489,2918815366,2950850813
2025-06-19 13:09:48,FAKE,2918815366,244,2918815610,2950851296
2025-06-19 13:09:50,REAL,2918815610,485,2918816095,2950851781
2025-06-19 13:09:52,FAKE,2918816095,241,2918816336,2950852263
2025-06-19 13:09:54,REAL,2918816336,493,2918816829,2950852756
2025-06-19 13:09:56,FAKE,2918816829,238,2918817067,2950853250
2025-06-19 13:09:58,FAKE,2918817067,238,2918817305,2950853727
2025-06-19 13:10:00,FAKE,2918817305,244,2918817549,2950859107
2025-06-19 13:10:02,REAL,2918817549,14406,2918831955,2950873513
2025-06-19 13:10:04,REAL,2918831955,10242,2918842197,2950883755
2025-06-19 13:10:06,REAL,2918842197,10257,2918852454,2950894012
2025-06-19 13:10:08,FAKE,2918852454,243,2918852697,2950904261
2025-06-19 13:10:10,FAKE,2918852697,241,2918852938,2950914508
2025-06-19 13:10:12,REAL,2918852938,10321,2918863259,2950924829
2025-06-19 13:10:14,FAKE,2918863259,241,2918863500,2950935075
2025-06-19 13:10:16,REAL,2918863500,1542,2918865042,2950936617
2025-06-19 13:10:18,REAL,2918865042,478,2918865520,2950937095
2025-06-19 13:10:20,FAKE,2918865520,241,2918865761,2950937586
2025-06-19 13:10:22,FAKE,2918865761,241,2918866002,2950938123
2025-06-19 13:10:24,FAKE,2918866002,244,2918866246,2950938602
2025-06-19 13:10:26,FAKE,2918866246,243,2918866489,2950939080
2025-06-19 13:10:28,REAL,2918866489,486,2918866975,2950939566
2025-06-19 13:10:30,FAKE,2918866975,244,2918867219,2950940053
2025-06-19 13:10:32,REAL,2918867219,482,2918867701,2950940535
2025-06-19 13:10:34,FAKE,2918867701,241,2918867942,2950941014
2025-06-19 13:10:36,FAKE,2918867942,238,2918868180,2950941498
2025-06-19 13:10:38,REAL,2918868180,481,2918868661,2950941979
2025-06-19 13:10:40,FAKE,2918868661,241,2918868902,2950942465
2025-06-19 13:10:42,FAKE,2918868902,241,2918869143,2950943001
2025-06-19 13:10:44,FAKE,2918869143,241,2918869384,2950943483
2025-06-19 13:10:46,REAL,2918869384,479,2918869863,2950943962
2025-06-19 13:10:48,REAL,2918869863,11443,2918881306,2950955405
2025-06-19 13:10:50,REAL,2918881306,10252,2918891558,2950965657
2025-06-19 13:10:52,FAKE,2918891558,244,2918891802,2950975901
2025-06-19 13:10:54,REAL,2918891802,10318,2918902120,2950986219
2025-06-19 13:10:56,REAL,2918902120,10244,2918912364,2950996463
2025-06-19 13:10:58,REAL,2918912364,10252,2918922616,2951006715
2025-06-19 13:11:00,REAL,2918922616,10313,2918932929,2951017028
2025-06-19 13:11:02,FAKE,2918932929,243,2918933172,2951022927
2025-06-19 13:11:04,REAL,2918933172,484,2918933656,2951023411
2025-06-19 13:11:06,FAKE,2918933656,241,2918933897,2951023895
2025-06-19 13:11:08,REAL,2918933897,487,2918934384,2951024382
2025-06-19 13:11:10,REAL,2918934384,482,2918934866,2951024864
2025-06-19 13:11:12,REAL,2918934866,548,2918935414,2951025412
2025-06-19 13:11:14,FAKE,2918935414,243,2918935657,2951025887
2025-06-19 13:11:16,FAKE,2918935657,241,2918935898,2951026371
2025-06-19 13:11:18,FAKE,2918935898,243,2918936141,2951026860
2025-06-19 13:11:20,FAKE,2918936141,244,2918936385,2951027406
2025-06-19 13:11:22,REAL,2918936385,483,2918936868,2951027889
2025-06-19 13:11:24,REAL,2918936868,476,2918937344,2951028365
2025-06-19 13:11:26,REAL,2918937344,491,2918937835,2951028856
2025-06-19 13:11:28,REAL,2918937835,484,2918938319,2951029340
2025-06-19 13:11:30,REAL,2918938319,485,2918938804,2951029825
2025-06-19 13:11:32,FAKE,2918938804,243,2918939047,2951030301
2025-06-19 13:11:34,REAL,2918939047,487,2918939534,2951030788
2025-06-19 13:11:36,REAL,2918939534,541,2918940075,2951031329
2025-06-19 13:11:38,REAL,2918940075,484,2918940559,2951031813
2025-06-19 13:11:40,REAL,2918940559,487,2918941046,2951032300
2025-06-19 13:11:42,REAL,2918941046,475,2918941521,2951032775
2025-06-19 13:11:44,REAL,2918941521,482,2918942003,2951033257
2025-06-19 13:11:46,FAKE,2918942003,238,2918942241,2951033735
2025-06-19 13:11:48,REAL,2918942241,481,2918942722,2951034216
2025-06-19 13:11:50,FAKE,2918942722,238,2918942960,2951034695
2025-06-19 13:11:52,FAKE,2918942960,244,2918943204,2951035176
2025-06-19 13:11:54,REAL,2918943204,479,2918943683,2951035655
2025-06-19 13:11:56,REAL,2918943683,8015,2918951698,2951043670
2025-06-19 13:11:58,REAL,2918951698,12964,2918964662,2951056634
2025-06-19 13:12:00,REAL,2918964662,10313,2918974975,2951066947
2025-06-19 13:12:02,REAL,2918974975,10321,2918985296,2951077268
2025-06-19 13:12:04,REAL,2918985296,10256,2918995552,2951087524
2025-06-19 13:12:06,FAKE,2918995552,238,2918995790,2951097838
2025-06-19 13:12:08,REAL,2918995790,10246,2919006036,2951108084
2025-06-19 13:12:10,REAL,2919006036,9658,2919015694,2951117742
2025-06-19 13:12:12,FAKE,2919015694,241,2919015935,2951118229
2025-06-19 13:12:14,REAL,2919015935,478,2919016413,2951118707
2025-06-19 13:12:16,FAKE,2919016413,243,2919016656,2951119188
2025-06-19 13:12:18,REAL,2919016656,534,2919017190,2951119722
2025-06-19 13:12:20,FAKE,2919017190,244,2919017434,2951120207
2025-06-19 13:12:22,REAL,2919017434,482,2919017916,2951120689
2025-06-19 13:12:24,FAKE,2919017916,238,2919018154,2951121175
2025-06-19 13:12:26,FAKE,2919018154,241,2919018395,2951121659
2025-06-19 13:12:28,FAKE,2919018395,244,2919018639,2951122149
2025-06-19 13:12:30,REAL,2919018639,492,2919019131,2951122641
2025-06-19 13:12:32,REAL,2919019131,478,2919019609,2951123119
2025-06-19 13:12:34,REAL,2919019609,486,2919020095,2951123605
2025-06-19 13:12:36,FAKE,2919020095,241,2919020336,2951124095
2025-06-19 13:12:38,REAL,2919020336,547,2919020883,2951124642
2025-06-19 13:12:40,REAL,2919020883,489,2919021372,2951125131
2025-06-19 13:12:42,REAL,2919021372,545,2919021917,2951125676
2025-06-19 13:12:44,REAL,2919021917,477,2919022394,2951126153
2025-06-19 13:12:46,REAL,2919022394,486,2919022880,2951126639
2025-06-19 13:12:48,FAKE,2919022880,244,2919023124,2951128982
2025-06-19 13:12:50,FAKE,2919023124,238,2919023362,2951140158
2025-06-19 13:12:52,REAL,2919023362,10312,2919033674,2951150470
2025-06-19 13:12:54,FAKE,2919033674,241,2919033915,2951161649
2025-06-19 13:12:56,REAL,2919033915,9328,2919043243,2951170977
2025-06-19 13:12:58,FAKE,2919043243,241,2919043484,2951181232
2025-06-19 13:13:00,REAL,2919043484,10323,2919053807,2951191555
2025-06-19 13:13:02,FAKE,2919053807,244,2919054051,2951201801
2025-06-19 13:13:04,REAL,2919054051,3786,2919057837,2951205587
2025-06-19 13:13:06,REAL,2919057837,549,2919058386,2951206136
2025-06-19 13:13:08,REAL,2919058386,483,2919058869,2951206619
2025-06-19 13:13:10,REAL,2919058869,491,2919059360,2951207110
2025-06-19 13:13:12,FAKE,2919059360,238,2919059598,2951207643
2025-06-19 13:13:14,REAL,2919059598,488,2919060086,2951208131
2025-06-19 13:13:16,REAL,2919060086,479,2919060565,2951208610
2025-06-19 13:13:18,REAL,2919060565,484,2919061049,2951209094
2025-06-19 13:13:20,REAL,2919061049,2934,2919063983,2951212028
2025-06-19 13:13:22,FAKE,2919063983,241,2919064224,2951223399
2025-06-19 13:13:24,REAL,2919064224,10322,2919074546,2951233721
2025-06-19 13:13:26,REAL,2919074546,10248,2919084794,2951243969
2025-06-19 13:13:28,FAKE,2919084794,243,2919085037,2951254215
2025-06-19 13:13:30,REAL,2919085037,10377,2919095414,2951264592
2025-06-19 13:13:32,REAL,2919095414,10249,2919105663,2951274841
2025-06-19 13:13:34,REAL,2919105663,10252,2919115915,2951285093
2025-06-19 13:13:36,FAKE,2919115915,243,2919116158,2951288289
2025-06-19 13:13:38,REAL,2919116158,486,2919116644,2951288775
2025-06-19 13:13:40,REAL,2919116644,482,2919117126,2951289257
2025-06-19 13:13:42,REAL,2919117126,488,2919117614,2951289745
2025-06-19 13:13:44,REAL,2919117614,536,2919118150,2951290281
2025-06-19 13:13:46,REAL,2919118150,491,2919118641,2951290772
2025-06-19 13:13:48,REAL,2919118641,484,2919119125,2951291256
2025-06-19 13:13:50,FAKE,2919119125,244,2919119369,2951291743
2025-06-19 13:13:52,REAL,2919119369,490,2919119859,2951292233
2025-06-19 13:13:54,REAL,2919119859,479,2919120338,2951292712
2025-06-19 13:13:56,FAKE,2919120338,241,2919120579,2951293252
2025-06-19 13:13:58,REAL,2919120579,489,2919121068,2951293741
2025-06-19 13:14:00,REAL,2919121068,492,2919121560,2951294233
2025-06-19 13:14:02,REAL,2919121560,480,2919122040,2951294713
2025-06-19 13:14:04,FAKE,2919122040,244,2919122284,2951295193
2025-06-19 13:14:06,REAL,2919122284,478,2919122762,2951295671
2025-06-19 13:14:08,REAL,2919122762,538,2919123300,2951296209
2025-06-19 13:14:10,REAL,2919123300,483,2919123783,2951296692
2025-06-19 13:14:12,REAL,2919123783,477,2919124260,2951297169
2025-06-19 13:14:14,REAL,2919124260,10196,2919134456,2951307365
2025-06-19 13:14:16,REAL,2919134456,10313,2919144769,2951317678
2025-06-19 13:14:18,REAL,2919144769,10245,2919155014,2951327923
2025-06-19 13:14:20,REAL,2919155014,10320,2919165334,2951338243
2025-06-19 13:14:22,FAKE,2919165334,238,2919165572,2951348548
2025-06-19 13:14:24,FAKE,2919165572,241,2919165813,2951358865
2025-06-19 13:14:26,FAKE,2919165813,241,2919166054,2951369118
2025-06-19 13:14:28,REAL,2919166054,7020,2919173074,2951376138
2025-06-19 13:14:30,REAL,2919173074,483,2919173557,2951376621
2025-06-19 13:14:32,REAL,2919173557,478,2919174035,2951377099
2025-06-19 13:14:34,FAKE,2919174035,238,2919174273,2951377588
2025-06-19 13:14:36,REAL,2919174273,541,2919174814,2951378129
2025-06-19 13:14:38,REAL,2919174814,482,2919175296,2951378611
2025-06-19 13:14:40,REAL,2919175296,485,2919175781,2951379096
2025-06-19 13:14:42,REAL,2919175781,490,2919176271,2951379586
2025-06-19 13:14:44,REAL,2919176271,486,2919176757,2951380072
2025-06-19 13:14:46,REAL,2919176757,479,2919177236,2951380551
2025-06-19 13:14:48,REAL,2919177236,539,2919177775,2951381090
2025-06-19 13:14:50,REAL,2919177775,476,2919178251,2951381566
2025-06-19 13:14:52,REAL,2919178251,481,2919178732,2951382047
2025-06-19 13:14:54,REAL,2919178732,489,2919179221,2951382536
2025-06-19 13:14:56,REAL,2919179221,486,2919179707,2951383022
2025-06-19 13:14:58,REAL,2919179707,486,2919180193,2951383508
2025-06-19 13:15:00,REAL,2919180193,488,2919180681,2951383996
2025-06-19 13:15:02,REAL,2919180681,486,2919181167,2951384482
2025-06-19 13:15:04,FAKE,2919181167,244,2919181411,2951384965
2025-06-19 13:15:06,REAL,2919181411,485,2919181896,2951385450
2025-06-19 13:15:08,FAKE,2919181896,244,2919182140,2951385939
2025-06-19 13:15:10,FAKE,2919182140,243,2919182383,2951386423
2025-06-19 13:15:12,REAL,2919182383,481,2919182864,2951386904
2025-06-19 13:15:14,REAL,2919182864,537,2919183401,2951387441
2025-06-19 13:15:16,FAKE,2919183401,238,2919183639,2951387919
2025-06-19 13:15:18,REAL,2919183639,487,2919184126,2951388406
2025-06-19 13:15:20,REAL,2919184126,488,2919184614,2951388894
2025-06-19 13:15:22,FAKE,2919184614,244,2919184858,2951389438
2025-06-19 13:15:24,REAL,2919184858,484,2919185342,2951389922
2025-06-19 13:15:26,FAKE,2919185342,238,2919185580,2951390408
2025-06-19 13:15:28,REAL,2919185580,482,2919186062,2951390890
2025-06-19 13:15:30,REAL,2919186062,483,2919186545,2951391373
2025-06-19 13:15:32,REAL,2919186545,486,2919187031,2951391859
2025-06-19 13:15:34,REAL,2919187031,487,2919187518,2951392346
2025-06-19 13:15:36,REAL,2919187518,487,2919188005,2951392833
2025-06-19 13:15:38,FAKE,2919188005,244,2919188249,2951393315
2025-06-19 13:15:40,REAL,2919188249,535,2919188784,2951393850
2025-06-19 13:15:42,FAKE,2919188784,244,2919189028,2951394337
2025-06-19 13:15:44,REAL,2919189028,237,2919189265,2951394574
2025-06-19 13:15:46,REAL,2919189265,479,2919189744,2951395053
2025-06-19 13:15:48,REAL,2919189744,490,2919190234,2951395543
2025-06-19 13:15:50,FAKE,2919190234,238,2919190472,2951396029
2025-06-19 13:15:52,REAL,2919190472,487,2919190959,2951396516
2025-06-19 13:15:54,REAL,2919190959,483,2919191442,2951396999
2025-06-19 13:15:56,REAL,2919191442,475,2919191917,2951397474
2025-06-19 13:15:58,REAL,2919191917,489,2919192406,2951397963
2025-06-19 13:16:00,FAKE,2919192406,238,2919192644,2951413175
2025-06-19 13:16:02,REAL,2919192644,10315,2919202959,2951423490
2025-06-19 13:16:04,REAL,2919202959,10251,2919213210,2951433741
2025-06-19 13:16:06,REAL,2919213210,10369,2919223579,2951444110
2025-06-19 13:16:08,REAL,2919223579,10262,2919233841,2951454372
2025-06-19 13:16:10,REAL,2919233841,10252,2919244093,2951464624
2025-06-19 13:16:12,REAL,2919244093,10320,2919254413,2951474944
2025-06-19 13:16:14,FAKE,2919254413,244,2919254657,2951480179
2025-06-19 13:16:16,REAL,2919254657,491,2919255148,2951480670
2025-06-19 13:16:18,REAL,2919255148,481,2919255629,2951481151
2025-06-19 13:16:20,FAKE,2919255629,244,2919255873,2951481638
2025-06-19 13:16:22,REAL,2919255873,485,2919256358,2951482123
2025-06-19 13:16:24,FAKE,2919256358,241,2919256599,2951482612
2025-06-19 13:16:26,REAL,2919256599,481,2919257080,2951483093
2025-06-19 13:16:28,REAL,2919257080,482,2919257562,2951483575
2025-06-19 13:16:30,REAL,2919257562,537,2919258099,2951484112
2025-06-19 13:16:32,FAKE,2919258099,244,2919258343,2951484603
2025-06-19 13:16:34,REAL,2919258343,479,2919258822,2951485082
2025-06-19 13:16:36,FAKE,2919258822,243,2919259065,2951492434
2025-06-19 13:16:38,REAL,2919259065,10709,2919269774,2951503143
2025-06-19 13:16:40,REAL,2919269774,10257,2919280031,2951513400
2025-06-19 13:16:42,REAL,2919280031,10252,2919290283,2951523652
2025-06-19 13:16:44,REAL,2919290283,10249,2919300532,2951533901
2025-06-19 13:16:46,REAL,2919300532,10322,2919310854,2951544223
2025-06-19 13:16:48,REAL,2919310854,10251,2919321105,2951554474
2025-06-19 13:16:50,REAL,2919321105,9453,2919330558,2951563927
2025-06-19 13:16:52,REAL,2919330558,487,2919331045,2951564414
2025-06-19 13:16:54,REAL,2919331045,481,2919331526,2951564895
2025-06-19 13:16:56,FAKE,2919331526,238,2919331764,2951565626
2025-06-19 13:16:58,REAL,2919331764,299,2919332063,2951565925
2025-06-19 13:17:00,REAL,2919332063,478,2919332541,2951566403
2025-06-19 13:17:02,REAL,2919332541,484,2919333025,2951566887
2025-06-19 13:17:04,REAL,2919333025,489,2919333514,2951567376
2025-06-19 13:17:06,FAKE,2919333514,244,2919333758,2951567866
2025-06-19 13:17:08,REAL,2919333758,7944,2919341702,2951575810
2025-06-19 13:17:10,REAL,2919341702,11175,2919352877,2951586985
2025-06-19 13:17:12,REAL,2919352877,10251,2919363128,2951597236
2025-06-19 13:17:14,REAL,2919363128,10249,2919373377,2951607485
2025-06-19 13:17:16,REAL,2919373377,10327,2919383704,2951617812
2025-06-19 13:17:18,REAL,2919383704,10259,2919393963,2951628071
2025-06-19 13:17:20,FAKE,2919393963,241,2919394204,2951638316
2025-06-19 13:17:22,FAKE,2919394204,243,2919394447,2951647184
2025-06-19 13:17:24,REAL,2919394447,489,2919394936,2951647673
2025-06-19 13:17:26,REAL,2919394936,485,2919395421,2951648158
2025-06-19 13:17:28,FAKE,2919395421,238,2919395659,2951648649
2025-06-19 13:17:30,REAL,2919395659,489,2919396148,2951649138
2025-06-19 13:17:32,REAL,2919396148,476,2919396624,2951649614
2025-06-19 13:17:34,REAL,2919396624,485,2919397109,2951650099
2025-06-19 13:17:36,REAL,2919397109,478,2919397587,2951650577
2025-06-19 13:17:38,REAL,2919397587,484,2919398071,2951651061
2025-06-19 13:17:40,FAKE,2919398071,244,2919398315,2951651543
2025-06-19 13:17:42,FAKE,2919398315,244,2919398559,2951652032
2025-06-19 13:17:44,REAL,2919398559,541,2919399100,2951652573
2025-06-19 13:17:46,FAKE,2919399100,238,2919399338,2951653063
2025-06-19 13:17:48,REAL,2919399338,480,2919399818,2951653543
2025-06-19 13:17:50,REAL,2919399818,492,2919400310,2951654035
2025-06-19 13:17:52,FAKE,2919400310,241,2919400551,2951654523
2025-06-19 13:17:54,REAL,2919400551,536,2919401087,2951655059
2025-06-19 13:17:56,REAL,2919401087,483,2919401570,2951655542
2025-06-19 13:17:58,REAL,2919401570,482,2919402052,2951656024
2025-06-19 13:18:00,REAL,2919402052,487,2919402539,2951656511
2025-06-19 13:18:02,FAKE,2919402539,243,2919402782,2951656994
2025-06-19 13:18:04,REAL,2919402782,480,2919403262,2951657474
2025-06-19 13:18:06,FAKE,2919403262,243,2919403505,2951668392
2025-06-19 13:18:08,FAKE,2919403505,238,2919403743,2951680160
2025-06-19 13:18:10,REAL,2919403743,10254,2919413997,2951690414
2025-06-19 13:18:12,REAL,2919413997,10319,2919424316,2951700733
2025-06-19 13:18:14,FAKE,2919424316,241,2919424557,2951710978
2025-06-19 13:18:16,REAL,2919424557,10258,2919434815,2951721236
2025-06-19 13:18:18,FAKE,2919434815,241,2919435056,2951731550
2025-06-19 13:18:20,FAKE,2919435056,241,2919435297,2951739555
2025-06-19 13:18:22,REAL,2919435297,477,2919435774,2951740032
2025-06-19 13:18:24,FAKE,2919435774,238,2919436012,2951740513
2025-06-19 13:18:26,REAL,2919436012,485,2919436497,2951740998
2025-06-19 13:18:28,FAKE,2919436497,238,2919436735,2951741490
2025-06-19 13:18:30,REAL,2919436735,482,2919437217,2951741972
2025-06-19 13:18:32,REAL,2919437217,536,2919437753,2951742508
2025-06-19 13:18:34,FAKE,2919437753,244,2919437997,2951742992
2025-06-19 13:18:36,REAL,2919437997,479,2919438476,2951743471
2025-06-19 13:18:38,REAL,2919438476,9730,2919448206,2951753201
2025-06-19 13:18:40,REAL,2919448206,10451,2919458657,2951763652
2025-06-19 13:18:42,REAL,2919458657,10314,2919468971,2951773966
2025-06-19 13:18:44,REAL,2919468971,10254,2919479225,2951784220
2025-06-19 13:18:46,REAL,2919479225,10251,2919489476,2951794471
2025-06-19 13:18:48,REAL,2919489476,10314,2919499790,2951804785
2025-06-19 13:18:50,REAL,2919499790,10253,2919510043,2951815038
2025-06-19 13:18:52,REAL,2919510043,7347,2919517390,2951822385
2025-06-19 13:18:54,REAL,2919517390,484,2919517874,2951822869
2025-06-19 13:18:56,REAL,2919517874,483,2919518357,2951823352
2025-06-19 13:18:58,REAL,2919518357,487,2919518844,2951823839
2025-06-19 13:19:00,FAKE,2919518844,244,2919519088,2951824324
2025-06-19 13:19:02,FAKE,2919519088,244,2919519332,2951824807
2025-06-19 13:19:04,FAKE,2919519332,241,2919519573,2951825287
2025-06-19 13:19:06,FAKE,2919519573,244,2919519817,2951825773
2025-06-19 13:19:08,FAKE,2919519817,238,2919520055,2951826258
2025-06-19 13:19:10,REAL,2919520055,488,2919520543,2951826746
2025-06-19 13:19:12,REAL,2919520543,478,2919521021,2951827224
2025-06-19 13:19:14,FAKE,2919521021,244,2919521265,2951827705
2025-06-19 13:19:16,REAL,2919521265,481,2919521746,2951828186
2025-06-19 13:19:18,REAL,2919521746,539,2919522285,2951828725
2025-06-19 13:19:20,REAL,2919522285,486,2919522771,2951829211
2025-06-19 13:19:22,FAKE,2919522771,244,2919523015,2951829697
2025-06-19 13:19:24,REAL,2919523015,541,2919523556,2951830238
2025-06-19 13:19:26,REAL,2919523556,483,2919524039,2951830721
2025-06-19 13:19:28,REAL,2919524039,475,2919524514,2951831196
2025-06-19 13:19:30,REAL,2919524514,490,2919525004,2951831686
2025-06-19 13:19:32,FAKE,2919525004,241,2919525245,2951832168
2025-06-19 13:19:34,REAL,2919525245,482,2919525727,2951832650
2025-06-19 13:19:36,REAL,2919525727,483,2919526210,2951833133
2025-06-19 13:19:38,REAL,2919526210,490,2919526700,2951833623
2025-06-19 13:19:40,FAKE,2919526700,238,2919526938,2951834112
2025-06-19 13:19:42,REAL,2919526938,485,2919527423,2951834597
2025-06-19 13:19:44,REAL,2919527423,476,2919527899,2951835073
2025-06-19 13:19:46,REAL,2919527899,483,2919528382,2951835556
2025-06-19 13:19:48,REAL,2919528382,482,2919528864,2951836038
2025-06-19 13:19:50,REAL,2919528864,484,2919529348,2951836522
2025-06-19 13:19:52,REAL,2919529348,14283,2919543631,2951850805
2025-06-19 13:19:54,REAL,2919543631,10390,2919554021,2951861195
2025-06-19 13:19:56,REAL,2919554021,10248,2919564269,2951871443
2025-06-19 13:19:58,REAL,2919564269,10320,2919574589,2951881763
2025-06-19 13:20:00,FAKE,2919574589,243,2919574832,2951892015
2025-06-19 13:20:02,REAL,2919574832,10247,2919585079,2951902262
2025-06-19 13:20:04,FAKE,2919585079,244,2919585323,2951912519
2025-06-19 13:20:06,REAL,2919585323,6212,2919591535,2951918731
2025-06-19 13:20:08,FAKE,2919591535,244,2919591779,2951919206
2025-06-19 13:20:10,FAKE,2919591779,241,2919592020,2951919682
2025-06-19 13:20:12,FAKE,2919592020,243,2919592263,2951920163
2025-06-19 13:20:14,FAKE,2919592263,244,2919592507,2951920707
2025-06-19 13:20:16,REAL,2919592507,490,2919592997,2951921197
2025-06-19 13:20:18,REAL,2919592997,482,2919593479,2951921679
2025-06-19 13:20:20,REAL,2919593479,477,2919593956,2951922156
2025-06-19 13:20:22,FAKE,2919593956,238,2919594194,2951922635
2025-06-19 13:20:24,FAKE,2919594194,241,2919594435,2951923119
2025-06-19 13:20:26,REAL,2919594435,475,2919594910,2951923594
2025-06-19 13:20:28,REAL,2919594910,482,2919595392,2951924076
2025-06-19 13:20:30,REAL,2919595392,485,2919595877,2951924561
2025-06-19 13:20:32,REAL,2919595877,484,2919596361,2951925045
2025-06-19 13:20:34,REAL,2919596361,487,2919596848,2951925532
2025-06-19 13:20:36,REAL,2919596848,488,2919597336,2951926020
2025-06-19 13:20:38,REAL,2919597336,484,2919597820,2951926504
2025-06-19 13:20:40,FAKE,2919597820,238,2919598058,2951927037
2025-06-19 13:20:42,REAL,2919598058,488,2919598546,2951927525
2025-06-19 13:20:44,REAL,2919598546,487,2919599033,2951928012
2025-06-19 13:20:46,REAL,2919599033,477,2919599510,2951928489
2025-06-19 13:20:48,REAL,2919599510,486,2919599996,2951928975
2025-06-19 13:20:50,REAL,2919599996,487,2919600483,2951929462
2025-06-19 13:20:52,REAL,2919600483,539,2919601022,2951930001
2025-06-19 13:20:54,REAL,2919601022,490,2919601512,2951930491
2025-06-19 13:20:56,REAL,2919601512,487,2919601999,2951930978
2025-06-19 13:20:58,REAL,2919601999,481,2919602480,2951931459
2025-06-19 13:21:00,FAKE,2919602480,241,2919602721,2951931948
2025-06-19 13:21:02,REAL,2919602721,484,2919603205,2951932432
2025-06-19 13:21:04,FAKE,2919603205,238,2919603443,2951932972
2025-06-19 13:21:06,REAL,2919603443,487,2919603930,2951933459
2025-06-19 13:21:08,REAL,2919603930,489,2919604419,2951933948
2025-06-19 13:21:10,REAL,2919604419,493,2919604912,2951934441
2025-06-19 13:21:12,REAL,2919604912,493,2919605405,2951934934
2025-06-19 13:21:14,REAL,2919605405,484,2919605889,2951935418
2025-06-19 13:21:16,REAL,2919605889,483,2919606372,2951935901
2025-06-19 13:21:18,FAKE,2919606372,243,2919606615,2951936382
2025-06-19 13:21:20,REAL,2919606615,480,2919607095,2951936862
2025-06-19 13:21:22,REAL,2919607095,486,2919607581,2951937348
2025-06-19 13:21:24,REAL,2919607581,477,2919608058,2951937825
2025-06-19 13:21:26,REAL,2919608058,8413,2919616471,2951946238
2025-06-19 13:21:28,REAL,2919616471,13091,2919629562,2951959329
2025-06-19 13:21:30,FAKE,2919629562,238,2919629800,2951969645
2025-06-19 13:21:32,REAL,2919629800,10318,2919640118,2951979963
2025-06-19 13:21:34,REAL,2919640118,10257,2919650375,2951990220
2025-06-19 13:21:36,FAKE,2919650375,244,2919650619,2952000472
2025-06-19 13:21:38,REAL,2919650619,10315,2919660934,2952010787
2025-06-19 13:21:40,FAKE,2919660934,241,2919661175,2952020369
2025-06-19 13:21:42,REAL,2919661175,492,2919661667,2952020861
2025-06-19 13:21:44,FAKE,2919661667,244,2919661911,2952021344
2025-06-19 13:21:46,REAL,2919661911,480,2919662391,2952021824
2025-06-19 13:21:48,FAKE,2919662391,243,2919662634,2952022306
2025-06-19 13:21:50,REAL,2919662634,534,2919663168,2952022840
2025-06-19 13:21:52,REAL,2919663168,484,2919663652,2952023324
2025-06-19 13:21:54,FAKE,2919663652,241,2919663893,2952023805
2025-06-19 13:21:56,FAKE,2919663893,238,2919664131,2952024286
2025-06-19 13:21:58,REAL,2919664131,477,2919664608,2952024763
2025-06-19 13:22:00,REAL,2919664608,483,2919665091,2952025246
2025-06-19 13:22:02,FAKE,2919665091,238,2919665329,2952025724
2025-06-19 13:22:04,FAKE,2919665329,238,2919665567,2952026207
2025-06-19 13:22:06,REAL,2919665567,491,2919666058,2952026698
2025-06-19 13:22:08,REAL,2919666058,482,2919666540,2952027180
2025-06-19 13:22:10,FAKE,2919666540,238,2919666778,2952027664
2025-06-19 13:22:12,FAKE,2919666778,243,2919667021,2952028152
2025-06-19 13:22:14,REAL,2919667021,534,2919667555,2952028686
2025-06-19 13:22:16,REAL,2919667555,487,2919668042,2952029173
2025-06-19 13:22:18,REAL,2919668042,481,2919668523,2952029654
2025-06-19 13:22:20,REAL,2919668523,486,2919669009,2952030140
2025-06-19 13:22:22,REAL,2919669009,481,2919669490,2952030621
2025-06-19 13:22:24,FAKE,2919669490,244,2919669734,2952031111
2025-06-19 13:22:26,REAL,2919669734,543,2919670277,2952031654
2025-06-19 13:22:28,FAKE,2919670277,244,2919670521,2952033994
2025-06-19 13:22:30,REAL,2919670521,11233,2919681754,2952045227
2025-06-19 13:22:32,REAL,2919681754,10258,2919692012,2952055485
2025-06-19 13:22:34,REAL,2919692012,10315,2919702327,2952065800
2025-06-19 13:22:36,REAL,2919702327,10253,2919712580,2952076053
2025-06-19 13:22:38,REAL,2919712580,10253,2919722833,2952086306
2025-06-19 13:22:40,FAKE,2919722833,241,2919723074,2952096558
2025-06-19 13:22:42,REAL,2919723074,10254,2919733328,2952106812
2025-06-19 13:22:44,REAL,2919733328,3787,2919737115,2952110599
2025-06-19 13:22:46,REAL,2919737115,477,2919737592,2952111076
2025-06-19 13:22:48,REAL,2919737592,532,2919738124,2952111608
2025-06-19 13:22:50,REAL,2919738124,491,2919738615,2952112099
2025-06-19 13:22:52,REAL,2919738615,538,2919739153,2952112637
2025-06-19 13:22:54,FAKE,2919739153,243,2919739396,2952113120
2025-06-19 13:22:56,REAL,2919739396,481,2919739877,2952113601
2025-06-19 13:22:58,REAL,2919739877,488,2919740365,2952114089
2025-06-19 13:23:00,REAL,2919740365,483,2919740848,2952114572
2025-06-19 13:23:02,REAL,2919740848,487,2919741335,2952115059
2025-06-19 13:23:04,REAL,2919741335,486,2919741821,2952115545
2025-06-19 13:23:06,REAL,2919741821,480,2919742301,2952116025
2025-06-19 13:23:08,REAL,2919742301,488,2919742789,2952116513
2025-06-19 13:23:10,REAL,2919742789,481,2919743270,2952116994
2025-06-19 13:23:12,REAL,2919743270,545,2919743815,2952117539
2025-06-19 13:23:14,REAL,2919743815,489,2919744304,2952118028
2025-06-19 13:23:16,FAKE,2919744304,244,2919744548,2952118566
2025-06-19 13:23:18,REAL,2919744548,490,2919745038,2952119056
2025-06-19 13:23:20,REAL,2919745038,484,2919745522,2952119540
2025-06-19 13:23:22,REAL,2919745522,492,2919746014,2952120032
2025-06-19 13:23:24,REAL,2919746014,488,2919746502,2952120520
2025-06-19 13:23:26,FAKE,2919746502,243,2919746745,2952121010
2025-06-19 13:23:28,REAL,2919746745,490,2919747235,2952121500
2025-06-19 13:23:30,FAKE,2919747235,238,2919747473,2952121989
2025-06-19 13:23:32,FAKE,2919747473,244,2919747717,2952122467
2025-06-19 13:23:34,REAL,2919747717,538,2919748255,2952123005
2025-06-19 13:23:36,REAL,2919748255,489,2919748744,2952123494
2025-06-19 13:23:38,REAL,2919748744,490,2919749234,2952123984
2025-06-19 13:23:40,REAL,2919749234,486,2919749720,2952124470
2025-06-19 13:23:42,REAL,2919749720,548,2919750268,2952125018
2025-06-19 13:23:44,REAL,2919750268,487,2919750755,2952125505
2025-06-19 13:23:46,REAL,2919750755,477,2919751232,2952125982
2025-06-19 13:23:48,FAKE,2919751232,244,2919751476,2952126465
2025-06-19 13:23:50,REAL,2919751476,484,2919751960,2952126949
2025-06-19 13:23:52,REAL,2919751960,479,2919752439,2952127428
2025-06-19 13:23:54,FAKE,2919752439,243,2919752682,2952127917
2025-06-19 13:23:56,REAL,2919752682,539,2919753221,2952128456
2025-06-19 13:23:58,FAKE,2919753221,241,2919753462,2952132714
2025-06-19 13:24:00,REAL,2919753462,11305,2919764767,2952144019
2025-06-19 13:24:02,REAL,2919764767,10253,2919775020,2952154272
2025-06-19 13:24:04,REAL,2919775020,10315,2919785335,2952164587
2025-06-19 13:24:06,FAKE,2919785335,241,2919785576,2952174839
2025-06-19 13:24:08,FAKE,2919785576,241,2919785817,2952185083
2025-06-19 13:24:10,FAKE,2919785817,243,2919786060,2952195399
2025-06-19 13:24:12,FAKE,2919786060,238,2919786298,2952205650
2025-06-19 13:24:14,REAL,2919786298,2133,2919788431,2952207783
2025-06-19 13:24:16,REAL,2919788431,484,2919788915,2952208267
2025-06-19 13:24:18,REAL,2919788915,536,2919789451,2952208803
2025-06-19 13:24:20,FAKE,2919789451,244,2919789695,2952209285
2025-06-19 13:24:22,FAKE,2919789695,241,2919789936,2952209820
2025-06-19 13:24:24,REAL,2919789936,486,2919790422,2952210306
2025-06-19 13:24:26,REAL,2919790422,477,2919790899,2952210783
2025-06-19 13:24:28,REAL,2919790899,486,2919791385,2952211269
2025-06-19 13:24:30,REAL,2919791385,4907,2919796292,2952216176
2025-06-19 13:24:32,FAKE,2919796292,243,2919796535,2952228083
2025-06-19 13:24:34,REAL,2919796535,10253,2919806788,2952238336
2025-06-19 13:24:36,FAKE,2919806788,243,2919807031,2952248656
2025-06-19 13:24:38,REAL,2919807031,10251,2919817282,2952258907
2025-06-19 13:24:40,REAL,2919817282,10250,2919827532,2952269157
2025-06-19 13:24:42,REAL,2919827532,10377,2919837909,2952279534
2025-06-19 13:24:44,REAL,2919837909,10255,2919848164,2952289789
2025-06-19 13:24:46,REAL,2919848164,1531,2919849695,2952291320
2025-06-19 13:24:48,FAKE,2919849695,238,2919849933,2952291802
2025-06-19 13:24:50,REAL,2919849933,488,2919850421,2952292290
2025-06-19 13:24:52,FAKE,2919850421,241,2919850662,2952292775
2025-06-19 13:24:54,REAL,2919850662,534,2919851196,2952293309
2025-06-19 13:24:56,REAL,2919851196,486,2919851682,2952293795
2025-06-19 13:24:58,REAL,2919851682,490,2919852172,2952294285
2025-06-19 13:25:00,REAL,2919852172,478,2919852650,2952294763
2025-06-19 13:25:02,REAL,2919852650,482,2919853132,2952295245
2025-06-19 13:25:04,FAKE,2919853132,244,2919853376,2952295784
2025-06-19 13:25:06,REAL,2919853376,485,2919853861,2952296269
2025-06-19 13:25:08,REAL,2919853861,483,2919854344,2952296752
2025-06-19 13:25:10,REAL,2919854344,480,2919854824,2952297232
2025-06-19 13:25:12,REAL,2919854824,484,2919855308,2952297716
2025-06-19 13:25:14,REAL,2919855308,489,2919855797,2952298205
2025-06-19 13:25:16,FAKE,2919855797,241,2919856038,2952298687
2025-06-19 13:25:18,FAKE,2919856038,244,2919856282,2952299176
2025-06-19 13:25:20,FAKE,2919856282,243,2919856525,2952299657
2025-06-19 13:25:22,REAL,2919856525,488,2919857013,2952300145
2025-06-19 13:25:24,REAL,2919857013,15025,2919872038,2952315170
2025-06-19 13:25:26,FAKE,2919872038,238,2919872276,2952325546
2025-06-19 13:25:28,REAL,2919872276,10246,2919882522,2952335792
2025-06-19 13:25:30,FAKE,2919882522,243,2919882765,2952346043
2025-06-19 13:25:32,REAL,2919882765,10249,2919893014,2952356292
2025-06-19 13:25:34,FAKE,2919893014,238,2919893252,2952366539
2025-06-19 13:25:36,REAL,2919893252,10258,2919903510,2952376797
2025-06-19 13:25:38,FAKE,2919903510,241,2919903751,2952382228
2025-06-19 13:25:40,FAKE,2919903751,241,2919903992,2952382710
2025-06-19 13:25:42,REAL,2919903992,488,2919904480,2952383198
2025-06-19 13:25:44,REAL,2919904480,479,2919904959,2952383677
2025-06-19 13:25:46,REAL,2919904959,479,2919905438,2952384156
2025-06-19 13:25:48,REAL,2919905438,546,2919905984,2952384702
2025-06-19 13:25:50,FAKE,2919905984,238,2919906222,2952385190
2025-06-19 13:25:52,REAL,2919906222,487,2919906709,2952385677
2025-06-19 13:25:54,FAKE,2919906709,244,2919906953,2952386573
2025-06-19 13:25:56,REAL,2919906953,11978,2919918931,2952398551
2025-06-19 13:25:58,REAL,2919918931,10251,2919929182,2952408802
2025-06-19 13:26:00,REAL,2919929182,10319,2919939501,2952419121
2025-06-19 13:26:02,FAKE,2919939501,243,2919939744,2952429364
2025-06-19 13:26:04,FAKE,2919939744,241,2919939985,2952439619
2025-06-19 13:26:06,REAL,2919939985,10325,2919950310,2952449944
2025-06-19 13:26:08,REAL,2919950310,10254,2919960564,2952460198
2025-06-19 13:26:10,REAL,2919960564,4782,2919965346,2952464980
2025-06-19 13:26:12,REAL,2919965346,547,2919965893,2952465527
2025-06-19 13:26:14,REAL,2919965893,482,2919966375,2952466009
2025-06-19 13:26:16,FAKE,2919966375,244,2919966619,2952466494
2025-06-19 13:26:18,FAKE,2919966619,243,2919966862,2952466980
2025-06-19 13:26:20,FAKE,2919966862,243,2919967105,2952467465
2025-06-19 13:26:22,REAL,2919967105,486,2919967591,2952467951
2025-06-19 13:26:24,REAL,2919967591,480,2919968071,2952468431
2025-06-19 13:26:26,FAKE,2919968071,238,2919968309,2952468920
2025-06-19 13:26:28,REAL,2919968309,484,2919968793,2952469404
2025-06-19 13:26:30,FAKE,2919968793,241,2919969034,2952469891
2025-06-19 13:26:32,REAL,2919969034,489,2919969523,2952470380
2025-06-19 13:26:34,REAL,2919969523,538,2919970061,2952470918
2025-06-19 13:26:36,FAKE,2919970061,244,2919970305,2952471461
2025-06-19 13:26:38,REAL,2919970305,490,2919970795,2952471951
2025-06-19 13:26:40,FAKE,2919970795,241,2919971036,2952472441
2025-06-19 13:26:42,REAL,2919971036,489,2919971525,2952472930
2025-06-19 13:26:44,REAL,2919971525,490,2919972015,2952473420
2025-06-19 13:26:46,FAKE,2919972015,243,2919972258,2952473906
2025-06-19 13:26:48,REAL,2919972258,481,2919972739,2952474387
2025-06-19 13:26:50,REAL,2919972739,489,2919973228,2952474876
2025-06-19 13:26:52,FAKE,2919973228,244,2919973472,2952475353
2025-06-19 13:26:54,REAL,2919973472,476,2919973948,2952475829
2025-06-19 13:26:56,REAL,2919973948,479,2919974427,2952476308
2025-06-19 13:26:58,REAL,2919974427,545,2919974972,2952476853
2025-06-19 13:27:00,REAL,2919974972,485,2919975457,2952477338
2025-06-19 13:27:02,FAKE,2919975457,244,2919975701,2952477823
2025-06-19 13:27:04,REAL,2919975701,9995,2919985696,2952487818
2025-06-19 13:27:06,REAL,2919985696,12165,2919997861,2952499983
2025-06-19 13:27:08,REAL,2919997861,10255,2920008116,2952510238
2025-06-19 13:27:10,REAL,2920008116,10320,2920018436,2952520558
2025-06-19 13:27:12,FAKE,2920018436,238,2920018674,2952530809
2025-06-19 13:27:14,FAKE,2920018674,241,2920018915,2952541132
2025-06-19 13:27:16,FAKE,2920018915,243,2920019158,2952551385
2025-06-19 13:27:18,REAL,2920019158,8406,2920027564,2952559791
2025-06-19 13:27:20,REAL,2920027564,482,2920028046,2952560273
2025-06-19 13:27:22,REAL,2920028046,477,2920028523,2952560750
2025-06-19 13:27:24,REAL,2920028523,482,2920029005,2952561232
2025-06-19 13:27:26,FAKE,2920029005,243,2920029248,2952561722
2025-06-19 13:27:28,REAL,2920029248,487,2920029735,2952562209
2025-06-19 13:27:30,REAL,2920029735,485,2920030220,2952562694
2025-06-19 13:27:32,REAL,2920030220,483,2920030703,2952563177
2025-06-19 13:27:34,FAKE,2920030703,241,2920030944,2952563660
2025-06-19 13:27:36,REAL,2920030944,8942,2920039886,2952572602
2025-06-19 13:27:38,REAL,2920039886,10576,2920050462,2952583178
2025-06-19 13:27:40,REAL,2920050462,10313,2920060775,2952593491
2025-06-19 13:27:42,REAL,2920060775,10307,2920071082,2952603798
2025-06-19 13:27:44,FAKE,2920071082,238,2920071320,2952614115
2025-06-19 13:27:46,FAKE,2920071320,243,2920071563,2952624367
2025-06-19 13:27:48,REAL,2920071563,10248,2920081811,2952634615
2025-06-19 13:27:50,REAL,2920081811,7807,2920089618,2952642422
2025-06-19 13:27:52,REAL,2920089618,491,2920090109,2952642913
2025-06-19 13:27:54,REAL,2920090109,479,2920090588,2952643392
2025-06-19 13:27:56,REAL,2920090588,486,2920091074,2952643878
2025-06-19 13:27:58,REAL,2920091074,494,2920091568,2952644372
2025-06-19 13:28:00,REAL,2920091568,479,2920092047,2952644851
2025-06-19 13:28:02,FAKE,2920092047,244,2920092291,2952645334
2025-06-19 13:28:04,REAL,2920092291,476,2920092767,2952645810
2025-06-19 13:28:06,REAL,2920092767,481,2920093248,2952646291
2025-06-19 13:28:08,REAL,2920093248,479,2920093727,2952646770
2025-06-19 13:28:10,FAKE,2920093727,241,2920093968,2952647254
2025-06-19 13:28:12,REAL,2920093968,478,2920094446,2952647732
2025-06-19 13:28:14,REAL,2920094446,480,2920094926,2952648212
2025-06-19 13:28:16,REAL,2920094926,490,2920095416,2952648702
2025-06-19 13:28:18,REAL,2920095416,535,2920095951,2952649237
2025-06-19 13:28:20,REAL,2920095951,481,2920096432,2952649718
2025-06-19 13:28:22,REAL,2920096432,482,2920096914,2952650200
2025-06-19 13:28:24,FAKE,2920096914,241,2920097155,2952650737
2025-06-19 13:28:26,REAL,2920097155,484,2920097639,2952651221
2025-06-19 13:28:28,REAL,2920097639,475,2920098114,2952651696
2025-06-19 13:28:30,REAL,2920098114,485,2920098599,2952652181
2025-06-19 13:28:32,REAL,2920098599,481,2920099080,2952652662
2025-06-19 13:28:34,REAL,2920099080,483,2920099563,2952653145
2025-06-19 13:28:36,FAKE,2920099563,243,2920099806,2952653636
2025-06-19 13:28:38,REAL,2920099806,490,2920100296,2952654126
2025-06-19 13:28:40,REAL,2920100296,480,2920100776,2952654606
2025-06-19 13:28:42,FAKE,2920100776,241,2920101017,2952655086
2025-06-19 13:28:44,REAL,2920101017,483,2920101500,2952655569
2025-06-19 13:28:46,FAKE,2920101500,241,2920101741,2952656049
2025-06-19 13:28:48,FAKE,2920101741,238,2920101979,2952656534
2025-06-19 13:28:50,FAKE,2920101979,238,2920102217,2952669696
2025-06-19 13:28:52,REAL,2920102217,10717,2920112934,2952680413
2025-06-19 13:28:54,REAL,2920112934,10320,2920123254,2952690733
2025-06-19 13:28:56,REAL,2920123254,10245,2920133499,2952700978
2025-06-19 13:28:58,FAKE,2920133499,244,2920133743,2952711303
2025-06-19 13:29:00,FAKE,2920133743,238,2920133981,2952721565
2025-06-19 13:29:02,REAL,2920133981,10322,2920144303,2952731887
2025-06-19 13:29:04,REAL,2920144303,6553,2920150856,2952738440
2025-06-19 13:29:06,REAL,2920150856,482,2920151338,2952738922
2025-06-19 13:29:08,REAL,2920151338,535,2920151873,2952739457
2025-06-19 13:29:10,REAL,2920151873,486,2920152359,2952739943
2025-06-19 13:29:12,REAL,2920152359,484,2920152843,2952740427
2025-06-19 13:29:14,REAL,2920152843,486,2920153329,2952740913
2025-06-19 13:29:16,REAL,2920153329,478,2920153807,2952741391
2025-06-19 13:29:18,REAL,2920153807,484,2920154291,2952741875
2025-06-19 13:29:20,REAL,2920154291,483,2920154774,2952742358
2025-06-19 13:29:22,REAL,2920154774,14088,2920168862,2952756446
2025-06-19 13:29:24,REAL,2920168862,10389,2920179251,2952766835
2025-06-19 13:29:26,REAL,2920179251,10253,2920189504,2952777088
2025-06-19 13:29:28,REAL,2920189504,10247,2920199751,2952787335
2025-06-19 13:29:30,FAKE,2920199751,238,2920199989,2952797589
2025-06-19 13:29:32,REAL,2920199989,10252,2920210241,2952807841
2025-06-19 13:29:34,FAKE,2920210241,244,2920210485,2952818086
2025-06-19 13:29:36,FAKE,2920210485,238,2920210723,2952824114
2025-06-19 13:29:38,REAL,2920210723,490,2920211213,2952824604
2025-06-19 13:29:40,FAKE,2920211213,243,2920211456,2952825083
2025-06-19 13:29:42,FAKE,2920211456,241,2920211697,2952825572
2025-06-19 13:29:44,REAL,2920211697,479,2920212176,2952826051
2025-06-19 13:29:46,REAL,2920212176,479,2920212655,2952826530
2025-06-19 13:29:48,FAKE,2920212655,243,2920212898,2952827016
2025-06-19 13:29:50,REAL,2920212898,541,2920213439,2952827557
2025-06-19 13:29:52,FAKE,2920213439,238,2920213677,2952828038
2025-06-19 13:29:54,REAL,2920213677,486,2920214163,2952828524
2025-06-19 13:29:56,FAKE,2920214163,244,2920214407,2952829006
2025-06-19 13:29:58,REAL,2920214407,483,2920214890,2952829489
2025-06-19 13:30:00,REAL,2920214890,480,2920215370,2952829969
2025-06-19 13:30:02,REAL,2920215370,479,2920215849,2952830448
2025-06-19 13:30:04,REAL,2920215849,493,2920216342,2952830941
2025-06-19 13:30:06,REAL,2920216342,543,2920216885,2952831484
2025-06-19 13:30:08,REAL,2920216885,484,2920217369,2952831968
2025-06-19 13:30:10,FAKE,2920217369,244,2920217613,2952832448
2025-06-19 13:30:12,REAL,2920217613,482,2920218095,2952832930
2025-06-19 13:30:14,REAL,2920218095,481,2920218576,2952833411
2025-06-19 13:30:16,FAKE,2920218576,238,2920218814,2952833902
2025-06-19 13:30:18,REAL,2920218814,482,2920219296,2952834384
2025-06-19 13:30:20,REAL,2920219296,489,2920219785,2952834873
2025-06-19 13:30:22,FAKE,2920219785,244,2920220029,2952835365
2025-06-19 13:30:24,FAKE,2920220029,243,2920220272,2952835850
2025-06-19 13:30:26,FAKE,2920220272,244,2920220516,2952836342
2025-06-19 13:30:28,REAL,2920220516,486,2920221002,2952836828
2025-06-19 13:30:30,REAL,2920221002,480,2920221482,2952837308
2025-06-19 13:30:32,REAL,2920221482,487,2920221969,2952837795
2025-06-19 13:30:34,REAL,2920221969,540,2920222509,2952838335
2025-06-19 13:30:36,REAL,2920222509,480,2920222989,2952838815
2025-06-19 13:30:38,REAL,2920222989,482,2920223471,2952839297
2025-06-19 13:30:40,REAL,2920223471,1676,2920225147,2952840973
2025-06-19 13:30:42,REAL,2920225147,11786,2920236933,2952852759
2025-06-19 13:30:44,FAKE,2920236933,243,2920237176,2952863014
2025-06-19 13:30:46,REAL,2920237176,10308,2920247484,2952873322
2025-06-19 13:30:48,REAL,2920247484,10255,2920257739,2952883577
2025-06-19 13:30:50,REAL,2920257739,10322,2920268061,2952893899
2025-06-19 13:30:52,REAL,2920268061,10259,2920278320,2952904158
2025-06-19 13:30:54,REAL,2920278320,10323,2920288643,2952914481
2025-06-19 13:30:56,REAL,2920288643,4371,2920293014,2952918852
2025-06-19 13:30:58,FAKE,2920293014,238,2920293252,2952919340
2025-06-19 13:31:00,FAKE,2920293252,244,2920293496,2952919823
2025-06-19 13:31:02,FAKE,2920293496,238,2920293734,2952920299
2025-06-19 13:31:04,REAL,2920293734,485,2920294219,2952920784
2025-06-19 13:31:06,REAL,2920294219,485,2920294704,2952921269
2025-06-19 13:31:08,REAL,2920294704,487,2920295191,2952921756
2025-06-19 13:31:10,REAL,2920295191,476,2920295667,2952922232
2025-06-19 13:31:12,REAL,2920295667,484,2920296151,2952922716
2025-06-19 13:31:14,FAKE,2920296151,243,2920296394,2952923208
2025-06-19 13:31:16,REAL,2920296394,488,2920296882,2952923696
2025-06-19 13:31:18,FAKE,2920296882,243,2920297125,2952924242
2025-06-19 13:31:20,REAL,2920297125,485,2920297610,2952924727
2025-06-19 13:31:22,REAL,2920297610,478,2920298088,2952925205
2025-06-19 13:31:24,REAL,2920298088,483,2920298571,2952925688
2025-06-19 13:31:26,REAL,2920298571,546,2920299117,2952926234
2025-06-19 13:31:28,FAKE,2920299117,241,2920299358,2952926725
2025-06-19 13:31:30,REAL,2920299358,484,2920299842,2952927209
2025-06-19 13:31:32,FAKE,2920299842,241,2920300083,2952927686
2025-06-19 13:31:34,FAKE,2920300083,244,2920300327,2952928170
2025-06-19 13:31:36,REAL,2920300327,478,2920300805,2952928648
2025-06-19 13:31:38,REAL,2920300805,487,2920301292,2952929135
2025-06-19 13:31:40,REAL,2920301292,482,2920301774,2952929617
2025-06-19 13:31:42,FAKE,2920301774,244,2920302018,2952930107
2025-06-19 13:31:44,REAL,2920302018,489,2920302507,2952930596
2025-06-19 13:31:46,FAKE,2920302507,243,2920302750,2952931077
2025-06-19 13:31:48,REAL,2920302750,481,2920303231,2952931558
2025-06-19 13:31:50,REAL,2920303231,480,2920303711,2952932038
2025-06-19 13:31:52,REAL,2920303711,488,2920304199,2952932526
2025-06-19 13:31:54,REAL,2920304199,2802,2920307001,2952935328
2025-06-19 13:31:56,REAL,2920307001,11572,2920318573,2952946900
2025-06-19 13:31:58,REAL,2920318573,10261,2920328834,2952957161
2025-06-19 13:32:00,FAKE,2920328834,243,2920329077,2952967414
2025-06-19 13:32:02,REAL,2920329077,10376,2920339453,2952977790
2025-06-19 13:32:04,REAL,2920339453,10249,2920349702,2952988039
2025-06-19 13:32:06,REAL,2920349702,10249,2920359951,2952998288
2025-06-19 13:32:08,REAL,2920359951,10311,2920370262,2953008599
2025-06-19 13:32:10,REAL,2920370262,3195,2920373457,2953011794
2025-06-19 13:32:12,REAL,2920373457,482,2920373939,2953012276
2025-06-19 13:32:14,REAL,2920373939,483,2920374422,2953012759
2025-06-19 13:32:16,FAKE,2920374422,244,2920374666,2953013242
2025-06-19 13:32:18,FAKE,2920374666,244,2920374910,2953013727
2025-06-19 13:32:20,REAL,2920374910,481,2920375391,2953014208
2025-06-19 13:32:22,FAKE,2920375391,243,2920375634,2953014688
2025-06-19 13:32:24,REAL,2920375634,477,2920376111,2953015165
2025-06-19 13:32:26,REAL,2920376111,489,2920376600,2953015654
2025-06-19 13:32:28,REAL,2920376600,483,2920377083,2953016137
2025-06-19 13:32:30,FAKE,2920377083,244,2920377327,2953016383
2025-06-19 13:32:32,FAKE,2920377327,243,2920377570,2953016874
2025-06-19 13:32:34,FAKE,2920377570,238,2920377808,2953017362
2025-06-19 13:32:36,REAL,2920377808,476,2920378284,2953017838
2025-06-19 13:32:38,REAL,2920378284,479,2920378763,2953018317
2025-06-19 13:32:40,REAL,2920378763,548,2920379311,2953018865
2025-06-19 13:32:42,FAKE,2920379311,238,2920379549,2953019346
2025-06-19 13:32:44,REAL,2920379549,479,2920380028,2953019825
2025-06-19 13:32:46,REAL,2920380028,3856,2920383884,2953023681
2025-06-19 13:32:48,REAL,2920383884,13017,2920396901,2953036698
2025-06-19 13:32:50,REAL,2920396901,10252,2920407153,2953046950
2025-06-19 13:32:52,REAL,2920407153,10250,2920417403,2953057200
2025-06-19 13:32:54,FAKE,2920417403,243,2920417646,2953067455
2025-06-19 13:32:56,REAL,2920417646,10328,2920427974,2953077783
2025-06-19 13:32:58,FAKE,2920427974,241,2920428215,2953088030
2025-06-19 13:33:00,REAL,2920428215,10249,2920438464,2953098279
2025-06-19 13:33:02,FAKE,2920438464,238,2920438702,2953101004
2025-06-19 13:33:04,REAL,2920438702,483,2920439185,2953101487
2025-06-19 13:33:06,FAKE,2920439185,244,2920439429,2953101975
2025-06-19 13:33:08,REAL,2920439429,10397,2920449826,2953112372
2025-06-19 13:33:10,FAKE,2920449826,243,2920450069,2953122959
2025-06-19 13:33:12,REAL,2920450069,10323,2920460392,2953133282
2025-06-19 13:33:14,REAL,2920460392,10251,2920470643,2953143533
2025-06-19 13:33:16,FAKE,2920470643,238,2920470881,2953153783
2025-06-19 13:33:18,REAL,2920470881,10250,2920481131,2953164033
2025-06-19 13:33:20,REAL,2920481131,10316,2920491447,2953174349
2025-06-19 13:33:22,REAL,2920491447,7288,2920498735,2953181637
2025-06-19 13:33:24,REAL,2920498735,483,2920499218,2953182120
2025-06-19 13:33:26,REAL,2920499218,494,2920499712,2953182614
2025-06-19 13:33:28,FAKE,2920499712,238,2920499950,2953183093
2025-06-19 13:33:30,FAKE,2920499950,244,2920500194,2953183640
2025-06-19 13:33:32,REAL,2920500194,475,2920500669,2953184115
2025-06-19 13:33:34,REAL,2920500669,485,2920501154,2953184600
2025-06-19 13:33:36,REAL,2920501154,726,2920501880,2953185326
2025-06-19 13:33:38,REAL,2920501880,245,2920502125,2953185571
2025-06-19 13:33:40,FAKE,2920502125,244,2920502369,2953186054
2025-06-19 13:33:42,REAL,2920502369,483,2920502852,2953186537
2025-06-19 13:33:44,REAL,2920502852,485,2920503337,2953187022
2025-06-19 13:33:46,REAL,2920503337,482,2920503819,2953187504
2025-06-19 13:33:48,REAL,2920503819,486,2920504305,2953187990
2025-06-19 13:33:50,REAL,2920504305,482,2920504787,2953188472
2025-06-19 13:33:52,REAL,2920504787,488,2920505275,2953188960
2025-06-19 13:33:54,FAKE,2920505275,244,2920505519,2953189506
2025-06-19 13:33:56,REAL,2920505519,483,2920506002,2953189989
2025-06-19 13:33:58,FAKE,2920506002,241,2920506243,2953190482
2025-06-19 13:34:00,FAKE,2920506243,244,2920506487,2953190960
2025-06-19 13:34:02,REAL,2920506487,480,2920506967,2953191440
2025-06-19 13:34:04,REAL,2920506967,474,2920507441,2953191914
2025-06-19 13:34:06,REAL,2920507441,484,2920507925,2953192398
2025-06-19 13:34:08,REAL,2920507925,484,2920508409,2953192882
2025-06-19 13:34:10,REAL,2920508409,480,2920508889,2953193362
2025-06-19 13:34:12,FAKE,2920508889,238,2920509127,2953193843
2025-06-19 13:34:14,REAL,2920509127,540,2920509667,2953194383
2025-06-19 13:34:16,REAL,2920509667,484,2920510151,2953194867
2025-06-19 13:34:18,REAL,2920510151,478,2920510629,2953195345
2025-06-19 13:34:20,FAKE,2920510629,238,2920510867,2953195837
2025-06-19 13:34:22,FAKE,2920510867,243,2920511110,2953196325
2025-06-19 13:34:24,FAKE,2920511110,243,2920511353,2953196817
2025-06-19 13:34:26,REAL,2920511353,487,2920511840,2953197304
2025-06-19 13:34:28,FAKE,2920511840,241,2920512081,2953208876
2025-06-19 13:34:30,REAL,2920512081,10319,2920522400,2953219195
2025-06-19 13:34:32,FAKE,2920522400,241,2920522641,2953229439
2025-06-19 13:34:34,FAKE,2920522641,238,2920522879,2953239686
2025-06-19 13:34:36,REAL,2920522879,10248,2920533127,2953249934
2025-06-19 13:34:38,REAL,2920533127,10183,2920543310,2953260117
2025-06-19 13:34:40,REAL,2920543310,10252,2920553562,2953270369
2025-06-19 13:34:42,REAL,2920553562,5762,2920559324,2953276131
2025-06-19 13:34:44,REAL,2920559324,485,2920559809,2953276616
2025-06-19 13:34:46,FAKE,2920559809,243,2920560052,2953277110
2025-06-19 13:34:48,FAKE,2920560052,238,2920560290,2953277601
2025-06-19 13:34:50,FAKE,2920560290,244,2920560534,2953278085
2025-06-19 13:34:52,REAL,2920560534,476,2920561010,2953278561
2025-06-19 13:34:54,FAKE,2920561010,243,2920561253,2953279039
2025-06-19 13:34:56,REAL,2920561253,543,2920561796,2953279582
2025-06-19 13:34:58,REAL,2920561796,489,2920562285,2953280071
2025-06-19 13:35:00,REAL,2920562285,485,2920562770,2953280556
2025-06-19 13:35:02,REAL,2920562770,485,2920563255,2953281041
2025-06-19 13:35:04,REAL,2920563255,482,2920563737,2953281523
2025-06-19 13:35:06,FAKE,2920563737,243,2920563980,2953282011
2025-06-19 13:35:08,FAKE,2920563980,243,2920564223,2953282503
2025-06-19 13:35:10,FAKE,2920564223,243,2920564466,2953282982
2025-06-19 13:35:12,REAL,2920564466,486,2920564952,2953283468
2025-06-19 13:35:14,REAL,2920564952,539,2920565491,2953284007
2025-06-19 13:35:16,FAKE,2920565491,244,2920565735,2953284484
2025-06-19 13:35:18,FAKE,2920565735,241,2920565976,2953284970
2025-06-19 13:35:20,REAL,2920565976,488,2920566464,2953285458
2025-06-19 13:35:22,REAL,2920566464,481,2920566945,2953285939
2025-06-19 13:35:24,FAKE,2920566945,238,2920567183,2953286417
2025-06-19 13:35:26,REAL,2920567183,474,2920567657,2953286891
2025-06-19 13:35:28,REAL,2920567657,475,2920568132,2953287366
2025-06-19 13:35:30,REAL,2920568132,481,2920568613,2953287847
2025-06-19 13:35:32,FAKE,2920568613,241,2920568854,2953288334
2025-06-19 13:35:34,REAL,2920568854,487,2920569341,2953288821
2025-06-19 13:35:36,REAL,2920569341,484,2920569825,2953289305
2025-06-19 13:35:38,FAKE,2920569825,238,2920570063,2953289788
2025-06-19 13:35:40,REAL,2920570063,1526,2920571589,2953291314
2025-06-19 13:35:42,REAL,2920571589,11510,2920583099,2953302824
2025-06-19 13:35:44,REAL,2920583099,10254,2920593353,2953313078
2025-06-19 13:35:46,REAL,2920593353,10249,2920603602,2953323327
2025-06-19 13:35:48,FAKE,2920603602,238,2920603840,2953333639
2025-06-19 13:35:50,FAKE,2920603840,243,2920604083,2953343895
2025-06-19 13:35:52,REAL,2920604083,10253,2920614336,2953354148
2025-06-19 13:35:54,REAL,2920614336,10309,2920624645,2953364457
2025-06-19 13:35:56,REAL,2920624645,4513,2920629158,2953368970
2025-06-19 13:35:58,REAL,2920629158,480,2920629638,2953369450
2025-06-19 13:36:00,FAKE,2920629638,241,2920629879,2953369939
2025-06-19 13:36:02,REAL,2920629879,486,2920630365,2953370425
2025-06-19 13:36:04,REAL,2920630365,483,2920630848,2953370908
2025-06-19 13:36:06,FAKE,2920630848,244,2920631092,2953371448
2025-06-19 13:36:08,REAL,2920631092,481,2920631573,2953371929
2025-06-19 13:36:10,FAKE,2920631573,243,2920631816,2953372422
2025-06-19 13:36:12,REAL,2920631816,484,2920632300,2953372906
2025-06-19 13:36:14,REAL,2920632300,488,2920632788,2953373394
2025-06-19 13:36:16,FAKE,2920632788,244,2920633032,2953373876
2025-06-19 13:36:18,REAL,2920633032,484,2920633516,2953374360
2025-06-19 13:36:20,REAL,2920633516,493,2920634009,2953374853
2025-06-19 13:36:22,REAL,2920634009,542,2920634551,2953375395
2025-06-19 13:36:24,REAL,2920634551,478,2920635029,2953375873
2025-06-19 13:36:26,REAL,2920635029,484,2920635513,2953376357
2025-06-19 13:36:28,REAL,2920635513,8482,2920643995,2953384839
2025-06-19 13:36:30,FAKE,2920643995,238,2920644233,2953395353
2025-06-19 13:36:32,FAKE,2920644233,238,2920644471,2953405601
2025-06-19 13:36:34,REAL,2920644471,10322,2920654793,2953415923
2025-06-19 13:36:36,REAL,2920654793,10249,2920665042,2953426172
2025-06-19 13:36:38,REAL,2920665042,10259,2920675301,2953436431
2025-06-19 13:36:40,REAL,2920675301,10319,2920685620,2953446750
2025-06-19 13:36:42,REAL,2920685620,8861,2920694481,2953455611
2025-06-19 13:36:44,REAL,2920694481,484,2920694965,2953456095
2025-06-19 13:36:46,REAL,2920694965,484,2920695449,2953456579
2025-06-19 13:36:48,FAKE,2920695449,244,2920695693,2953457066
2025-06-19 13:36:50,REAL,2920695693,484,2920696177,2953457550
2025-06-19 13:36:52,REAL,2920696177,543,2920696720,2953458093
2025-06-19 13:36:54,REAL,2920696720,485,2920697205,2953458578
2025-06-19 13:36:56,FAKE,2920697205,241,2920697446,2953459071
2025-06-19 13:36:58,FAKE,2920697446,244,2920697690,2953459556
2025-06-19 13:37:00,REAL,2920697690,493,2920698183,2953460049
2025-06-19 13:37:02,REAL,2920698183,478,2920698661,2953460527
2025-06-19 13:37:04,REAL,2920698661,486,2920699147,2953461013
2025-06-19 13:37:06,FAKE,2920699147,243,2920699390,2953461550
2025-06-19 13:37:08,REAL,2920699390,481,2920699871,2953462031
2025-06-19 13:37:10,REAL,2920699871,486,2920700357,2953462517
2025-06-19 13:37:12,REAL,2920700357,479,2920700836,2953462996
2025-06-19 13:37:14,FAKE,2920700836,244,2920701080,2953463476
2025-06-19 13:37:16,FAKE,2920701080,238,2920701318,2953464015
2025-06-19 13:37:18,FAKE,2920701318,244,2920701562,2953464498
2025-06-19 13:37:20,FAKE,2920701562,241,2920701803,2953467563
2025-06-19 13:37:22,REAL,2920701803,11581,2920713384,2953479144
2025-06-19 13:37:24,REAL,2920713384,10254,2920723638,2953489398
2025-06-19 13:37:26,REAL,2920723638,10309,2920733947,2953499707
2025-06-19 13:37:28,REAL,2920733947,10253,2920744200,2953509960
2025-06-19 13:37:30,REAL,2920744200,10247,2920754447,2953520207
2025-06-19 13:37:32,REAL,2920754447,10252,2920764699,2953530459
2025-06-19 13:37:34,REAL,2920764699,10314,2920775013,2953540773
2025-06-19 13:37:36,REAL,2920775013,2987,2920778000,2953543760
2025-06-19 13:37:38,FAKE,2920778000,238,2920778238,2953544238
2025-06-19 13:37:40,REAL,2920778238,484,2920778722,2953544722
2025-06-19 13:37:42,FAKE,2920778722,244,2920778966,2953556823
2025-06-19 13:37:44,REAL,2920778966,11912,2920790878,2953568735
2025-06-19 13:37:46,REAL,2920790878,10249,2920801127,2953578984
2025-06-19 13:37:48,REAL,2920801127,10300,2920811427,2953589284
2025-06-19 13:37:50,REAL,2920811427,10319,2920821746,2953599603
2025-06-19 13:37:52,FAKE,2920821746,244,2920821990,2953609861
2025-06-19 13:37:54,REAL,2920821990,10257,2920832247,2953620118
2025-06-19 13:37:56,REAL,2920832247,7480,2920839727,2953627598
2025-06-19 13:37:58,REAL,2920839727,479,2920840206,2953628077
2025-06-19 13:38:00,REAL,2920840206,491,2920840697,2953628568
2025-06-19 13:38:02,REAL,2920840697,486,2920841183,2953629054
2025-06-19 13:38:04,REAL,2920841183,475,2920841658,2953629529
2025-06-19 13:38:06,REAL,2920841658,540,2920842198,2953630069
2025-06-19 13:38:08,REAL,2920842198,482,2920842680,2953630551
2025-06-19 13:38:10,REAL,2920842680,491,2920843171,2953631042
2025-06-19 13:38:12,FAKE,2920843171,243,2920843414,2953631534
2025-06-19 13:38:14,FAKE,2920843414,238,2920843652,2953632012
2025-06-19 13:38:16,REAL,2920843652,483,2920844135,2953632495
2025-06-19 13:38:18,REAL,2920844135,485,2920844620,2953632980
2025-06-19 13:38:20,REAL,2920844620,484,2920845104,2953633464
2025-06-19 13:38:22,FAKE,2920845104,244,2920845348,2953633954
2025-06-19 13:38:24,FAKE,2920845348,244,2920845592,2953634495
2025-06-19 13:38:26,FAKE,2920845592,243,2920845835,2953634978
2025-06-19 13:38:28,REAL,2920845835,478,2920846313,2953635456
2025-06-19 13:38:30,REAL,2920846313,532,2920846845,2953635988
2025-06-19 13:38:32,REAL,2920846845,477,2920847322,2953636465
2025-06-19 13:38:34,REAL,2920847322,478,2920847800,2953636943
2025-06-19 13:38:36,REAL,2920847800,480,2920848280,2953637423
2025-06-19 13:38:38,REAL,2920848280,486,2920848766,2953637909
2025-06-19 13:38:40,FAKE,2920848766,238,2920849004,2953638403
2025-06-19 13:38:42,REAL,2920849004,487,2920849491,2953638890
2025-06-19 13:38:44,REAL,2920849491,487,2920849978,2953639377
2025-06-19 13:38:46,REAL,2920849978,483,2920850461,2953639860
2025-06-19 13:38:48,REAL,2920850461,488,2920850949,2953640348
2025-06-19 13:38:50,FAKE,2920850949,238,2920851187,2953640835
2025-06-19 13:38:52,REAL,2920851187,490,2920851677,2953641325
2025-06-19 13:38:54,FAKE,2920851677,243,2920851920,2953641813
2025-06-19 13:38:56,FAKE,2920851920,238,2920852158,2953642343
2025-06-19 13:38:58,REAL,2920852158,483,2920852641,2953642826
2025-06-19 13:39:00,REAL,2920852641,482,2920853123,2953643308
2025-06-19 13:39:02,FAKE,2920853123,244,2920853367,2953657519
2025-06-19 13:39:04,REAL,2920853367,10319,2920863686,2953667838
2025-06-19 13:39:06,REAL,2920863686,10248,2920873934,2953678086
2025-06-19 13:39:08,REAL,2920873934,10244,2920884178,2953688330
2025-06-19 13:39:10,REAL,2920884178,10315,2920894493,2953698645
2025-06-19 13:39:12,REAL,2920894493,10246,2920904739,2953708891
2025-06-19 13:39:14,REAL,2920904739,10251,2920914990,2953719142
2025-06-19 13:39:16,FAKE,2920914990,244,2920915234,2953725180
2025-06-19 13:39:18,REAL,2920915234,483,2920915717,2953725663
2025-06-19 13:39:20,FAKE,2920915717,243,2920915960,2953726148
2025-06-19 13:39:22,FAKE,2920915960,238,2920916198,2953726629
2025-06-19 13:39:24,FAKE,2920916198,244,2920916442,2953727115
2025-06-19 13:39:26,REAL,2920916442,542,2920916984,2953727657
2025-06-19 13:39:28,REAL,2920916984,489,2920917473,2953728146
2025-06-19 13:39:30,FAKE,2920917473,241,2920917714,2953728633
2025-06-19 13:39:32,REAL,2920917714,486,2920918200,2953729119
2025-06-19 13:39:34,REAL,2920918200,11836,2920930036,2953740955
2025-06-19 13:39:36,FAKE,2920930036,244,2920930280,2953751208
2025-06-19 13:39:38,FAKE,2920930280,243,2920930523,2953761511
2025-06-19 13:39:40,FAKE,2920930523,244,2920930767,2953771831
2025-06-19 13:39:42,REAL,2920930767,10253,2920941020,2953782084
2025-06-19 13:39:44,FAKE,2920941020,243,2920941263,2953792335
2025-06-19 13:39:46,FAKE,2920941263,243,2920941506,2953802657
2025-06-19 13:39:48,FAKE,2920941506,241,2920941747,2953807964
2025-06-19 13:39:50,FAKE,2920941747,238,2920941985,2953808445
2025-06-19 13:39:52,FAKE,2920941985,241,2920942226,2953808931
2025-06-19 13:39:54,FAKE,2920942226,241,2920942467,2953809416
2025-06-19 13:39:56,REAL,2920942467,487,2920942954,2953809903
2025-06-19 13:39:58,REAL,2920942954,535,2920943489,2953810438
2025-06-19 13:40:00,REAL,2920943489,483,2920943972,2953810921
2025-06-19 13:40:02,REAL,2920943972,492,2920944464,2953811413
2025-06-19 13:40:04,FAKE,2920944464,238,2920944702,2953811903
2025-06-19 13:40:06,REAL,2920944702,488,2920945190,2953812391
2025-06-19 13:40:08,REAL,2920945190,479,2920945669,2953812870
2025-06-19 13:40:10,REAL,2920945669,492,2920946161,2953813362
2025-06-19 13:40:12,FAKE,2920946161,241,2920946402,2953813855
2025-06-19 13:40:14,FAKE,2920946402,243,2920946645,2953814337
2025-06-19 13:40:16,REAL,2920946645,536,2920947181,2953814873
2025-06-19 13:40:18,FAKE,2920947181,241,2920947422,2953815349
2025-06-19 13:40:20,REAL,2920947422,485,2920947907,2953815834
2025-06-19 13:40:22,FAKE,2920947907,238,2920948145,2953816308
2025-06-19 13:40:24,FAKE,2920948145,243,2920948388,2953816795
2025-06-19 13:40:26,REAL,2920948388,8946,2920957334,2953825741
2025-06-19 13:40:28,REAL,2920957334,10845,2920968179,2953836586
2025-06-19 13:40:30,REAL,2920968179,10326,2920978505,2953846912
2025-06-19 13:40:32,REAL,2920978505,10255,2920988760,2953857167
2025-06-19 13:40:34,REAL,2920988760,10312,2920999072,2953867479
2025-06-19 13:40:36,REAL,2920999072,10251,2921009323,2953877730
2025-06-19 13:40:38,FAKE,2921009323,243,2921009566,2953888044
2025-06-19 13:40:40,REAL,2921009566,9393,2921018959,2953897437
2025-06-19 13:40:42,REAL,2921018959,481,2921019440,2953897918
2025-06-19 13:40:44,REAL,2921019440,475,2921019915,2953898393
2025-06-19 13:40:46,REAL,2921019915,1673,2921021588,2953900066
2025-06-19 13:40:48,REAL,2921021588,14600,2921036188,2953914666
2025-06-19 13:40:50,FAKE,2921036188,238,2921036426,2953924988
2025-06-19 13:40:52,REAL,2921036426,10301,2921046727,2953935289
2025-06-19 13:40:54,REAL,2921046727,10314,2921057041,2953945603
2025-06-19 13:40:56,REAL,2921057041,10243,2921067284,2953955846
2025-06-19 13:40:58,FAKE,2921067284,244,2921067528,2953966097
2025-06-19 13:41:00,FAKE,2921067528,238,2921067766,2953976349
2025-06-19 13:41:02,REAL,2921067766,4181,2921071947,2953980530
2025-06-19 13:41:04,REAL,2921071947,486,2921072433,2953981016
2025-06-19 13:41:06,REAL,2921072433,484,2921072917,2953981500
2025-06-19 13:41:08,REAL,2921072917,480,2921073397,2953981980
2025-06-19 13:41:10,REAL,2921073397,490,2921073887,2953982470
2025-06-19 13:41:12,FAKE,2921073887,244,2921074131,2953982955
2025-06-19 13:41:14,FAKE,2921074131,241,2921074372,2953983446
2025-06-19 13:41:16,REAL,2921074372,494,2921074866,2953983940
2025-06-19 13:41:18,REAL,2921074866,2475,2921077341,2953986415
2025-06-19 13:41:20,REAL,2921077341,13938,2921091279,2954000353
2025-06-19 13:41:22,REAL,2921091279,10321,2921101600,2954010674
2025-06-19 13:41:24,REAL,2921101600,10247,2921111847,2954020921
2025-06-19 13:41:26,REAL,2921111847,10252,2921122099,2954031173
2025-06-19 13:41:28,REAL,2921122099,10252,2921132351,2954041425
2025-06-19 13:41:30,REAL,2921132351,10313,2921142664,2954051738
2025-06-19 13:41:32,REAL,2921142664,10324,2921152988,2954062062
2025-06-19 13:41:34,REAL,2921152988,3516,2921156504,2954065578
2025-06-19 13:41:36,REAL,2921156504,492,2921156996,2954066070
2025-06-19 13:41:38,REAL,2921156996,491,2921157487,2954066561
2025-06-19 13:41:40,REAL,2921157487,482,2921157969,2954067043
2025-06-19 13:41:42,FAKE,2921157969,238,2921158207,2954067521
2025-06-19 13:41:44,REAL,2921158207,481,2921158688,2954068002
2025-06-19 13:41:46,FAKE,2921158688,244,2921158932,2954068490
2025-06-19 13:41:48,REAL,2921158932,490,2921159422,2954068980
2025-06-19 13:41:50,REAL,2921159422,491,2921159913,2954069471
2025-06-19 13:41:52,REAL,2921159913,476,2921160389,2954069947
2025-06-19 13:41:54,REAL,2921160389,543,2921160932,2954070490
2025-06-19 13:41:56,REAL,2921160932,478,2921161410,2954070968
2025-06-19 13:41:58,REAL,2921161410,477,2921161887,2954071445
2025-06-19 13:42:00,REAL,2921161887,493,2921162380,2954071938
2025-06-19 13:42:02,REAL,2921162380,481,2921162861,2954072419
2025-06-19 13:42:04,FAKE,2921162861,244,2921163105,2954072902
2025-06-19 13:42:06,REAL,2921163105,539,2921163644,2954073441
2025-06-19 13:42:08,REAL,2921163644,483,2921164127,2954073924
2025-06-19 13:42:10,REAL,2921164127,480,2921164607,2954074404
2025-06-19 13:42:12,FAKE,2921164607,244,2921164851,2954083679
2025-06-19 13:42:14,REAL,2921164851,10455,2921175306,2954094134
2025-06-19 13:42:16,FAKE,2921175306,241,2921175547,2954104382
2025-06-19 13:42:18,REAL,2921175547,10252,2921185799,2954114634
2025-06-19 13:42:20,FAKE,2921185799,244,2921186043,2954124951
2025-06-19 13:42:22,REAL,2921186043,10250,2921196293,2954135201
2025-06-19 13:42:24,REAL,2921196293,10246,2921206539,2954145447
2025-06-19 13:42:26,FAKE,2921206539,238,2921206777,2954152925
2025-06-19 13:42:28,FAKE,2921206777,244,2921207021,2954153416
2025-06-19 13:42:30,REAL,2921207021,479,2921207500,2954153895
2025-06-19 13:42:32,REAL,2921207500,484,2921207984,2954154379
2025-06-19 13:42:34,REAL,2921207984,475,2921208459,2954154854
2025-06-19 13:42:36,REAL,2921208459,483,2921208942,2954155337
2025-06-19 13:42:38,FAKE,2921208942,244,2921209186,2954155816
2025-06-19 13:42:40,FAKE,2921209186,244,2921209430,2954156300
2025-06-19 13:42:42,REAL,2921209430,544,2921209974,2954156844
2025-06-19 13:42:44,REAL,2921209974,10254,2921220228,2954167098
2025-06-19 13:42:46,REAL,2921220228,10387,2921230615,2954177485
2025-06-19 13:42:48,REAL,2921230615,10323,2921240938,2954187808
2025-06-19 13:42:50,REAL,2921240938,10251,2921251189,2954198059
2025-06-19 13:42:52,FAKE,2921251189,243,2921251432,2954208317
2025-06-19 13:42:54,FAKE,2921251432,243,2921251675,2954218636
2025-06-19 13:42:56,REAL,2921251675,10255,2921261930,2954228891
2025-06-19 13:42:58,REAL,2921261930,6884,2921268814,2954235775
2025-06-19 13:43:00,REAL,2921268814,477,2921269291,2954236252
2025-06-19 13:43:02,FAKE,2921269291,238,2921269529,2954236735
2025-06-19 13:43:04,REAL,2921269529,476,2921270005,2954237211
2025-06-19 13:43:06,REAL,2921270005,487,2921270492,2954237698
2025-06-19 13:43:08,REAL,2921270492,481,2921270973,2954238179
2025-06-19 13:43:10,REAL,2921270973,487,2921271460,2954238666
2025-06-19 13:43:12,REAL,2921271460,493,2921271953,2954239159
2025-06-19 13:43:14,FAKE,2921271953,238,2921272191,2954239691
2025-06-19 13:43:16,FAKE,2921272191,244,2921272435,2954250158
2025-06-19 13:43:18,FAKE,2921272435,241,2921272676,2954260551
2025-06-19 13:43:20,REAL,2921272676,10251,2921282927,2954270802
2025-06-19 13:43:22,REAL,2921282927,10252,2921293179,2954281054
2025-06-19 13:43:24,REAL,2921293179,10314,2921303493,2954291368
2025-06-19 13:43:26,REAL,2921303493,10251,2921313744,2954301619
2025-06-19 13:43:28,REAL,2921313744,10259,2921324003,2954311878
2025-06-19 13:43:30,FAKE,2921324003,243,2921324246,2954318097
2025-06-19 13:43:32,FAKE,2921324246,243,2921324489,2954318589
2025-06-19 13:43:34,REAL,2921324489,479,2921324968,2954319068
2025-06-19 13:43:36,REAL,2921324968,484,2921325452,2954319552
2025-06-19 13:43:38,REAL,2921325452,486,2921325938,2954320038
2025-06-19 13:43:40,REAL,2921325938,488,2921326426,2954320526
2025-06-19 13:43:42,FAKE,2921326426,241,2921326667,2954321010
2025-06-19 13:43:44,FAKE,2921326667,238,2921326905,2954321554
2025-06-19 13:43:46,FAKE,2921326905,244,2921327149,2954322032
2025-06-19 13:43:48,REAL,2921327149,488,2921327637,2954322520
2025-06-19 13:43:50,REAL,2921327637,541,2921328178,2954323061
2025-06-19 13:43:52,FAKE,2921328178,241,2921328419,2954323539
2025-06-19 13:43:54,REAL,2921328419,487,2921328906,2954324026
2025-06-19 13:43:56,FAKE,2921328906,238,2921329144,2954324510
2025-06-19 13:43:58,REAL,2921329144,479,2921329623,2954324989
2025-06-19 13:44:00,REAL,2921329623,476,2921330099,2954325465
2025-06-19 13:44:02,FAKE,2921330099,238,2921330337,2954325953
2025-06-19 13:44:04,REAL,2921330337,485,2921330822,2954326438
2025-06-19 13:44:06,REAL,2921330822,487,2921331309,2954326925
2025-06-19 13:44:08,FAKE,2921331309,241,2921331550,2954327401
2025-06-19 13:44:10,FAKE,2921331550,244,2921331794,2954327890
2025-06-19 13:44:12,REAL,2921331794,481,2921332275,2954328371
2025-06-19 13:44:14,FAKE,2921332275,244,2921332519,2954328907
2025-06-19 13:44:16,REAL,2921332519,486,2921333005,2954329393
2025-06-19 13:44:18,REAL,2921333005,7233,2921340238,2954336626
2025-06-19 13:44:20,FAKE,2921340238,238,2921340476,2954349716
2025-06-19 13:44:22,FAKE,2921340476,238,2921340714,2954360031
2025-06-19 13:44:24,REAL,2921340714,10251,2921350965,2954370282
2025-06-19 13:44:26,FAKE,2921350965,244,2921351209,2954380595
2025-06-19 13:44:28,REAL,2921351209,10252,2921361461,2954390847
2025-06-19 13:44:30,FAKE,2921361461,238,2921361699,2954401163
2025-06-19 13:44:32,REAL,2921361699,10248,2921371947,2954411411
2025-06-19 13:44:34,REAL,2921371947,616,2921372563,2954412027
2025-06-19 13:44:36,REAL,2921372563,484,2921373047,2954412511
2025-06-19 13:44:38,REAL,2921373047,485,2921373532,2954412996
2025-06-19 13:44:40,REAL,2921373532,484,2921374016,2954413480
2025-06-19 13:44:42,REAL,2921374016,476,2921374492,2954413956
2025-06-19 13:44:44,REAL,2921374492,486,2921374978,2954414442
2025-06-19 13:44:46,REAL,2921374978,540,2921375518,2954414982
2025-06-19 13:44:48,REAL,2921375518,476,2921375994,2954415458
2025-06-19 13:44:50,REAL,2921375994,489,2921376483,2954415947
2025-06-19 13:44:52,REAL,2921376483,481,2921376964,2954416428
2025-06-19 13:44:54,REAL,2921376964,544,2921377508,2954416972
2025-06-19 13:44:56,REAL,2921377508,477,2921377985,2954417449
2025-06-19 13:44:58,REAL,2921377985,487,2921378472,2954417936
2025-06-19 13:45:00,REAL,2921378472,480,2921378952,2954418416
2025-06-19 13:45:02,REAL,2921378952,488,2921379440,2954418904
2025-06-19 13:45:04,REAL,2921379440,479,2921379919,2954419383
2025-06-19 13:45:06,REAL,2921379919,487,2921380406,2954419870
2025-06-19 13:45:08,REAL,2921380406,494,2921380900,2954420364
2025-06-19 13:45:10,REAL,2921380900,486,2921381386,2954420850
2025-06-19 13:45:12,REAL,2921381386,488,2921381874,2954421338
2025-06-19 13:45:14,FAKE,2921381874,241,2921382115,2954421817
2025-06-19 13:45:16,REAL,2921382115,537,2921382652,2954422354
2025-06-19 13:45:18,FAKE,2921382652,241,2921382893,2954422843
2025-06-19 13:45:20,REAL,2921382893,491,2921383384,2954423334
2025-06-19 13:45:22,REAL,2921383384,492,2921383876,2954423826
2025-06-19 13:45:24,REAL,2921383876,479,2921384355,2954424305
2025-06-19 13:45:26,FAKE,2921384355,243,2921384598,2954424787
2025-06-19 13:45:28,FAKE,2921384598,241,2921384839,2954425277
2025-06-19 13:45:30,REAL,2921384839,540,2921385379,2954425817
2025-06-19 13:45:32,REAL,2921385379,483,2921385862,2954426300
2025-06-19 13:45:34,FAKE,2921385862,238,2921386100,2954426788
2025-06-19 13:45:36,REAL,2921386100,479,2921386579,2954427267
2025-06-19 13:45:38,REAL,2921386579,489,2921387068,2954427756
2025-06-19 13:45:40,REAL,2921387068,482,2921387550,2954428238
2025-06-19 13:45:42,REAL,2921387550,489,2921388039,2954428727
2025-06-19 13:45:44,REAL,2921388039,483,2921388522,2954429210
2025-06-19 13:45:46,REAL,2921388522,490,2921389012,2954429700
2025-06-19 13:45:48,REAL,2921389012,538,2921389550,2954430238
2025-06-19 13:45:50,REAL,2921389550,492,2921390042,2954430730
2025-06-19 13:45:52,FAKE,2921390042,241,2921390283,2954431210
2025-06-19 13:45:54,REAL,2921390283,483,2921390766,2954431693
2025-06-19 13:45:56,REAL,2921390766,483,2921391249,2954432176
2025-06-19 13:45:58,FAKE,2921391249,243,2921391492,2954432658
2025-06-19 13:46:00,FAKE,2921391492,244,2921391736,2954433141
2025-06-19 13:46:02,REAL,2921391736,486,2921392222,2954433627
2025-06-19 13:46:04,REAL,2921392222,484,2921392706,2954434111
2025-06-19 13:46:06,REAL,2921392706,542,2921393248,2954434653
2025-06-19 13:46:08,REAL,2921393248,488,2921393736,2954435141
2025-06-19 13:46:10,REAL,2921393736,483,2921394219,2954435624
2025-06-19 13:46:12,REAL,2921394219,482,2921394701,2954436106
2025-06-19 13:46:14,FAKE,2921394701,244,2921394945,2954436590
2025-06-19 13:46:16,REAL,2921394945,488,2921395433,2954437078
2025-06-19 13:46:18,FAKE,2921395433,244,2921395677,2954437622
2025-06-19 13:46:20,REAL,2921395677,483,2921396160,2954438105
2025-06-19 13:46:22,FAKE,2921396160,243,2921396403,2954438597
2025-06-19 13:46:24,REAL,2921396403,485,2921396888,2954439082
2025-06-19 13:46:26,REAL,2921396888,483,2921397371,2954439565
2025-06-19 13:46:28,REAL,2921397371,487,2921397858,2954440052
2025-06-19 13:46:30,REAL,2921397858,489,2921398347,2954440541
2025-06-19 13:46:32,FAKE,2921398347,243,2921398590,2954441018
2025-06-19 13:46:34,REAL,2921398590,486,2921399076,2954441504
2025-06-19 13:46:36,FAKE,2921399076,241,2921399317,2954441994
2025-06-19 13:46:38,FAKE,2921399317,241,2921399558,2954442483
2025-06-19 13:46:40,REAL,2921399558,489,2921400047,2954442972
2025-06-19 13:46:42,REAL,2921400047,477,2921400524,2954443449
2025-06-19 13:46:44,REAL,2921400524,541,2921401065,2954443990
2025-06-19 13:46:46,FAKE,2921401065,238,2921401303,2954444474
2025-06-19 13:46:48,REAL,2921401303,550,2921401853,2954445024
2025-06-19 13:46:50,REAL,2921401853,482,2921402335,2954445506
2025-06-19 13:46:52,FAKE,2921402335,243,2921402578,2954445999
2025-06-19 13:46:54,FAKE,2921402578,243,2921402821,2954446484
2025-06-19 13:46:56,FAKE,2921402821,244,2921403065,2954446963
2025-06-19 13:46:58,REAL,2921403065,481,2921403546,2954447444
2025-06-19 13:47:00,REAL,2921403546,491,2921404037,2954447935
2025-06-19 13:47:02,FAKE,2921404037,241,2921404278,2954448413
2025-06-19 13:47:04,REAL,2921404278,486,2921404764,2954448899
2025-06-19 13:47:06,FAKE,2921404764,241,2921405005,2954449377
2025-06-19 13:47:08,FAKE,2921405005,241,2921405246,2954449859
2025-06-19 13:47:10,REAL,2921405246,483,2921405729,2954450342
2025-06-19 13:47:12,FAKE,2921405729,243,2921405972,2954459874
2025-06-19 13:47:14,REAL,2921405972,10443,2921416415,2954470317
2025-06-19 13:47:16,REAL,2921416415,10252,2921426667,2954480569
2025-06-19 13:47:18,FAKE,2921426667,244,2921426911,2954490876
2025-06-19 13:47:20,REAL,2921426911,10312,2921437223,2954501188
2025-06-19 13:47:22,REAL,2921437223,10256,2921447479,2954511444
2025-06-19 13:47:24,REAL,2921447479,10251,2921457730,2954521695
2025-06-19 13:47:26,REAL,2921457730,7481,2921465211,2954529176
2025-06-19 13:47:28,REAL,2921465211,483,2921465694,2954529659
2025-06-19 13:47:30,REAL,2921465694,485,2921466179,2954530144
2025-06-19 13:47:32,REAL,2921466179,479,2921466658,2954530623
2025-06-19 13:47:34,REAL,2921466658,491,2921467149,2954531114
2025-06-19 13:47:36,REAL,2921467149,485,2921467634,2954531599
2025-06-19 13:47:38,FAKE,2921467634,244,2921467878,2954532074
2025-06-19 13:47:40,FAKE,2921467878,238,2921468116,2954532566
2025-06-19 13:47:42,FAKE,2921468116,241,2921468357,2954533056
2025-06-19 13:47:44,FAKE,2921468357,238,2921468595,2954533535
2025-06-19 13:47:46,FAKE,2921468595,243,2921468838,2954534026
2025-06-19 13:47:48,REAL,2921468838,477,2921469315,2954534503
2025-06-19 13:47:50,REAL,2921469315,545,2921469860,2954535048
2025-06-19 13:47:52,REAL,2921469860,488,2921470348,2954535536
2025-06-19 13:47:54,REAL,2921470348,488,2921470836,2954536024
2025-06-19 13:47:56,FAKE,2921470836,241,2921471077,2954536504
2025-06-19 13:47:58,FAKE,2921471077,241,2921471318,2954536990
2025-06-19 13:48:00,FAKE,2921471318,241,2921471559,2954537479
2025-06-19 13:48:02,FAKE,2921471559,243,2921471802,2954537962
2025-06-19 13:48:04,REAL,2921471802,5512,2921477314,2954543474
2025-06-19 13:48:06,REAL,2921477314,11040,2921488354,2954554514
2025-06-19 13:48:08,REAL,2921488354,10252,2921498606,2954564766
2025-06-19 13:48:10,FAKE,2921498606,241,2921498847,2954575080
2025-06-19 13:48:12,REAL,2921498847,10320,2921509167,2954585400
2025-06-19 13:48:14,FAKE,2921509167,238,2921509405,2954595652
2025-06-19 13:48:16,REAL,2921509405,10245,2921519650,2954605897
2025-06-19 13:48:18,REAL,2921519650,10320,2921529970,2954616217
2025-06-19 13:48:20,REAL,2921529970,1542,2921531512,2954617759
2025-06-19 13:48:22,REAL,2921531512,483,2921531995,2954618242
2025-06-19 13:48:24,REAL,2921531995,490,2921532485,2954618732
2025-06-19 13:48:26,REAL,2921532485,481,2921532966,2954619213
2025-06-19 13:48:28,FAKE,2921532966,243,2921533209,2954619692
2025-06-19 13:48:30,REAL,2921533209,480,2921533689,2954620172
2025-06-19 13:48:32,REAL,2921533689,483,2921534172,2954620655
2025-06-19 13:48:34,REAL,2921534172,479,2921534651,2954621134
2025-06-19 13:48:36,REAL,2921534651,491,2921535142,2954621625
2025-06-19 13:48:38,REAL,2921535142,487,2921535629,2954622112
2025-06-19 13:48:40,REAL,2921535629,487,2921536116,2954622599
2025-06-19 13:48:42,REAL,2921536116,549,2921536665,2954623148
2025-06-19 13:48:44,FAKE,2921536665,244,2921536909,2954623634
2025-06-19 13:48:46,REAL,2921536909,485,2921537394,2954624119
2025-06-19 13:48:48,REAL,2921537394,488,2921537882,2954624607
2025-06-19 13:48:50,REAL,2921537882,477,2921538359,2954625084
2025-06-19 13:48:52,FAKE,2921538359,243,2921538602,2954625574
2025-06-19 13:48:54,REAL,2921538602,484,2921539086,2954626058
2025-06-19 13:48:56,FAKE,2921539086,243,2921539329,2954626543
2025-06-19 13:48:58,REAL,2921539329,546,2921539875,2954627089
2025-06-19 13:49:00,REAL,2921539875,488,2921540363,2954627577
2025-06-19 13:49:02,REAL,2921540363,481,2921540844,2954628058
2025-06-19 13:49:04,REAL,2921540844,484,2921541328,2954628542
2025-06-19 13:49:06,FAKE,2921541328,244,2921541572,2954629029
2025-06-19 13:49:08,REAL,2921541572,242,2921541814,2954629271
2025-06-19 13:49:10,FAKE,2921541814,243,2921542057,2954629757
2025-06-19 13:49:12,REAL,2921542057,480,2921542537,2954630237
2025-06-19 13:49:14,REAL,2921542537,475,2921543012,2954630712
2025-06-19 13:49:16,REAL,2921543012,492,2921543504,2954631204
2025-06-19 13:49:18,REAL,2921543504,6355,2921549859,2954637559
2025-06-19 13:49:20,FAKE,2921549859,241,2921550100,2954648597
2025-06-19 13:49:22,FAKE,2921550100,241,2921550341,2954658914
2025-06-19 13:49:24,FAKE,2921550341,243,2921550584,2954669168
2025-06-19 13:49:26,FAKE,2921550584,244,2921550828,2954679491
2025-06-19 13:49:28,REAL,2921550828,10253,2921561081,2954689744
2025-06-19 13:49:30,REAL,2921561081,10325,2921571406,2954700069
2025-06-19 13:49:32,REAL,2921571406,10053,2921581459,2954710122
2025-06-19 13:49:34,REAL,2921581459,485,2921581944,2954710607
2025-06-19 13:49:36,FAKE,2921581944,243,2921582187,2954711098
2025-06-19 13:49:38,REAL,2921582187,483,2921582670,2954711581
2025-06-19 13:49:40,FAKE,2921582670,238,2921582908,2954712066
2025-06-19 13:49:42,REAL,2921582908,487,2921583395,2954712553
2025-06-19 13:49:44,REAL,2921583395,480,2921583875,2954713033
2025-06-19 13:49:46,FAKE,2921583875,238,2921584113,2954713520
2025-06-19 13:49:48,REAL,2921584113,543,2921584656,2954714063
2025-06-19 13:49:50,REAL,2921584656,476,2921585132,2954714539
2025-06-19 13:49:52,REAL,2921585132,493,2921585625,2954715032
2025-06-19 13:49:54,REAL,2921585625,535,2921586160,2954715567
2025-06-19 13:49:56,REAL,2921586160,481,2921586641,2954716048
2025-06-19 13:49:58,REAL,2921586641,480,2921587121,2954716528
2025-06-19 13:50:00,REAL,2921587121,483,2921587604,2954717011
2025-06-19 13:50:02,REAL,2921587604,486,2921588090,2954717497
2025-06-19 13:50:04,REAL,2921588090,484,2921588574,2954717981
2025-06-19 13:50:06,REAL,2921588574,478,2921589052,2954718459
2025-06-19 13:50:08,REAL,2921589052,476,2921589528,2954718935
2025-06-19 13:50:10,REAL,2921589528,1950,2921591478,2954720885
2025-06-19 13:50:12,FAKE,2921591478,241,2921591719,2954733009
2025-06-19 13:50:14,REAL,2921591719,10252,2921601971,2954743261
2025-06-19 13:50:16,FAKE,2921601971,244,2921602215,2954753512
2025-06-19 13:50:18,FAKE,2921602215,241,2921602456,2954763824
2025-06-19 13:50:20,REAL,2921602456,10249,2921612705,2954774073
2025-06-19 13:50:22,REAL,2921612705,10320,2921623025,2954784393
2025-06-19 13:50:24,REAL,2921623025,10257,2921633282,2954794650
2025-06-19 13:50:26,FAKE,2921633282,241,2921633523,2954798833
2025-06-19 13:50:28,FAKE,2921633523,241,2921633764,2954799308
2025-06-19 13:50:30,REAL,2921633764,489,2921634253,2954799797
2025-06-19 13:50:32,REAL,2921634253,488,2921634741,2954800285
2025-06-19 13:50:34,FAKE,2921634741,238,2921634979,2954800765
2025-06-19 13:50:36,FAKE,2921634979,241,2921635220,2954801308
2025-06-19 13:50:38,REAL,2921635220,479,2921635699,2954801787
2025-06-19 13:50:40,REAL,2921635699,490,2921636189,2954802277
2025-06-19 13:50:42,REAL,2921636189,2666,2921638855,2954804943
2025-06-19 13:50:44,FAKE,2921638855,243,2921639098,2954816520
2025-06-19 13:50:46,REAL,2921639098,10252,2921649350,2954826772
2025-06-19 13:50:48,REAL,2921649350,10328,2921659678,2954837100
2025-06-19 13:50:50,FAKE,2921659678,238,2921659916,2954847346
2025-06-19 13:50:52,REAL,2921659916,10316,2921670232,2954857662
2025-06-19 13:50:54,FAKE,2921670232,243,2921670475,2954867915
2025-06-19 13:50:56,REAL,2921670475,10253,2921680728,2954878168
2025-06-19 13:50:58,FAKE,2921680728,243,2921680971,2954881764
2025-06-19 13:51:00,REAL,2921680971,485,2921681456,2954882249
2025-06-19 13:51:02,REAL,2921681456,488,2921681944,2954882737
2025-06-19 13:51:04,REAL,2921681944,483,2921682427,2954883220
2025-06-19 13:51:06,REAL,2921682427,478,2921682905,2954883698
2025-06-19 13:51:08,REAL,2921682905,479,2921683384,2954884177
2025-06-19 13:51:10,FAKE,2921683384,243,2921683627,2954884660
2025-06-19 13:51:12,FAKE,2921683627,244,2921683871,2954885138
2025-06-19 13:51:14,FAKE,2921683871,243,2921684114,2954888536
2025-06-19 13:51:16,REAL,2921684114,11837,2921695951,2954900373
2025-06-19 13:51:18,REAL,2921695951,10243,2921706194,2954910616
2025-06-19 13:51:20,REAL,2921706194,10248,2921716442,2954920864
2025-06-19 13:51:22,REAL,2921716442,10318,2921726760,2954931182
2025-06-19 13:51:24,REAL,2921726760,10252,2921737012,2954941434
2025-06-19 13:51:26,REAL,2921737012,10370,2921747382,2954951804
2025-06-19 13:51:28,FAKE,2921747382,241,2921747623,2954962064
2025-06-19 13:51:30,FAKE,2921747623,241,2921747864,2954964992
2025-06-19 13:51:32,FAKE,2921747864,243,2921748107,2954965480
2025-06-19 13:51:34,REAL,2921748107,476,2921748583,2954965956
2025-06-19 13:51:36,FAKE,2921748583,238,2921748821,2954966447
2025-06-19 13:51:38,FAKE,2921748821,241,2921749062,2954966922
2025-06-19 13:51:40,REAL,2921749062,482,2921749544,2954967404
2025-06-19 13:51:42,REAL,2921749544,479,2921750023,2954967883
2025-06-19 13:51:44,FAKE,2921750023,238,2921750261,2954968368
2025-06-19 13:51:46,REAL,2921750261,4117,2921754378,2954972485
2025-06-19 13:51:48,FAKE,2921754378,241,2921754619,2954983729
2025-06-19 13:51:50,REAL,2921754619,10313,2921764932,2954994042
2025-06-19 13:51:52,REAL,2921764932,10257,2921775189,2955004299
2025-06-19 13:51:54,REAL,2921775189,10249,2921785438,2955014548
2025-06-19 13:51:56,REAL,2921785438,10324,2921795762,2955024872
2025-06-19 13:51:58,REAL,2921795762,10247,2921806009,2955035119
2025-06-19 13:52:00,FAKE,2921806009,243,2921806252,2955045372
2025-06-19 13:52:02,REAL,2921806252,2272,2921808524,2955047644
2025-06-19 13:52:04,REAL,2921808524,490,2921809014,2955048134
2025-06-19 13:52:06,REAL,2921809014,486,2921809500,2955048620
2025-06-19 13:52:08,REAL,2921809500,485,2921809985,2955049105
2025-06-19 13:52:10,REAL,2921809985,488,2921810473,2955049593
2025-06-19 13:52:12,REAL,2921810473,477,2921810950,2955050070
2025-06-19 13:52:14,REAL,2921810950,542,2921811492,2955050612
2025-06-19 13:52:16,REAL,2921811492,474,2921811966,2955051086
2025-06-19 13:52:18,REAL,2921811966,484,2921812450,2955051570
2025-06-19 13:52:20,FAKE,2921812450,243,2921812693,2955052052
2025-06-19 13:52:22,FAKE,2921812693,238,2921812931,2955052536
2025-06-19 13:52:24,FAKE,2921812931,238,2921813169,2955053020
2025-06-19 13:52:26,REAL,2921813169,477,2921813646,2955053497
2025-06-19 13:52:28,REAL,2921813646,478,2921814124,2955053975
2025-06-19 13:52:30,FAKE,2921814124,241,2921814365,2955054467
2025-06-19 13:52:32,REAL,2921814365,486,2921814851,2955054953
2025-06-19 13:52:34,REAL,2921814851,491,2921815342,2955055444
2025-06-19 13:52:36,REAL,2921815342,539,2921815881,2955055983
2025-06-19 13:52:38,REAL,2921815881,490,2921816371,2955056473
2025-06-19 13:52:40,REAL,2921816371,486,2921816857,2955056959
2025-06-19 13:52:42,FAKE,2921816857,244,2921817101,2955057440
2025-06-19 13:52:44,REAL,2921817101,484,2921817585,2955057924
2025-06-19 13:52:46,REAL,2921817585,480,2921818065,2955058404
2025-06-19 13:52:48,REAL,2921818065,488,2921818553,2955058892
2025-06-19 13:52:50,REAL,2921818553,480,2921819033,2955059372
2025-06-19 13:52:52,REAL,2921819033,481,2921819514,2955059853
2025-06-19 13:52:54,FAKE,2921819514,238,2921819752,2955060342
2025-06-19 13:52:56,FAKE,2921819752,243,2921819995,2955060819
2025-06-19 13:52:58,REAL,2921819995,474,2921820469,2955061293
2025-06-19 13:53:00,REAL,2921820469,484,2921820953,2955061777
2025-06-19 13:53:02,REAL,2921820953,481,2921821434,2955062258
2025-06-19 13:53:04,REAL,2921821434,546,2921821980,2955062804
2025-06-19 13:53:06,FAKE,2921821980,244,2921822224,2955063287
2025-06-19 13:53:08,FAKE,2921822224,243,2921822467,2955063771
2025-06-19 13:53:10,REAL,2921822467,489,2921822956,2955064260
2025-06-19 13:53:12,REAL,2921822956,11324,2921834280,2955075584
2025-06-19 13:53:14,FAKE,2921834280,243,2921834523,2955085904
2025-06-19 13:53:16,FAKE,2921834523,238,2921834761,2955096156
2025-06-19 13:53:18,REAL,2921834761,10254,2921845015,2955106410
2025-06-19 13:53:20,REAL,2921845015,10254,2921855269,2955116664
2025-06-19 13:53:22,FAKE,2921855269,243,2921855512,2955126917
2025-06-19 13:53:24,REAL,2921855512,10314,2921865826,2955137231
2025-06-19 13:53:26,REAL,2921865826,5699,2921871525,2955142930
2025-06-19 13:53:28,REAL,2921871525,489,2921872014,2955143419
2025-06-19 13:53:30,REAL,2921872014,477,2921872491,2955143896
2025-06-19 13:53:32,REAL,2921872491,490,2921872981,2955144386
2025-06-19 13:53:34,REAL,2921872981,487,2921873468,2955144873
2025-06-19 13:53:36,REAL,2921873468,476,2921873944,2955145349
2025-06-19 13:53:38,REAL,2921873944,484,2921874428,2955145833
2025-06-19 13:53:40,REAL,2921874428,474,2921874902,2955146307
2025-06-19 13:53:42,REAL,2921874902,481,2921875383,2955146788
2025-06-19 13:53:44,REAL,2921875383,12115,2921887498,2955158903
2025-06-19 13:53:46,REAL,2921887498,10313,2921897811,2955169216
2025-06-19 13:53:48,FAKE,2921897811,243,2921898054,2955179532
2025-06-19 13:53:50,REAL,2921898054,10248,2921908302,2955189780
2025-06-19 13:53:52,FAKE,2921908302,241,2921908543,2955200035
2025-06-19 13:53:54,FAKE,2921908543,238,2921908781,2955210357
2025-06-19 13:53:56,FAKE,2921908781,241,2921909022,2955220608
2025-06-19 13:53:58,REAL,2921909022,5100,2921914122,2955225708
2025-06-19 13:54:00,REAL,2921914122,489,2921914611,2955226197
2025-06-19 13:54:02,REAL,2921914611,488,2921915099,2955226685
2025-06-19 13:54:04,FAKE,2921915099,238,2921915337,2955227175
2025-06-19 13:54:06,REAL,2921915337,475,2921915812,2955227650
2025-06-19 13:54:08,REAL,2921915812,487,2921916299,2955228137
2025-06-19 13:54:10,FAKE,2921916299,238,2921916537,2955228625
2025-06-19 13:54:12,REAL,2921916537,480,2921917017,2955229105
2025-06-19 13:54:14,REAL,2921917017,1480,2921918497,2955230585
2025-06-19 13:54:16,FAKE,2921918497,243,2921918740,2955242689
2025-06-19 13:54:18,REAL,2921918740,10251,2921928991,2955252940
2025-06-19 13:54:20,FAKE,2921928991,238,2921929229,2955263195
2025-06-19 13:54:22,FAKE,2921929229,244,2921929473,2955273515
2025-06-19 13:54:24,FAKE,2921929473,241,2921929714,2955283772
2025-06-19 13:54:26,REAL,2921929714,10323,2921940037,2955294095
2025-06-19 13:54:28,FAKE,2921940037,244,2921940281,2955304343
2025-06-19 13:54:30,REAL,2921940281,4560,2921944841,2955308903
2025-06-19 13:54:32,FAKE,2921944841,238,2921945079,2955309388
2025-06-19 13:54:34,FAKE,2921945079,238,2921945317,2955309882
2025-06-19 13:54:36,FAKE,2921945317,244,2921945561,2955318889
2025-06-19 13:54:38,REAL,2921945561,12629,2921958190,2955331518
2025-06-19 13:54:40,FAKE,2921958190,243,2921958433,2955341768
2025-06-19 13:54:42,REAL,2921958433,10317,2921968750,2955352085
2025-06-19 13:54:44,REAL,2921968750,10251,2921979001,2955362336
2025-06-19 13:54:46,REAL,2921979001,10257,2921989258,2955372593
2025-06-19 13:54:48,REAL,2921989258,10312,2921999570,2955382905
2025-06-19 13:54:50,FAKE,2921999570,244,2921999814,2955392106
2025-06-19 13:54:52,REAL,2921999814,484,2922000298,2955392590
2025-06-19 13:54:54,REAL,2922000298,487,2922000785,2955393077
2025-06-19 13:54:56,REAL,2922000785,485,2922001270,2955393562
2025-06-19 13:54:58,REAL,2922001270,487,2922001757,2955394049
2025-06-19 13:55:00,REAL,2922001757,485,2922002242,2955394534
2025-06-19 13:55:02,REAL,2922002242,482,2922002724,2955395016
2025-06-19 13:55:04,REAL,2922002724,476,2922003200,2955395492
2025-06-19 13:55:06,FAKE,2922003200,244,2922003444,2955395976
2025-06-19 13:55:08,FAKE,2922003444,243,2922003687,2955405254
2025-06-19 13:55:10,FAKE,2922003687,243,2922003930,2955415635
2025-06-19 13:55:12,REAL,2922003930,10309,2922014239,2955425944
2025-06-19 13:55:14,REAL,2922014239,10253,2922024492,2955436197
2025-06-19 13:55:16,REAL,2922024492,10320,2922034812,2955446517
2025-06-19 13:55:18,FAKE,2922034812,238,2922035050,2955456775
2025-06-19 13:55:20,REAL,2922035050,10242,2922045292,2955467017
2025-06-19 13:55:22,REAL,2922045292,8536,2922053828,2955475553
2025-06-19 13:55:24,REAL,2922053828,492,2922054320,2955476045
2025-06-19 13:55:26,REAL,2922054320,482,2922054802,2955476527
2025-06-19 13:55:28,REAL,2922054802,482,2922055284,2955477009
2025-06-19 13:55:30,REAL,2922055284,484,2922055768,2955477493
2025-06-19 13:55:32,FAKE,2922055768,243,2922056011,2955477973
2025-06-19 13:55:34,REAL,2922056011,486,2922056497,2955478459
2025-06-19 13:55:36,FAKE,2922056497,238,2922056735,2955478939
2025-06-19 13:55:38,REAL,2922056735,487,2922057222,2955479426
2025-06-19 13:55:40,FAKE,2922057222,238,2922057460,2955488829
2025-06-19 13:55:42,FAKE,2922057460,241,2922057701,2955499481
2025-06-19 13:55:44,REAL,2922057701,10328,2922068029,2955509809
2025-06-19 13:55:46,REAL,2922068029,10253,2922078282,2955520062
2025-06-19 13:55:48,REAL,2922078282,10251,2922088533,2955530313
2025-06-19 13:55:50,FAKE,2922088533,243,2922088776,2955540634
2025-06-19 13:55:52,FAKE,2922088776,243,2922089019,2955550882
2025-06-19 13:55:54,REAL,2922089019,7947,2922096966,2955558829
2025-06-19 13:55:56,REAL,2922096966,537,2922097503,2955559366
2025-06-19 13:55:58,REAL,2922097503,489,2922097992,2955559855
2025-06-19 13:56:00,REAL,2922097992,485,2922098477,2955560340
2025-06-19 13:56:02,REAL,2922098477,484,2922098961,2955560824
2025-06-19 13:56:04,REAL,2922098961,482,2922099443,2955561306
2025-06-19 13:56:06,FAKE,2922099443,238,2922099681,2955561788
2025-06-19 13:56:08,REAL,2922099681,490,2922100171,2955562278
2025-06-19 13:56:10,REAL,2922100171,487,2922100658,2955562765
2025-06-19 13:56:12,REAL,2922100658,483,2922101141,2955563248
2025-06-19 13:56:14,REAL,2922101141,485,2922101626,2955563733
2025-06-19 13:56:16,REAL,2922101626,480,2922102106,2955564213
2025-06-19 13:56:18,REAL,2922102106,480,2922102586,2955564693
2025-06-19 13:56:20,REAL,2922102586,480,2922103066,2955565173
2025-06-19 13:56:22,REAL,2922103066,480,2922103546,2955565653
2025-06-19 13:56:24,FAKE,2922103546,243,2922103789,2955566145
2025-06-19 13:56:26,REAL,2922103789,486,2922104275,2955566631
2025-06-19 13:56:28,REAL,2922104275,540,2922104815,2955567171
2025-06-19 13:56:30,REAL,2922104815,482,2922105297,2955567653
2025-06-19 13:56:32,REAL,2922105297,488,2922105785,2955568141
2025-06-19 13:56:34,REAL,2922105785,489,2922106274,2955568630
2025-06-19 13:56:36,REAL,2922106274,478,2922106752,2955569108
2025-06-19 13:56:38,REAL,2922106752,538,2922107290,2955569646
2025-06-19 13:56:40,REAL,2922107290,483,2922107773,2955570129
2025-06-19 13:56:42,REAL,2922107773,486,2922108259,2955570615
2025-06-19 13:56:44,REAL,2922108259,482,2922108741,2955571097
2025-06-19 13:56:46,REAL,2922108741,485,2922109226,2955571582
2025-06-19 13:56:48,REAL,2922109226,487,2922109713,2955572069
2025-06-19 13:56:50,REAL,2922109713,483,2922110196,2955572552
2025-06-19 13:56:52,REAL,2922110196,489,2922110685,2955573041
2025-06-19 13:56:54,REAL,2922110685,489,2922111174,2955573530
2025-06-19 13:56:56,REAL,2922111174,477,2922111651,2955574007
2025-06-19 13:56:58,REAL,2922111651,493,2922112144,2955574500
2025-06-19 13:57:00,FAKE,2922112144,238,2922112382,2955574986
2025-06-19 13:57:02,REAL,2922112382,486,2922112868,2955575472
2025-06-19 13:57:04,FAKE,2922112868,238,2922113106,2955580323
2025-06-19 13:57:06,REAL,2922113106,11456,2922124562,2955591779
2025-06-19 13:57:08,REAL,2922124562,10251,2922134813,2955602030
2025-06-19 13:57:10,REAL,2922134813,10325,2922145138,2955612355
2025-06-19 13:57:12,FAKE,2922145138,241,2922145379,2955622681
2025-06-19 13:57:14,REAL,2922145379,10320,2922155699,2955633001
2025-06-19 13:57:16,REAL,2922155699,10257,2922165956,2955643258
2025-06-19 13:57:18,FAKE,2922165956,241,2922166197,2955653578
2025-06-19 13:57:20,FAKE,2922166197,244,2922166441,2955654990
2025-06-19 13:57:22,REAL,2922166441,537,2922166978,2955655527
2025-06-19 13:57:24,REAL,2922166978,490,2922167468,2955656017
2025-06-19 13:57:26,FAKE,2922167468,241,2922167709,2955667079
2025-06-19 13:57:28,REAL,2922167709,10311,2922178020,2955677390
2025-06-19 13:57:30,REAL,2922178020,10253,2922188273,2955687643
2025-06-19 13:57:32,REAL,2922188273,10249,2922198522,2955697892
2025-06-19 13:57:34,REAL,2922198522,10247,2922208769,2955708139
2025-06-19 13:57:36,REAL,2922208769,10320,2922219089,2955718459
2025-06-19 13:57:38,FAKE,2922219089,241,2922219330,2955728705
2025-06-19 13:57:40,REAL,2922219330,6090,2922225420,2955734795
2025-06-19 13:57:42,REAL,2922225420,487,2922225907,2955735282
2025-06-19 13:57:44,REAL,2922225907,480,2922226387,2955735762
2025-06-19 13:57:46,REAL,2922226387,480,2922226867,2955736242
2025-06-19 13:57:48,REAL,2922226867,487,2922227354,2955736729
2025-06-19 13:57:50,REAL,2922227354,485,2922227839,2955737214
2025-06-19 13:57:52,REAL,2922227839,483,2922228322,2955737697
2025-06-19 13:57:54,REAL,2922228322,476,2922228798,2955738173
2025-06-19 13:57:56,REAL,2922228798,476,2922229274,2955738649
2025-06-19 13:57:58,REAL,2922229274,15171,2922244445,2955753820
2025-06-19 13:58:00,FAKE,2922244445,244,2922244689,2955764139
2025-06-19 13:58:02,REAL,2922244689,10251,2922254940,2955774390
2025-06-19 13:58:04,FAKE,2922254940,238,2922255178,2955784703
2025-06-19 13:58:06,REAL,2922255178,10313,2922265491,2955795016
2025-06-19 13:58:08,FAKE,2922265491,244,2922265735,2955805267
2025-06-19 13:58:10,FAKE,2922265735,241,2922265976,2955815585
2025-06-19 13:58:12,FAKE,2922265976,244,2922266220,2955821090
2025-06-19 13:58:14,REAL,2922266220,474,2922266694,2955821564
2025-06-19 13:58:16,REAL,2922266694,478,2922267172,2955822042
2025-06-19 13:58:18,REAL,2922267172,475,2922267647,2955822517
2025-06-19 13:58:20,REAL,2922267647,481,2922268128,2955822998
2025-06-19 13:58:22,FAKE,2922268128,243,2922268371,2955823485
2025-06-19 13:58:24,FAKE,2922268371,244,2922268615,2955823972
2025-06-19 13:58:26,REAL,2922268615,482,2922269097,2955824454
2025-06-19 13:58:28,FAKE,2922269097,238,2922269335,2955824943
2025-06-19 13:58:30,REAL,2922269335,481,2922269816,2955825424
2025-06-19 13:58:32,REAL,2922269816,487,2922270303,2955825911
2025-06-19 13:58:34,FAKE,2922270303,241,2922270544,2955826393
2025-06-19 13:58:36,FAKE,2922270544,243,2922270787,2955826875
2025-06-19 13:58:38,REAL,2922270787,630,2922271417,2955827505
2025-06-19 13:58:40,REAL,2922271417,12724,2922284141,2955840229
2025-06-19 13:58:42,FAKE,2922284141,243,2922284384,2955850489
2025-06-19 13:58:44,REAL,2922284384,10310,2922294694,2955860799
2025-06-19 13:58:46,FAKE,2922294694,244,2922294938,2955871110
2025-06-19 13:58:48,REAL,2922294938,10255,2922305193,2955881365
2025-06-19 13:58:50,FAKE,2922305193,243,2922305436,2955891613
2025-06-19 13:58:52,REAL,2922305436,10310,2922315746,2955901923
2025-06-19 13:58:54,REAL,2922315746,4903,2922320649,2955906826
2025-06-19 13:58:56,FAKE,2922320649,244,2922320893,2955907312
2025-06-19 13:58:58,REAL,2922320893,485,2922321378,2955907797
2025-06-19 13:59:00,REAL,2922321378,481,2922321859,2955908278
2025-06-19 13:59:02,REAL,2922321859,483,2922322342,2955908761
2025-06-19 13:59:04,REAL,2922322342,483,2922322825,2955909244
2025-06-19 13:59:06,REAL,2922322825,479,2922323304,2955909723
2025-06-19 13:59:08,REAL,2922323304,491,2922323795,2955910214
2025-06-19 13:59:10,REAL,2922323795,486,2922324281,2955910700
2025-06-19 13:59:12,REAL,2922324281,489,2922324770,2955911189
2025-06-19 13:59:14,REAL,2922324770,487,2922325257,2955911676
2025-06-19 13:59:16,REAL,2922325257,491,2922325748,2955912167
2025-06-19 13:59:18,REAL,2922325748,483,2922326231,2955912650
2025-06-19 13:59:20,REAL,2922326231,478,2922326709,2955913128
2025-06-19 13:59:22,REAL,2922326709,481,2922327190,2955913609
2025-06-19 13:59:24,REAL,2922327190,477,2922327667,2955914086
2025-06-19 13:59:26,REAL,2922327667,542,2922328209,2955914628
2025-06-19 13:59:28,REAL,2922328209,540,2922328749,2955915168
2025-06-19 13:59:30,REAL,2922328749,481,2922329230,2955915649
2025-06-19 13:59:32,REAL,2922329230,490,2922329720,2955916139
2025-06-19 13:59:34,REAL,2922329720,485,2922330205,2955916624
2025-06-19 13:59:36,FAKE,2922330205,238,2922330443,2955917108
2025-06-19 13:59:38,FAKE,2922330443,241,2922330684,2955917585
2025-06-19 13:59:40,REAL,2922330684,484,2922331168,2955918069
2025-06-19 13:59:42,FAKE,2922331168,241,2922331409,2955918554
2025-06-19 13:59:44,REAL,2922331409,486,2922331895,2955919040
2025-06-19 13:59:46,REAL,2922331895,482,2922332377,2955919522
2025-06-19 13:59:48,REAL,2922332377,480,2922332857,2955920002
2025-06-19 13:59:50,FAKE,2922332857,238,2922333095,2955920491
2025-06-19 13:59:52,FAKE,2922333095,243,2922333338,2955920973
2025-06-19 13:59:54,FAKE,2922333338,238,2922333576,2955921458
2025-06-19 13:59:56,REAL,2922333576,488,2922334064,2955921946
2025-06-19 13:59:58,REAL,2922334064,488,2922334552,2955922434
2025-06-19 14:00:00,REAL,2922334552,480,2922335032,2955922914
2025-06-19 14:00:02,FAKE,2922335032,244,2922335276,2955923398
2025-06-19 14:00:04,FAKE,2922335276,241,2922335517,2955923874
2025-06-19 14:00:06,REAL,2922335517,486,2922336003,2955924360
2025-06-19 14:00:08,FAKE,2922336003,238,2922336241,2955924901
2025-06-19 14:00:10,REAL,2922336241,489,2922336730,2955925390
2025-06-19 14:00:12,REAL,2922336730,479,2922337209,2955925869
2025-06-19 14:00:14,REAL,2922337209,546,2922337755,2955926415
2025-06-19 14:00:16,REAL,2922337755,487,2922338242,2955926902
2025-06-19 14:00:18,REAL,2922338242,486,2922338728,2955927388
2025-06-19 14:00:20,REAL,2922338728,478,2922339206,2955927866
2025-06-19 14:00:22,FAKE,2922339206,243,2922339449,2955928353
2025-06-19 14:00:24,FAKE,2922339449,244,2922339693,2955928837
2025-06-19 14:00:26,REAL,2922339693,485,2922340178,2955929322
2025-06-19 14:00:28,REAL,2922340178,476,2922340654,2955929798
2025-06-19 14:00:30,REAL,2922340654,489,2922341143,2955930287
2025-06-19 14:00:32,REAL,2922341143,477,2922341620,2955930764
2025-06-19 14:00:34,REAL,2922341620,493,2922342113,2955931257
2025-06-19 14:00:36,REAL,2922342113,478,2922342591,2955931735
2025-06-19 14:00:38,REAL,2922342591,490,2922343081,2955932225
2025-06-19 14:00:40,FAKE,2922343081,238,2922343319,2955932717
2025-06-19 14:00:42,FAKE,2922343319,241,2922343560,2955933199
2025-06-19 14:00:44,REAL,2922343560,488,2922344048,2955933687
2025-06-19 14:00:46,REAL,2922344048,9141,2922353189,2955942828
2025-06-19 14:00:48,REAL,2922353189,10635,2922363824,2955953463
2025-06-19 14:00:50,REAL,2922363824,10317,2922374141,2955963780
2025-06-19 14:00:52,REAL,2922374141,10256,2922384397,2955974036
2025-06-19 14:00:54,FAKE,2922384397,243,2922384640,2955984298
2025-06-19 14:00:56,FAKE,2922384640,243,2922384883,2955994623
2025-06-19 14:00:58,REAL,2922384883,10252,2922395135,2956004875
2025-06-19 14:01:00,FAKE,2922395135,238,2922395373,2956012684
2025-06-19 14:01:02,REAL,2922395373,485,2922395858,2956013169
2025-06-19 14:01:04,FAKE,2922395858,244,2922396102,2956013649
2025-06-19 14:01:06,REAL,2922396102,486,2922396588,2956014135
2025-06-19 14:01:08,REAL,2922396588,546,2922397134,2956014681
2025-06-19 14:01:10,REAL,2922397134,489,2922397623,2956015170
2025-06-19 14:01:12,FAKE,2922397623,238,2922397861,2956015651
2025-06-19 14:01:14,FAKE,2922397861,244,2922398105,2956016140
2025-06-19 14:01:16,REAL,2922398105,487,2922398592,2956016627
2025-06-19 14:01:18,REAL,2922398592,476,2922399068,2956017103
2025-06-19 14:01:20,REAL,2922399068,488,2922399556,2956017591
2025-06-19 14:01:22,FAKE,2922399556,244,2922399800,2956018068
2025-06-19 14:01:24,REAL,2922399800,489,2922400289,2956018557
2025-06-19 14:01:26,REAL,2922400289,482,2922400771,2956019039
2025-06-19 14:01:28,REAL,2922400771,488,2922401259,2956019527
2025-06-19 14:01:30,REAL,2922401259,541,2922401800,2956020068
2025-06-19 14:01:32,REAL,2922401800,540,2922402340,2956020608
2025-06-19 14:01:34,FAKE,2922402340,243,2922402583,2956021094
2025-06-19 14:01:36,FAKE,2922402583,238,2922402821,2956021577
2025-06-19 14:01:38,FAKE,2922402821,241,2922403062,2956022053
2025-06-19 14:01:40,REAL,2922403062,476,2922403538,2956022529
2025-06-19 14:01:42,REAL,2922403538,485,2922404023,2956023014
2025-06-19 14:01:44,REAL,2922404023,486,2922404509,2956023500
2025-06-19 14:01:46,REAL,2922404509,488,2922404997,2956023988
2025-06-19 14:01:48,REAL,2922404997,487,2922405484,2956024475
2025-06-19 14:01:50,FAKE,2922405484,243,2922405727,2956024958
2025-06-19 14:01:52,REAL,2922405727,485,2922406212,2956025443
2025-06-19 14:01:54,FAKE,2922406212,243,2922406455,2956025928
2025-06-19 14:01:56,FAKE,2922406455,243,2922406698,2956026414
2025-06-19 14:01:58,FAKE,2922406698,238,2922406936,2956026953
2025-06-19 14:02:00,REAL,2922406936,485,2922407421,2956027438
2025-06-19 14:02:02,REAL,2922407421,485,2922407906,2956027923
2025-06-19 14:02:04,REAL,2922407906,486,2922408392,2956028409
2025-06-19 14:02:06,FAKE,2922408392,243,2922408635,2956028893
2025-06-19 14:02:08,REAL,2922408635,486,2922409121,2956029379
2025-06-19 14:02:10,REAL,2922409121,539,2922409660,2956029918
2025-06-19 14:02:12,REAL,2922409660,483,2922410143,2956030401
2025-06-19 14:02:14,FAKE,2922410143,241,2922410384,2956030882
2025-06-19 14:02:16,REAL,2922410384,489,2922410873,2956031371
2025-06-19 14:02:18,REAL,2922410873,488,2922411361,2956031859
2025-06-19 14:02:20,REAL,2922411361,480,2922411841,2956032339
2025-06-19 14:02:22,REAL,2922411841,536,2922412377,2956032875
2025-06-19 14:02:24,FAKE,2922412377,238,2922412615,2956033357
2025-06-19 14:02:26,FAKE,2922412615,238,2922412853,2956033849
2025-06-19 14:02:28,REAL,2922412853,488,2922413341,2956034337
2025-06-19 14:02:30,FAKE,2922413341,238,2922413579,2956034820
2025-06-19 14:02:32,REAL,2922413579,491,2922414070,2956035311
2025-06-19 14:02:34,REAL,2922414070,481,2922414551,2956035792
2025-06-19 14:02:36,REAL,2922414551,481,2922415032,2956036273
2025-06-19 14:02:38,REAL,2922415032,475,2922415507,2956036748
2025-06-19 14:02:40,REAL,2922415507,484,2922415991,2956037232
2025-06-19 14:02:42,REAL,2922415991,13888,2922429879,2956051120
2025-06-19 14:02:44,REAL,2922429879,10383,2922440262,2956061503
2025-06-19 14:02:46,FAKE,2922440262,238,2922440500,2956071880
2025-06-19 14:02:48,FAKE,2922440500,241,2922440741,2956082131
2025-06-19 14:02:50,FAKE,2922440741,238,2922440979,2956092454
2025-06-19 14:02:52,REAL,2922440979,10315,2922451294,2956102769
2025-06-19 14:02:54,REAL,2922451294,10318,2922461612,2956113087
2025-06-19 14:02:56,REAL,2922461612,6099,2922467711,2956119186
2025-06-19 14:02:58,FAKE,2922467711,243,2922467954,2956119663
2025-06-19 14:03:00,REAL,2922467954,476,2922468430,2956120139
2025-06-19 14:03:02,FAKE,2922468430,238,2922468668,2956120618
2025-06-19 14:03:04,FAKE,2922468668,238,2922468906,2956121104
2025-06-19 14:03:06,FAKE,2922468906,244,2922469150,2956121586
2025-06-19 14:03:08,FAKE,2922469150,243,2922469393,2956122064
2025-06-19 14:03:10,FAKE,2922469393,241,2922469634,2956122604
2025-06-19 14:03:12,REAL,2922469634,481,2922470115,2956123085
2025-06-19 14:03:14,REAL,2922470115,480,2922470595,2956123565
2025-06-19 14:03:16,REAL,2922470595,483,2922471078,2956124048
2025-06-19 14:03:18,FAKE,2922471078,244,2922471322,2956124533
2025-06-19 14:03:20,FAKE,2922471322,243,2922471565,2956125021
2025-06-19 14:03:22,REAL,2922471565,478,2922472043,2956125499
2025-06-19 14:03:24,REAL,2922472043,482,2922472525,2956125981
2025-06-19 14:03:26,FAKE,2922472525,244,2922472769,2956126460
2025-06-19 14:03:28,FAKE,2922472769,238,2922473007,2956126952
2025-06-19 14:03:30,FAKE,2922473007,244,2922473251,2956127433
2025-06-19 14:03:32,REAL,2922473251,534,2922473785,2956127967
2025-06-19 14:03:34,FAKE,2922473785,243,2922474028,2956134860
2025-06-19 14:03:36,FAKE,2922474028,238,2922474266,2956146041
2025-06-19 14:03:38,FAKE,2922474266,244,2922474510,2956156358
2025-06-19 14:03:40,FAKE,2922474510,244,2922474754,2956166617
2025-06-19 14:03:42,REAL,2922474754,10259,2922485013,2956176876
2025-06-19 14:03:44,REAL,2922485013,10312,2922495325,2956187188
2025-06-19 14:03:46,REAL,2922495325,10250,2922505575,2956197438
2025-06-19 14:03:48,REAL,2922505575,10054,2922515629,2956207492
2025-06-19 14:03:50,REAL,2922515629,479,2922516108,2956207971
2025-06-19 14:03:52,FAKE,2922516108,243,2922516351,2956208454
2025-06-19 14:03:54,REAL,2922516351,486,2922516837,2956208940
2025-06-19 14:03:56,REAL,2922516837,545,2922517382,2956209485
2025-06-19 14:03:58,REAL,2922517382,483,2922517865,2956209968
2025-06-19 14:04:00,REAL,2922517865,486,2922518351,2956210454
2025-06-19 14:04:02,FAKE,2922518351,241,2922518592,2956210934
2025-06-19 14:04:04,REAL,2922518592,481,2922519073,2956211415
2025-06-19 14:04:06,REAL,2922519073,482,2922519555,2956211897
2025-06-19 14:04:08,REAL,2922519555,487,2922520042,2956212384
2025-06-19 14:04:10,FAKE,2922520042,238,2922520280,2956212868
2025-06-19 14:04:12,FAKE,2922520280,244,2922520524,2956213409
2025-06-19 14:04:14,FAKE,2922520524,244,2922520768,2956213888
2025-06-19 14:04:16,REAL,2922520768,7091,2922527859,2956220979
2025-06-19 14:04:18,REAL,2922527859,10969,2922538828,2956231948
2025-06-19 14:04:20,REAL,2922538828,10256,2922549084,2956242204
2025-06-19 14:04:22,FAKE,2922549084,238,2922549322,2956252576
2025-06-19 14:04:24,FAKE,2922549322,244,2922549566,2956262826
2025-06-19 14:04:26,REAL,2922549566,10254,2922559820,2956273080
2025-06-19 14:04:28,REAL,2922559820,10314,2922570134,2956283394
2025-06-19 14:04:30,FAKE,2922570134,238,2922570372,2956292852
2025-06-19 14:04:32,REAL,2922570372,481,2922570853,2956293333
2025-06-19 14:04:34,FAKE,2922570853,238,2922571091,2956293816
2025-06-19 14:04:36,REAL,2922571091,486,2922571577,2956294302
2025-06-19 14:04:38,FAKE,2922571577,241,2922571818,2956294782
2025-06-19 14:04:40,REAL,2922571818,482,2922572300,2956295264
2025-06-19 14:04:42,REAL,2922572300,480,2922572780,2956295744
2025-06-19 14:04:44,REAL,2922572780,480,2922573260,2956296224
2025-06-19 14:04:46,REAL,2922573260,533,2922573793,2956296757
2025-06-19 14:04:48,REAL,2922573793,7620,2922581413,2956304377
2025-06-19 14:04:50,FAKE,2922581413,241,2922581654,2956315225
2025-06-19 14:04:52,REAL,2922581654,10245,2922591899,2956325470
2025-06-19 14:04:54,FAKE,2922591899,244,2922592143,2956335778
2025-06-19 14:04:56,REAL,2922592143,10255,2922602398,2956346033
2025-06-19 14:04:58,FAKE,2922602398,241,2922602639,2956356352
2025-06-19 14:05:00,REAL,2922602639,10246,2922612885,2956366598
2025-06-19 14:05:02,REAL,2922612885,8868,2922621753,2956375466
2025-06-19 14:05:04,FAKE,2922621753,241,2922621994,2956375951
2025-06-19 14:05:06,REAL,2922621994,477,2922622471,2956376428
2025-06-19 14:05:08,REAL,2922622471,2209,2922624680,2956378637
2025-06-19 14:05:10,REAL,2922624680,15013,2922639693,2956393650
2025-06-19 14:05:12,REAL,2922639693,10256,2922649949,2956403906
2025-06-19 14:05:14,FAKE,2922649949,244,2922650193,2956414164
2025-06-19 14:05:16,REAL,2922650193,10316,2922660509,2956424480
2025-06-19 14:05:18,REAL,2922660509,10251,2922670760,2956434731
2025-06-19 14:05:20,FAKE,2922670760,244,2922671004,2956445041
2025-06-19 14:05:22,FAKE,2922671004,243,2922671247,2956455293
2025-06-19 14:05:24,REAL,2922671247,3784,2922675031,2956459077
2025-06-19 14:05:26,FAKE,2922675031,238,2922675269,2956459558
2025-06-19 14:05:28,FAKE,2922675269,243,2922675512,2956460044
2025-06-19 14:05:30,REAL,2922675512,488,2922676000,2956460532
2025-06-19 14:05:32,REAL,2922676000,536,2922676536,2956461068
2025-06-19 14:05:34,REAL,2922676536,480,2922677016,2956461548
2025-06-19 14:05:36,REAL,2922677016,538,2922677554,2956462086
2025-06-19 14:05:38,REAL,2922677554,485,2922678039,2956462571
2025-06-19 14:05:40,REAL,2922678039,485,2922678524,2956463056
2025-06-19 14:05:42,REAL,2922678524,484,2922679008,2956463540
2025-06-19 14:05:44,REAL,2922679008,481,2922679489,2956464021
2025-06-19 14:05:46,REAL,2922679489,480,2922679969,2956464501
2025-06-19 14:05:48,REAL,2922679969,479,2922680448,2956464980
2025-06-19 14:05:50,REAL,2922680448,487,2922680935,2956465467
2025-06-19 14:05:52,FAKE,2922680935,241,2922681176,2956465960
2025-06-19 14:05:54,REAL,2922681176,488,2922681664,2956466448
2025-06-19 14:05:56,FAKE,2922681664,238,2922681902,2956466932
2025-06-19 14:05:58,FAKE,2922681902,244,2922682146,2956467177
2025-06-19 14:06:00,REAL,2922682146,486,2922682632,2956467663
2025-06-19 14:06:02,REAL,2922682632,543,2922683175,2956468206
2025-06-19 14:06:04,REAL,2922683175,478,2922683653,2956468684
2025-06-19 14:06:06,REAL,2922683653,475,2922684128,2956469159
2025-06-19 14:06:08,REAL,2922684128,476,2922684604,2956469635
2025-06-19 14:06:10,REAL,2922684604,478,2922685082,2956470113
2025-06-19 14:06:12,FAKE,2922685082,238,2922685320,2956473841
2025-06-19 14:06:14,FAKE,2922685320,238,2922685558,2956485211
2025-06-19 14:06:16,FAKE,2922685558,243,2922685801,2956495510
2025-06-19 14:06:18,REAL,2922685801,10312,2922696113,2956505822
2025-06-19 14:06:20,REAL,2922696113,10260,2922706373,2956516082
2025-06-19 14:06:22,REAL,2922706373,10323,2922716696,2956526405
2025-06-19 14:06:24,FAKE,2922716696,238,2922716934,2956536661
2025-06-19 14:06:26,REAL,2922716934,10319,2922727253,2956546980
2025-06-19 14:06:28,FAKE,2922727253,243,2922727496,2956549453
2025-06-19 14:06:30,REAL,2922727496,484,2922727980,2956549937
2025-06-19 14:06:32,REAL,2922727980,482,2922728462,2956550419
2025-06-19 14:06:34,FAKE,2922728462,244,2922728706,2956550905
2025-06-19 14:06:36,FAKE,2922728706,243,2922728949,2956551384
2025-06-19 14:06:38,FAKE,2922728949,241,2922729190,2956551866
2025-06-19 14:06:40,REAL,2922729190,536,2922729726,2956552402
2025-06-19 14:06:42,FAKE,2922729726,238,2922729964,2956552887
2025-06-19 14:06:44,REAL,2922729964,482,2922730446,2956553369
2025-06-19 14:06:46,REAL,2922730446,477,2922730923,2956553846
2025-06-19 14:06:48,FAKE,2922730923,241,2922731164,2956554335
2025-06-19 14:06:50,REAL,2922731164,493,2922731657,2956554828
2025-06-19 14:06:52,REAL,2922731657,484,2922732141,2956555312
2025-06-19 14:06:54,FAKE,2922732141,243,2922732384,2956555789
2025-06-19 14:06:56,REAL,2922732384,484,2922732868,2956556273
2025-06-19 14:06:58,FAKE,2922732868,238,2922733106,2956556810
2025-06-19 14:07:00,REAL,2922733106,480,2922733586,2956557290
2025-06-19 14:07:02,REAL,2922733586,488,2922734074,2956557778
2025-06-19 14:07:04,FAKE,2922734074,244,2922734318,2956558264
2025-06-19 14:07:06,FAKE,2922734318,241,2922734559,2956558747
2025-06-19 14:07:08,FAKE,2922734559,244,2922734803,2956559224
2025-06-19 14:07:10,REAL,2922734803,532,2922735335,2956559756
2025-06-19 14:07:12,REAL,2922735335,478,2922735813,2956560234
2025-06-19 14:07:14,REAL,2922735813,477,2922736290,2956560711
2025-06-19 14:07:16,FAKE,2922736290,241,2922736531,2956561195
2025-06-19 14:07:18,REAL,2922736531,483,2922737014,2956561678
2025-06-19 14:07:20,REAL,2922737014,492,2922737506,2956562170
2025-06-19 14:07:22,REAL,2922737506,480,2922737986,2956562650
2025-06-19 14:07:24,FAKE,2922737986,244,2922738230,2956563134
2025-06-19 14:07:26,REAL,2922738230,477,2922738707,2956563611
2025-06-19 14:07:28,REAL,2922738707,482,2922739189,2956564093
2025-06-19 14:07:30,REAL,2922739189,489,2922739678,2956564582
2025-06-19 14:07:32,FAKE,2922739678,244,2922739922,2956565071
2025-06-19 14:07:34,REAL,2922739922,475,2922740397,2956565546
2025-06-19 14:07:36,REAL,2922740397,479,2922740876,2956566025
2025-06-19 14:07:38,FAKE,2922740876,244,2922741120,2956566626
2025-06-19 14:07:40,REAL,2922741120,489,2922741609,2956567115
2025-06-19 14:07:42,REAL,2922741609,489,2922742098,2956567604
2025-06-19 14:07:44,REAL,2922742098,492,2922742590,2956568096
2025-06-19 14:07:46,REAL,2922742590,480,2922743070,2956568576
2025-06-19 14:07:48,REAL,2922743070,483,2922743553,2956569059
2025-06-19 14:07:50,REAL,2922743553,477,2922744030,2956569536
2025-06-19 14:07:52,FAKE,2922744030,238,2922744268,2956570017
2025-06-19 14:07:54,REAL,2922744268,488,2922744756,2956570505
2025-06-19 14:07:56,FAKE,2922744756,243,2922744999,2956570986
2025-06-19 14:07:58,REAL,2922744999,491,2922745490,2956571477
2025-06-19 14:08:00,FAKE,2922745490,241,2922745731,2956571954
2025-06-19 14:08:02,REAL,2922745731,493,2922746224,2956572447
2025-06-19 14:08:04,REAL,2922746224,11718,2922757942,2956584165
2025-06-19 14:08:06,REAL,2922757942,10300,2922768242,2956594465
2025-06-19 14:08:08,FAKE,2922768242,238,2922768480,2956604779
2025-06-19 14:08:10,REAL,2922768480,10253,2922778733,2956615032
2025-06-19 14:08:12,FAKE,2922778733,243,2922778976,2956625348
2025-06-19 14:08:14,REAL,2922778976,10250,2922789226,2956635598
2025-06-19 14:08:16,REAL,2922789226,10247,2922799473,2956645845
2025-06-19 14:08:18,FAKE,2922799473,241,2922799714,2956651415
2025-06-19 14:08:20,FAKE,2922799714,238,2922799952,2956651901
2025-06-19 14:08:22,FAKE,2922799952,238,2922800190,2956652384
2025-06-19 14:08:24,FAKE,2922800190,243,2922800433,2956652865
2025-06-19 14:08:26,FAKE,2922800433,238,2922800671,2956653348
2025-06-19 14:08:28,REAL,2922800671,484,2922801155,2956653832
2025-06-19 14:08:30,REAL,2922801155,541,2922801696,2956654373
2025-06-19 14:08:32,REAL,2922801696,485,2922802181,2956654858
2025-06-19 14:08:34,REAL,2922802181,627,2922802808,2956655485
2025-06-19 14:08:36,REAL,2922802808,11957,2922814765,2956667442
2025-06-19 14:08:38,REAL,2922814765,10252,2922825017,2956677694
2025-06-19 14:08:40,REAL,2922825017,10248,2922835265,2956687942
2025-06-19 14:08:42,REAL,2922835265,10316,2922845581,2956698258
2025-06-19 14:08:44,FAKE,2922845581,238,2922845819,2956708512
2025-06-19 14:08:46,REAL,2922845819,10321,2922856140,2956718833
2025-06-19 14:08:48,REAL,2922856140,10251,2922866391,2956729084
2025-06-19 14:08:50,FAKE,2922866391,238,2922866629,2956733991
2025-06-19 14:08:52,REAL,2922866629,488,2922867117,2956734479
2025-06-19 14:08:54,REAL,2922867117,478,2922867595,2956734957
2025-06-19 14:08:56,REAL,2922867595,486,2922868081,2956735443
2025-06-19 14:08:58,FAKE,2922868081,238,2922868319,2956735933
2025-06-19 14:09:00,REAL,2922868319,488,2922868807,2956736421
2025-06-19 14:09:02,REAL,2922868807,546,2922869353,2956736967
2025-06-19 14:09:04,FAKE,2922869353,244,2922869597,2956737506
2025-06-19 14:09:06,REAL,2922869597,490,2922870087,2956737996
2025-06-19 14:09:08,REAL,2922870087,488,2922870575,2956738484
2025-06-19 14:09:10,REAL,2922870575,477,2922871052,2956738961
2025-06-19 14:09:12,REAL,2922871052,486,2922871538,2956739447
2025-06-19 14:09:14,REAL,2922871538,479,2922872017,2956739926
2025-06-19 14:09:16,REAL,2922872017,485,2922872502,2956740411
2025-06-19 14:09:18,REAL,2922872502,486,2922872988,2956740897
2025-06-19 14:09:20,REAL,2922872988,484,2922873472,2956741381
2025-06-19 14:09:22,FAKE,2922873472,241,2922873713,2956741859
2025-06-19 14:09:24,REAL,2922873713,484,2922874197,2956742343
2025-06-19 14:09:26,FAKE,2922874197,241,2922874438,2956742827
2025-06-19 14:09:28,REAL,2922874438,483,2922874921,2956743310
2025-06-19 14:09:30,FAKE,2922874921,243,2922875164,2956743850
2025-06-19 14:09:32,REAL,2922875164,531,2922875695,2956744381
2025-06-19 14:09:34,REAL,2922875695,483,2922876178,2956744864
2025-06-19 14:09:36,REAL,2922876178,475,2922876653,2956745339
2025-06-19 14:09:38,REAL,2922876653,479,2922877132,2956745818
2025-06-19 14:09:40,FAKE,2922877132,241,2922877373,2956746304
2025-06-19 14:09:42,REAL,2922877373,481,2922877854,2956746785
2025-06-19 14:09:44,REAL,2922877854,8617,2922886471,2956755402
2025-06-19 14:09:46,FAKE,2922886471,241,2922886712,2956766111
2025-06-19 14:09:48,REAL,2922886712,10243,2922896955,2956776354
2025-06-19 14:09:50,REAL,2922896955,10255,2922907210,2956786609
2025-06-19 14:09:52,FAKE,2922907210,243,2922907453,2956796923
2025-06-19 14:09:54,REAL,2922907453,10185,2922917638,2956807108
2025-06-19 14:09:56,REAL,2922917638,10318,2922927956,2956817426
2025-06-19 14:09:58,REAL,2922927956,8533,2922936489,2956825959
2025-06-19 14:10:00,REAL,2922936489,481,2922936970,2956826440
2025-06-19 14:10:02,REAL,2922936970,539,2922937509,2956826979
2025-06-19 14:10:04,REAL,2922937509,2668,2922940177,2956829647
2025-06-19 14:10:06,REAL,2922940177,14224,2922954401,2956843871
2025-06-19 14:10:08,REAL,2922954401,10250,2922964651,2956854121
2025-06-19 14:10:10,REAL,2922964651,10319,2922974970,2956864440
2025-06-19 14:10:12,FAKE,2922974970,244,2922975214,2956874756
2025-06-19 14:10:14,REAL,2922975214,10256,2922985470,2956885012
2025-06-19 14:10:16,FAKE,2922985470,244,2922985714,2956895331
2025-06-19 14:10:18,FAKE,2922985714,244,2922985958,2956905584
2025-06-19 14:10:20,REAL,2922985958,3251,2922989209,2956908835
2025-06-19 14:10:22,REAL,2922989209,482,2922989691,2956909317
2025-06-19 14:10:24,REAL,2922989691,480,2922990171,2956909797
2025-06-19 14:10:26,REAL,2922990171,488,2922990659,2956910285
2025-06-19 14:10:28,REAL,2922990659,485,2922991144,2956910770
2025-06-19 14:10:30,FAKE,2922991144,244,2922991388,2956911309
2025-06-19 14:10:32,REAL,2922991388,475,2922991863,2956911784
2025-06-19 14:10:34,REAL,2922991863,543,2922992406,2956912327
2025-06-19 14:10:36,REAL,2922992406,3526,2922995932,2956915853
2025-06-19 14:10:38,FAKE,2922995932,238,2922996170,2956927494
2025-06-19 14:10:40,REAL,2922996170,10253,2923006423,2956937747
2025-06-19 14:10:42,REAL,2923006423,10252,2923016675,2956947999
2025-06-19 14:10:44,FAKE,2923016675,244,2923016919,2956958314
2025-06-19 14:10:46,REAL,2923016919,10249,2923027168,2956968563
2025-06-19 14:10:48,REAL,2923027168,10246,2923037414,2956978809
2025-06-19 14:10:50,REAL,2923037414,10319,2923047733,2956989128
2025-06-19 14:10:52,REAL,2923047733,2661,2923050394,2956991789
2025-06-19 14:10:54,REAL,2923050394,485,2923050879,2956992274
2025-06-19 14:10:56,FAKE,2923050879,243,2923051122,2956992754
2025-06-19 14:10:58,FAKE,2923051122,243,2923051365,2956993296
2025-06-19 14:11:00,REAL,2923051365,484,2923051849,2956993780
2025-06-19 14:11:02,FAKE,2923051849,244,2923052093,2956994269
2025-06-19 14:11:04,FAKE,2923052093,243,2923052336,2956994754
2025-06-19 14:11:06,REAL,2923052336,484,2923052820,2956995238
2025-06-19 14:11:08,FAKE,2923052820,238,2923053058,2956995723
2025-06-19 14:11:10,FAKE,2923053058,238,2923053296,2956996204
2025-06-19 14:11:12,REAL,2923053296,491,2923053787,2956996695
2025-06-19 14:11:14,FAKE,2923053787,241,2923054028,2956997235
2025-06-19 14:11:16,REAL,2923054028,488,2923054516,2956997723
2025-06-19 14:11:18,REAL,2923054516,4325,2923058841,2957002048
2025-06-19 14:11:20,REAL,2923058841,11113,2923069954,2957013161
2025-06-19 14:11:22,REAL,2923069954,10318,2923080272,2957023479
2025-06-19 14:11:24,FAKE,2923080272,241,2923080513,2957033730
2025-06-19 14:11:26,FAKE,2923080513,243,2923080756,2957044173
2025-06-19 14:11:28,REAL,2923080756,10171,2923090927,2957054344
2025-06-19 14:11:30,REAL,2923090927,10253,2923101180,2957064597
2025-06-19 14:11:32,REAL,2923101180,10252,2923111432,2957074849
2025-06-19 14:11:34,REAL,2923111432,2203,2923113635,2957077052
2025-06-19 14:11:36,REAL,2923113635,476,2923114111,2957077528
2025-06-19 14:11:38,REAL,2923114111,489,2923114600,2957078017
2025-06-19 14:11:40,REAL,2923114600,13619,2923128219,2957091636
2025-06-19 14:11:42,REAL,2923128219,11108,2923139327,2957102744
2025-06-19 14:11:44,REAL,2923139327,10254,2923149581,2957112998
2025-06-19 14:11:46,REAL,2923149581,10318,2923159899,2957123316
2025-06-19 14:11:48,FAKE,2923159899,238,2923160137,2957133562
2025-06-19 14:11:50,REAL,2923160137,10318,2923170455,2957143880
2025-06-19 14:11:52,FAKE,2923170455,244,2923170699,2957154133
2025-06-19 14:11:54,REAL,2923170699,6823,2923177522,2957160956
2025-06-19 14:11:56,REAL,2923177522,541,2923178063,2957161497
2025-06-19 14:11:58,FAKE,2923178063,243,2923178306,2957161983
2025-06-19 14:12:00,REAL,2923178306,476,2923178782,2957162459
2025-06-19 14:12:02,REAL,2923178782,482,2923179264,2957162941
2025-06-19 14:12:04,REAL,2923179264,482,2923179746,2957163423
2025-06-19 14:12:06,REAL,2923179746,484,2923180230,2957163907
2025-06-19 14:12:08,FAKE,2923180230,243,2923180473,2957164393
2025-06-19 14:12:10,FAKE,2923180473,238,2923180711,2957164875
2025-06-19 14:12:12,FAKE,2923180711,238,2923180949,2957165361
2025-06-19 14:12:14,REAL,2923180949,488,2923181437,2957165849
2025-06-19 14:12:16,FAKE,2923181437,238,2923181675,2957166338
2025-06-19 14:12:18,REAL,2923181675,540,2923182215,2957166878
2025-06-19 14:12:20,FAKE,2923182215,243,2923182458,2957167370
2025-06-19 14:12:22,REAL,2923182458,483,2923182941,2957167853
2025-06-19 14:12:24,REAL,2923182941,538,2923183479,2957168391
2025-06-19 14:12:26,REAL,2923183479,476,2923183955,2957168867
2025-06-19 14:12:28,REAL,2923183955,489,2923184444,2957169356
2025-06-19 14:12:30,REAL,2923184444,482,2923184926,2957169838
2025-06-19 14:12:32,REAL,2923184926,485,2923185411,2957170323
2025-06-19 14:12:34,FAKE,2923185411,244,2923185655,2957170802
2025-06-19 14:12:36,REAL,2923185655,483,2923186138,2957171285
2025-06-19 14:12:38,REAL,2923186138,487,2923186625,2957171772
2025-06-19 14:12:40,REAL,2923186625,477,2923187102,2957172249
2025-06-19 14:12:42,FAKE,2923187102,244,2923187346,2957172738
2025-06-19 14:12:44,REAL,2923187346,487,2923187833,2957173225
2025-06-19 14:12:46,REAL,2923187833,489,2923188322,2957173714
2025-06-19 14:12:48,FAKE,2923188322,244,2923188566,2957185363
2025-06-19 14:12:50,REAL,2923188566,10250,2923198816,2957195613
2025-06-19 14:12:52,REAL,2923198816,10323,2923209139,2957205936
2025-06-19 14:12:54,REAL,2923209139,10256,2923219395,2957216192
2025-06-19 14:12:56,FAKE,2923219395,243,2923219638,2957226510
2025-06-19 14:12:58,REAL,2923219638,10253,2923229891,2957236763
2025-06-19 14:13:00,FAKE,2923229891,244,2923230135,2957247085
2025-06-19 14:13:02,FAKE,2923230135,244,2923230379,2957252983
2025-06-19 14:13:04,FAKE,2923230379,244,2923230623,2957253467
2025-06-19 14:13:06,REAL,2923230623,535,2923231158,2957254002
2025-06-19 14:13:08,FAKE,2923231158,243,2923231401,2957261041
2025-06-19 14:13:10,REAL,2923231401,13620,2923245021,2957274661
2025-06-19 14:13:12,REAL,2923245021,10318,2923255339,2957284979
2025-06-19 14:13:14,REAL,2923255339,10256,2923265595,2957295235
2025-06-19 14:13:16,REAL,2923265595,10318,2923275913,2957305553
2025-06-19 14:13:18,FAKE,2923275913,238,2923276151,2957315802
2025-06-19 14:13:20,FAKE,2923276151,243,2923276394,2957326121
2025-06-19 14:13:22,REAL,2923276394,10253,2923286647,2957336374
2025-06-19 14:13:24,REAL,2923286647,618,2923287265,2957336992
2025-06-19 14:13:26,REAL,2923287265,489,2923287754,2957337481
2025-06-19 14:13:28,FAKE,2923287754,244,2923287998,2957337966
2025-06-19 14:13:30,REAL,2923287998,484,2923288482,2957338450
2025-06-19 14:13:32,REAL,2923288482,480,2923288962,2957338930
2025-06-19 14:13:34,REAL,2923288962,484,2923289446,2957339414
2025-06-19 14:13:36,REAL,2923289446,486,2923289932,2957339900
2025-06-19 14:13:38,REAL,2923289932,477,2923290409,2957340377
2025-06-19 14:13:40,FAKE,2923290409,241,2923290650,2957340861
2025-06-19 14:13:42,REAL,2923290650,489,2923291139,2957341350
2025-06-19 14:13:44,REAL,2923291139,479,2923291618,2957341829
2025-06-19 14:13:46,REAL,2923291618,539,2923292157,2957342368
2025-06-19 14:13:48,REAL,2923292157,532,2923292689,2957342900
2025-06-19 14:13:50,FAKE,2923292689,241,2923292930,2957343380
2025-06-19 14:13:52,REAL,2923292930,483,2923293413,2957343863
2025-06-19 14:13:54,REAL,2923293413,485,2923293898,2957344348
2025-06-19 14:13:56,REAL,2923293898,490,2923294388,2957344838
2025-06-19 14:13:58,FAKE,2923294388,244,2923294632,2957345317
2025-06-19 14:14:00,REAL,2923294632,479,2923295111,2957345796
2025-06-19 14:14:02,FAKE,2923295111,238,2923295349,2957346278
2025-06-19 14:14:04,FAKE,2923295349,241,2923295590,2957346760
2025-06-19 14:14:06,FAKE,2923295590,238,2923295828,2957347246
2025-06-19 14:14:08,REAL,2923295828,488,2923296316,2957347734
2025-06-19 14:14:10,REAL,2923296316,490,2923296806,2957348224
2025-06-19 14:14:12,FAKE,2923296806,238,2923297044,2957348710
2025-06-19 14:14:14,REAL,2923297044,482,2923297526,2957349192
2025-06-19 14:14:16,REAL,2923297526,483,2923298009,2957349675
2025-06-19 14:14:18,REAL,2923298009,479,2923298488,2957350154
2025-06-19 14:14:20,REAL,2923298488,483,2923298971,2957350637
2025-06-19 14:14:22,FAKE,2923298971,238,2923299209,2957351125
2025-06-19 14:14:24,FAKE,2923299209,244,2923299453,2957351662
2025-06-19 14:14:26,FAKE,2923299453,244,2923299697,2957352152
2025-06-19 14:14:28,FAKE,2923299697,244,2923299941,2957360231
2025-06-19 14:14:30,FAKE,2923299941,243,2923300184,2957371155
2025-06-19 14:14:32,REAL,2923300184,10308,2923310492,2957381463
2025-06-19 14:14:34,REAL,2923310492,10311,2923320803,2957391774
2025-06-19 14:14:36,FAKE,2923320803,243,2923321046,2957402031
2025-06-19 14:14:38,REAL,2923321046,10317,2923331363,2957412348
2025-06-19 14:14:40,REAL,2923331363,10249,2923341612,2957422597
2025-06-19 14:14:42,REAL,2923341612,8934,2923350546,2957431531
2025-06-19 14:14:44,REAL,2923350546,487,2923351033,2957432018
2025-06-19 14:14:46,FAKE,2923351033,244,2923351277,2957432505
2025-06-19 14:14:48,REAL,2923351277,484,2923351761,2957432989
2025-06-19 14:14:50,REAL,2923351761,476,2923352237,2957433465
2025-06-19 14:14:52,REAL,2923352237,482,2923352719,2957433947
2025-06-19 14:14:54,REAL,2923352719,9940,2923362659,2957443887
2025-06-19 14:14:56,REAL,2923362659,11698,2923374357,2957455585
2025-06-19 14:14:58,REAL,2923374357,10912,2923385269,2957466497
2025-06-19 14:15:00,REAL,2923385269,9658,2923394927,2957476155
2025-06-19 14:15:02,REAL,2923394927,10248,2923405175,2957486403
2025-06-19 14:15:04,REAL,2923405175,10323,2923415498,2957496726
2025-06-19 14:15:06,REAL,2923415498,10246,2923425744,2957506972
2025-06-19 14:15:08,REAL,2923425744,8595,2923434339,2957515567
2025-06-19 14:15:10,REAL,2923434339,474,2923434813,2957516041
2025-06-19 14:15:12,REAL,2923434813,480,2923435293,2957516521
2025-06-19 14:15:14,REAL,2923435293,537,2923435830,2957517058
2025-06-19 14:15:16,REAL,2923435830,487,2923436317,2957517545
2025-06-19 14:15:18,REAL,2923436317,484,2923436801,2957518029
2025-06-19 14:15:20,FAKE,2923436801,243,2923437044,2957518517
2025-06-19 14:15:22,REAL,2923437044,475,2923437519,2957518992
2025-06-19 14:15:24,FAKE,2923437519,238,2923437757,2957519474
2025-06-19 14:15:26,REAL,2923437757,475,2923438232,2957519949
2025-06-19 14:15:28,REAL,2923438232,483,2923438715,2957520432
2025-06-19 14:15:30,REAL,2923438715,477,2923439192,2957520909
2025-06-19 14:15:32,REAL,2923439192,542,2923439734,2957521451
2025-06-19 14:15:34,FAKE,2923439734,243,2923439977,2957521931
2025-06-19 14:15:36,REAL,2923439977,482,2923440459,2957522413
2025-06-19 14:15:38,REAL,2923440459,481,2923440940,2957522894
2025-06-19 14:15:40,REAL,2923440940,486,2923441426,2957523380
2025-06-19 14:15:42,REAL,2923441426,490,2923441916,2957523870
2025-06-19 14:15:44,REAL,2923441916,482,2923442398,2957524352
2025-06-19 14:15:46,REAL,2923442398,483,2923442881,2957524835
2025-06-19 14:15:48,REAL,2923442881,490,2923443371,2957525325
2025-06-19 14:15:50,REAL,2923443371,481,2923443852,2957525806
2025-06-19 14:15:52,REAL,2923443852,484,2923444336,2957526290
2025-06-19 14:15:54,FAKE,2923444336,241,2923444577,2957526772
2025-06-19 14:15:56,REAL,2923444577,481,2923445058,2957527253
2025-06-19 14:15:58,REAL,2923445058,533,2923445591,2957527786
2025-06-19 14:16:00,REAL,2923445591,492,2923446083,2957528278
2025-06-19 14:16:02,REAL,2923446083,490,2923446573,2957528768
2025-06-19 14:16:04,REAL,2923446573,485,2923447058,2957529253
2025-06-19 14:16:06,REAL,2923447058,481,2923447539,2957529734
2025-06-19 14:16:08,REAL,2923447539,483,2923448022,2957530217
2025-06-19 14:16:10,FAKE,2923448022,238,2923448260,2957530709
2025-06-19 14:16:12,FAKE,2923448260,241,2923448501,2957531190
2025-06-19 14:16:14,REAL,2923448501,478,2923448979,2957531668
2025-06-19 14:16:16,FAKE,2923448979,238,2923449217,2957532158
2025-06-19 14:16:18,REAL,2923449217,480,2923449697,2957532638
2025-06-19 14:16:20,REAL,2923449697,492,2923450189,2957533130
2025-06-19 14:16:22,REAL,2923450189,547,2923450736,2957533677
2025-06-19 14:16:24,REAL,2923450736,489,2923451225,2957534166
2025-06-19 14:16:26,FAKE,2923451225,241,2923451466,2957534641
2025-06-19 14:16:28,REAL,2923451466,491,2923451957,2957535132
2025-06-19 14:16:30,FAKE,2923451957,238,2923452195,2957535616
2025-06-19 14:16:32,REAL,2923452195,479,2923452674,2957536095
2025-06-19 14:16:34,REAL,2923452674,487,2923453161,2957536582
2025-06-19 14:16:36,FAKE,2923453161,241,2923453402,2957537064
2025-06-19 14:16:38,FAKE,2923453402,243,2923453645,2957537539
2025-06-19 14:16:40,REAL,2923453645,10375,2923464020,2957547914
2025-06-19 14:16:42,REAL,2923464020,10324,2923474344,2957558238
2025-06-19 14:16:44,REAL,2923474344,10249,2923484593,2957568487
2025-06-19 14:16:46,REAL,2923484593,10250,2923494843,2957578737
2025-06-19 14:16:48,FAKE,2923494843,238,2923495081,2957588989
2025-06-19 14:16:50,FAKE,2923495081,243,2923495324,2957599313
2025-06-19 14:16:52,REAL,2923495324,10251,2923505575,2957609564
2025-06-19 14:16:54,FAKE,2923505575,243,2923505818,2957616384
2025-06-19 14:16:56,REAL,2923505818,487,2923506305,2957616871
2025-06-19 14:16:58,FAKE,2923506305,241,2923506546,2957617353
2025-06-19 14:17:00,REAL,2923506546,4916,2923511462,2957622269
2025-06-19 14:17:02,REAL,2923511462,10912,2923522374,2957633181
2025-06-19 14:17:04,REAL,2923522374,10315,2923532689,2957643496
2025-06-19 14:17:06,REAL,2923532689,10253,2923542942,2957653749
2025-06-19 14:17:08,REAL,2923542942,10250,2923553192,2957663999
2025-06-19 14:17:10,REAL,2923553192,10254,2923563446,2957674253
2025-06-19 14:17:12,REAL,2923563446,10319,2923573765,2957684572
2025-06-19 14:17:14,REAL,2923573765,10254,2923584019,2957694826
2025-06-19 14:17:16,REAL,2923584019,1539,2923585558,2957696365
2025-06-19 14:17:18,FAKE,2923585558,241,2923585799,2957696843
2025-06-19 14:17:20,REAL,2923585799,484,2923586283,2957697327
2025-06-19 14:17:22,FAKE,2923586283,244,2923586527,2957697809
2025-06-19 14:17:24,REAL,2923586527,543,2923587070,2957698352
2025-06-19 14:17:26,FAKE,2923587070,241,2923587311,2957698834
2025-06-19 14:17:28,REAL,2923587311,487,2923587798,2957699321
2025-06-19 14:17:30,REAL,2923587798,481,2923588279,2957699802
2025-06-19 14:17:32,REAL,2923588279,6894,2923595173,2957706696
2025-06-19 14:17:34,REAL,2923595173,13620,2923608793,2957720316
2025-06-19 14:17:36,FAKE,2923608793,243,2923609036,2957730628
2025-06-19 14:17:38,FAKE,2923609036,244,2923609280,2957740875
2025-06-19 14:17:40,REAL,2923609280,10247,2923619527,2957751122
2025-06-19 14:17:42,REAL,2923619527,10318,2923629845,2957761440
2025-06-19 14:17:44,REAL,2923629845,10248,2923640093,2957771688
2025-06-19 14:17:46,REAL,2923640093,10247,2923650340,2957781935
2025-06-19 14:17:48,REAL,2923650340,942,2923651282,2957782877
2025-06-19 14:17:50,FAKE,2923651282,244,2923651526,2957783365
2025-06-19 14:17:52,FAKE,2923651526,243,2923651769,2957783847
2025-06-19 14:17:54,FAKE,2923651769,238,2923652007,2957784332
2025-06-19 14:17:56,REAL,2923652007,477,2923652484,2957784809
2025-06-19 14:17:58,REAL,2923652484,475,2923652959,2957785284
2025-06-19 14:18:00,REAL,2923652959,487,2923653446,2957785771
2025-06-19 14:18:02,REAL,2923653446,485,2923653931,2957786256
2025-06-19 14:18:04,REAL,2923653931,493,2923654424,2957786749
2025-06-19 14:18:06,REAL,2923654424,540,2923654964,2957787289
2025-06-19 14:18:08,REAL,2923654964,474,2923655438,2957787763
2025-06-19 14:18:10,REAL,2923655438,489,2923655927,2957788252
2025-06-19 14:18:12,REAL,2923655927,482,2923656409,2957788734
2025-06-19 14:18:14,FAKE,2923656409,238,2923656647,2957789217
2025-06-19 14:18:16,REAL,2923656647,483,2923657130,2957789700
2025-06-19 14:18:18,REAL,2923657130,490,2923657620,2957790190
2025-06-19 14:18:20,FAKE,2923657620,243,2923657863,2957790671
2025-06-19 14:18:22,REAL,2923657863,539,2923658402,2957791210
2025-06-19 14:18:24,REAL,2923658402,481,2923658883,2957791691
2025-06-19 14:18:26,REAL,2923658883,478,2923659361,2957792169
2025-06-19 14:18:28,REAL,2923659361,490,2923659851,2957792659
2025-06-19 14:18:30,FAKE,2923659851,238,2923660089,2957793148
2025-06-19 14:18:32,REAL,2923660089,487,2923660576,2957793635
2025-06-19 14:18:34,REAL,2923660576,477,2923661053,2957794112
2025-06-19 14:18:36,REAL,2923661053,480,2923661533,2957794592
2025-06-19 14:18:38,FAKE,2923661533,238,2923661771,2957795073
2025-06-19 14:18:40,REAL,2923661771,478,2923662249,2957795551
2025-06-19 14:18:42,FAKE,2923662249,244,2923662493,2957796033
2025-06-19 14:18:44,REAL,2923662493,538,2923663031,2957796571
2025-06-19 14:18:46,FAKE,2923663031,243,2923663274,2957797054
2025-06-19 14:18:48,REAL,2923663274,485,2923663759,2957797539
2025-06-19 14:18:50,FAKE,2923663759,238,2923663997,2957798023
2025-06-19 14:18:52,REAL,2923663997,484,2923664481,2957798507
2025-06-19 14:18:54,REAL,2923664481,487,2923664968,2957798994
2025-06-19 14:18:56,FAKE,2923664968,241,2923665209,2957799476
2025-06-19 14:18:58,REAL,2923665209,481,2923665690,2957799957
2025-06-19 14:19:00,REAL,2923665690,492,2923666182,2957800449
2025-06-19 14:19:02,REAL,2923666182,485,2923666667,2957800934
2025-06-19 14:19:04,REAL,2923666667,478,2923667145,2957801412
2025-06-19 14:19:06,REAL,2923667145,480,2923667625,2957801892
2025-06-19 14:19:08,REAL,2923667625,484,2923668109,2957802376
2025-06-19 14:19:10,REAL,2923668109,486,2923668595,2957802862
2025-06-19 14:19:12,REAL,2923668595,541,2923669136,2957803403
2025-06-19 14:19:14,REAL,2923669136,485,2923669621,2957803888
2025-06-19 14:19:16,REAL,2923669621,491,2923670112,2957804379
2025-06-19 14:19:18,REAL,2923670112,485,2923670597,2957804864
2025-06-19 14:19:20,FAKE,2923670597,244,2923670841,2957805353
2025-06-19 14:19:22,REAL,2923670841,541,2923671382,2957805894
2025-06-19 14:19:24,REAL,2923671382,481,2923671863,2957806375
2025-06-19 14:19:26,REAL,2923671863,485,2923672348,2957806860
2025-06-19 14:19:28,FAKE,2923672348,241,2923672589,2957807349
2025-06-19 14:19:30,FAKE,2923672589,243,2923672832,2957807831
2025-06-19 14:19:32,FAKE,2923672832,243,2923673075,2957808317
2025-06-19 14:19:34,FAKE,2923673075,244,2923673319,2957808799
2025-06-19 14:19:36,REAL,2923673319,478,2923673797,2957809277
2025-06-19 14:19:38,REAL,2923673797,486,2923674283,2957809763
2025-06-19 14:19:40,REAL,2923674283,487,2923674770,2957810250
2025-06-19 14:19:42,FAKE,2923674770,238,2923675008,2957810732
2025-06-19 14:19:44,FAKE,2923675008,244,2923675252,2957811219
2025-06-19 14:19:46,REAL,2923675252,474,2923675726,2957811693
2025-06-19 14:19:48,FAKE,2923675726,244,2923675970,2957812181
2025-06-19 14:19:50,FAKE,2923675970,244,2923676214,2957812667
2025-06-19 14:19:52,REAL,2923676214,488,2923676702,2957813155
2025-06-19 14:19:54,REAL,2923676702,490,2923677192,2957813645
2025-06-19 14:19:56,FAKE,2923677192,243,2923677435,2957814127
2025-06-19 14:19:58,REAL,2923677435,542,2923677977,2957814669
2025-06-19 14:20:00,REAL,2923677977,489,2923678466,2957815158
2025-06-19 14:20:02,REAL,2923678466,537,2923679003,2957815695
2025-06-19 14:20:04,REAL,2923679003,485,2923679488,2957816180
2025-06-19 14:20:06,REAL,2923679488,485,2923679973,2957816665
2025-06-19 14:20:08,REAL,2923679973,478,2923680451,2957817143
2025-06-19 14:20:10,FAKE,2923680451,243,2923680694,2957817626
2025-06-19 14:20:12,REAL,2923680694,488,2923681182,2957818114
2025-06-19 14:20:14,REAL,2923681182,487,2923681669,2957818601
2025-06-19 14:20:16,REAL,2923681669,483,2923682152,2957819084
2025-06-19 14:20:18,FAKE,2923682152,244,2923682396,2957819564
2025-06-19 14:20:20,REAL,2923682396,477,2923682873,2957820041
2025-06-19 14:20:22,REAL,2923682873,487,2923683360,2957820528
2025-06-19 14:20:24,FAKE,2923683360,238,2923683598,2957821007
2025-06-19 14:20:26,REAL,2923683598,486,2923684084,2957821493
2025-06-19 14:20:28,REAL,2923684084,479,2923684563,2957821972
2025-06-19 14:20:30,FAKE,2923684563,241,2923684804,2957822448
2025-06-19 14:20:32,REAL,2923684804,488,2923685292,2957822936
2025-06-19 14:20:34,REAL,2923685292,540,2923685832,2957823476
2025-06-19 14:20:36,FAKE,2923685832,244,2923686076,2957823959
2025-06-19 14:20:38,REAL,2923686076,9861,2923695937,2957833820
2025-06-19 14:20:40,REAL,2923695937,10511,2923706448,2957844331
2025-06-19 14:20:42,FAKE,2923706448,238,2923706686,2957854591
2025-06-19 14:20:44,REAL,2923706686,10252,2923716938,2957864843
2025-06-19 14:20:46,REAL,2923716938,10245,2923727183,2957875088
2025-06-19 14:20:48,REAL,2923727183,10322,2923737505,2957885410
2025-06-19 14:20:50,REAL,2923737505,10256,2923747761,2957895666
2025-06-19 14:20:52,REAL,2923747761,7224,2923754985,2957902890
2025-06-19 14:20:54,FAKE,2923754985,241,2923755226,2957903375
2025-06-19 14:20:56,REAL,2923755226,482,2923755708,2957903857
2025-06-19 14:20:58,FAKE,2923755708,244,2923755952,2957904398
2025-06-19 14:21:00,REAL,2923755952,490,2923756442,2957904888
2025-06-19 14:21:02,FAKE,2923756442,243,2923756685,2957905367
2025-06-19 14:21:04,FAKE,2923756685,241,2923756926,2957905854
2025-06-19 14:21:06,REAL,2923756926,488,2923757414,2957906342
2025-06-19 14:21:08,FAKE,2923757414,244,2923757658,2957906830
2025-06-19 14:21:10,REAL,2923757658,484,2923758142,2957907314
2025-06-19 14:21:12,REAL,2923758142,538,2923758680,2957907852
2025-06-19 14:21:14,REAL,2923758680,486,2923759166,2957908338
2025-06-19 14:21:16,FAKE,2923759166,244,2923759410,2957908822
2025-06-19 14:21:18,FAKE,2923759410,238,2923759648,2957909305
2025-06-19 14:21:20,REAL,2923759648,540,2923760188,2957909845
2025-06-19 14:21:22,REAL,2923760188,479,2923760667,2957910324
2025-06-19 14:21:24,REAL,2923760667,485,2923761152,2957910809
2025-06-19 14:21:26,FAKE,2923761152,243,2923761395,2957911300
2025-06-19 14:21:28,REAL,2923761395,480,2923761875,2957911780
2025-06-19 14:21:30,REAL,2923761875,481,2923762356,2957912261
2025-06-19 14:21:32,FAKE,2923762356,243,2923762599,2957912748
2025-06-19 14:21:34,FAKE,2923762599,241,2923762840,2957913225
2025-06-19 14:21:36,REAL,2923762840,484,2923763324,2957913709
2025-06-19 14:21:38,REAL,2923763324,481,2923763805,2957914190
2025-06-19 14:21:40,REAL,2923763805,484,2923764289,2957914674
2025-06-19 14:21:42,REAL,2923764289,535,2923764824,2957915209
2025-06-19 14:21:44,REAL,2923764824,480,2923765304,2957915689
2025-06-19 14:21:46,REAL,2923765304,487,2923765791,2957916176
2025-06-19 14:21:48,REAL,2923765791,546,2923766337,2957916722
2025-06-19 14:21:50,REAL,2923766337,478,2923766815,2957917200
2025-06-19 14:21:52,FAKE,2923766815,244,2923767059,2957917683
2025-06-19 14:21:54,FAKE,2923767059,241,2923767300,2957918167
2025-06-19 14:21:56,REAL,2923767300,5772,2923773072,2957923939
2025-06-19 14:21:58,FAKE,2923773072,243,2923773315,2957934916
2025-06-19 14:22:00,REAL,2923773315,10251,2923783566,2957945167
2025-06-19 14:22:02,REAL,2923783566,10839,2923794405,2957956006
2025-06-19 14:22:04,FAKE,2923794405,238,2923794643,2957965667
2025-06-19 14:22:06,FAKE,2923794643,241,2923794884,2957975917
2025-06-19 14:22:08,REAL,2923794884,10311,2923805195,2957986228
2025-06-19 14:22:10,FAKE,2923805195,243,2923805438,2957996475
2025-06-19 14:22:12,REAL,2923805438,1150,2923806588,2957997625
2025-06-19 14:22:14,REAL,2923806588,480,2923807068,2957998105
2025-06-19 14:22:16,REAL,2923807068,488,2923807556,2957998593
2025-06-19 14:22:18,REAL,2923807556,11835,2923819391,2958010428
2025-06-19 14:22:20,REAL,2923819391,10254,2923829645,2958020682
2025-06-19 14:22:22,FAKE,2923829645,244,2923829889,2958030932
2025-06-19 14:22:24,REAL,2923829889,10322,2923840211,2958041254
2025-06-19 14:22:26,REAL,2923840211,10313,2923850524,2958051567
2025-06-19 14:22:28,REAL,2923850524,10251,2923860775,2958061818
2025-06-19 14:22:30,FAKE,2923860775,243,2923861018,2958072069
2025-06-19 14:22:32,REAL,2923861018,5697,2923866715,2958077766
2025-06-19 14:22:34,FAKE,2923866715,241,2923866956,2958078010
2025-06-19 14:22:36,FAKE,2923866956,238,2923867194,2958078502
2025-06-19 14:22:38,REAL,2923867194,7410,2923874604,2958085912
2025-06-19 14:22:40,REAL,2923874604,13487,2923888091,2958099399
2025-06-19 14:22:42,REAL,2923888091,10309,2923898400,2958109708
2025-06-19 14:22:44,REAL,2923898400,10243,2923908643,2958119951
2025-06-19 14:22:46,REAL,2923908643,10318,2923918961,2958130269
2025-06-19 14:22:48,FAKE,2923918961,244,2923919205,2958140517
2025-06-19 14:22:50,REAL,2923919205,10248,2923929453,2958150765
2025-06-19 14:22:52,FAKE,2923929453,238,2923929691,2958161025
2025-06-19 14:22:54,REAL,2923929691,619,2923930310,2958161644
2025-06-19 14:22:56,REAL,2923930310,485,2923930795,2958162129
2025-06-19 14:22:58,REAL,2923930795,481,2923931276,2958162610
2025-06-19 14:23:00,FAKE,2923931276,244,2923931520,2958163148
2025-06-19 14:23:02,REAL,2923931520,489,2923932009,2958163637
2025-06-19 14:23:04,FAKE,2923932009,241,2923932250,2958164175
2025-06-19 14:23:06,FAKE,2923932250,244,2923932494,2958164653
2025-06-19 14:23:08,REAL,2923932494,482,2923932976,2958165135
2025-06-19 14:23:10,REAL,2923932976,479,2923933455,2958165614
2025-06-19 14:23:12,REAL,2923933455,483,2923933938,2958166097
2025-06-19 14:23:14,FAKE,2923933938,244,2923934182,2958166575
2025-06-19 14:23:16,REAL,2923934182,479,2923934661,2958167054
2025-06-19 14:23:18,REAL,2923934661,491,2923935152,2958167545
2025-06-19 14:23:20,REAL,2923935152,534,2923935686,2958168079
2025-06-19 14:23:22,FAKE,2923935686,244,2923935930,2958168564
2025-06-19 14:23:24,REAL,2923935930,484,2923936414,2958169048
2025-06-19 14:23:26,FAKE,2923936414,243,2923936657,2958169532
2025-06-19 14:23:28,REAL,2923936657,476,2923937133,2958170008
2025-06-19 14:23:30,REAL,2923937133,481,2923937614,2958170489
2025-06-19 14:23:32,REAL,2923937614,482,2923938096,2958170971
2025-06-19 14:23:34,FAKE,2923938096,243,2923938339,2958171446
2025-06-19 14:23:36,FAKE,2923938339,241,2923938580,2958171923
2025-06-19 14:23:38,FAKE,2923938580,238,2923938818,2958172410
2025-06-19 14:23:40,REAL,2923938818,1155,2923939973,2958173565
2025-06-19 14:23:42,REAL,2923939973,12043,2923952016,2958185608
2025-06-19 14:23:44,REAL,2923952016,10249,2923962265,2958195857
2025-06-19 14:23:46,REAL,2923962265,10317,2923972582,2958206174
2025-06-19 14:23:48,REAL,2923972582,10252,2923982834,2958216426
2025-06-19 14:23:50,REAL,2923982834,10244,2923993078,2958226670
2025-06-19 14:23:52,FAKE,2923993078,243,2923993321,2958236986
2025-06-19 14:23:54,REAL,2923993321,10244,2924003565,2958247230
2025-06-19 14:23:56,REAL,2924003565,4711,2924008276,2958251941
2025-06-19 14:23:58,FAKE,2924008276,244,2924008520,2958252424
2025-06-19 14:24:00,FAKE,2924008520,244,2924008764,2958252905
2025-06-19 14:24:02,FAKE,2924008764,238,2924009002,2958253450
2025-06-19 14:24:04,FAKE,2924009002,243,2924009245,2958253937
2025-06-19 14:24:06,REAL,2924009245,476,2924009721,2958254413
2025-06-19 14:24:08,FAKE,2924009721,243,2924009964,2958254895
2025-06-19 14:24:10,REAL,2924009964,482,2924010446,2958255377
2025-06-19 14:24:12,REAL,2924010446,1884,2924012330,2958257261
2025-06-19 14:24:14,REAL,2924012330,14809,2924027139,2958272070
2025-06-19 14:24:16,FAKE,2924027139,243,2924027382,2958282323
2025-06-19 14:24:18,REAL,2924027382,10260,2924037642,2958292583
2025-06-19 14:24:20,REAL,2924037642,10252,2924047894,2958302835
2025-06-19 14:24:22,REAL,2924047894,10372,2924058266,2958313207
2025-06-19 14:24:24,REAL,2924058266,10256,2924068522,2958323463
2025-06-19 14:24:26,FAKE,2924068522,244,2924068766,2958333717
2025-06-19 14:24:28,REAL,2924068766,4111,2924072877,2958337828
2025-06-19 14:24:30,REAL,2924072877,485,2924073362,2958338313
2025-06-19 14:24:32,REAL,2924073362,479,2924073841,2958338792
2025-06-19 14:24:34,FAKE,2924073841,243,2924074084,2958339337
2025-06-19 14:24:36,FAKE,2924074084,238,2924074322,2958339815
2025-06-19 14:24:38,FAKE,2924074322,238,2924074560,2958340297
2025-06-19 14:24:40,FAKE,2924074560,244,2924074804,2958340786
2025-06-19 14:24:42,FAKE,2924074804,238,2924075042,2958341268
2025-06-19 14:24:44,FAKE,2924075042,243,2924075285,2958341743
2025-06-19 14:24:46,REAL,2924075285,480,2924075765,2958342223
2025-06-19 14:24:48,REAL,2924075765,484,2924076249,2958342707
2025-06-19 14:24:50,FAKE,2924076249,241,2924076490,2958343194
2025-06-19 14:24:52,FAKE,2924076490,244,2924076734,2958343680
2025-06-19 14:24:54,REAL,2924076734,487,2924077221,2958344167
2025-06-19 14:24:56,FAKE,2924077221,243,2924077464,2958344710
2025-06-19 14:24:58,REAL,2924077464,482,2924077946,2958345192
2025-06-19 14:25:00,REAL,2924077946,544,2924078490,2958345736
2025-06-19 14:25:02,REAL,2924078490,481,2924078971,2958346217
2025-06-19 14:25:04,FAKE,2924078971,243,2924079214,2958346694
2025-06-19 14:25:06,REAL,2924079214,487,2924079701,2958347181
2025-06-19 14:25:08,REAL,2924079701,481,2924080182,2958347662
2025-06-19 14:25:10,REAL,2924080182,490,2924080672,2958348152
2025-06-19 14:25:12,REAL,2924080672,484,2924081156,2958348636
2025-06-19 14:25:14,FAKE,2924081156,243,2924081399,2958349119
2025-06-19 14:25:16,REAL,2924081399,539,2924081938,2958349658
2025-06-19 14:25:18,REAL,2924081938,482,2924082420,2958350140
2025-06-19 14:25:20,REAL,2924082420,490,2924082910,2958350630
2025-06-19 14:25:22,FAKE,2924082910,243,2924083153,2958351117
2025-06-19 14:25:24,REAL,2924083153,477,2924083630,2958351594
2025-06-19 14:25:26,REAL,2924083630,3331,2924086961,2958354925
2025-06-19 14:25:28,REAL,2924086961,15600,2924102561,2958370525
2025-06-19 14:25:30,REAL,2924102561,10248,2924112809,2958380773
2025-06-19 14:25:32,FAKE,2924112809,238,2924113047,2958391088
2025-06-19 14:25:34,FAKE,2924113047,241,2924113288,2958403031
2025-06-19 14:25:36,FAKE,2924113288,238,2924113526,2958411586
2025-06-19 14:25:38,REAL,2924113526,10242,2924123768,2958421828
2025-06-19 14:25:40,REAL,2924123768,10301,2924134069,2958432129
2025-06-19 14:25:42,REAL,2924134069,2794,2924136863,2958434923
2025-06-19 14:25:44,FAKE,2924136863,241,2924137104,2958435400
2025-06-19 14:25:46,REAL,2924137104,483,2924137587,2958435883
2025-06-19 14:25:48,REAL,2924137587,480,2924138067,2958436363
2025-06-19 14:25:50,REAL,2924138067,480,2924138547,2958436843
2025-06-19 14:25:52,REAL,2924138547,486,2924139033,2958437329
2025-06-19 14:25:54,REAL,2924139033,489,2924139522,2958437818
2025-06-19 14:25:56,REAL,2924139522,494,2924140016,2958438312
2025-06-19 14:25:58,FAKE,2924140016,241,2924140257,2958438790
2025-06-19 14:26:00,REAL,2924140257,487,2924140744,2958439277
2025-06-19 14:26:02,FAKE,2924140744,238,2924140982,2958439757
2025-06-19 14:26:04,REAL,2924140982,478,2924141460,2958440235
2025-06-19 14:26:06,FAKE,2924141460,241,2924141701,2958440716
2025-06-19 14:26:08,REAL,2924141701,484,2924142185,2958441200
2025-06-19 14:26:10,REAL,2924142185,533,2924142718,2958441733
2025-06-19 14:26:12,FAKE,2924142718,238,2924142956,2958442214
2025-06-19 14:26:14,REAL,2924142956,483,2924143439,2958442697
2025-06-19 14:26:16,REAL,2924143439,478,2924143917,2958443175
2025-06-19 14:26:18,FAKE,2924143917,241,2924144158,2958443711
2025-06-19 14:26:20,REAL,2924144158,10258,2924154416,2958453969
2025-06-19 14:26:22,REAL,2924154416,10379,2924164795,2958464348
2025-06-19 14:26:24,REAL,2924164795,10246,2924175041,2958474594
2025-06-19 14:26:26,REAL,2924175041,10244,2924185285,2958484838
2025-06-19 14:26:28,REAL,2924185285,10244,2924195529,2958495082
2025-06-19 14:26:30,REAL,2924195529,10248,2924205777,2958505330
2025-06-19 14:26:32,REAL,2924205777,10318,2924216095,2958515648
2025-06-19 14:26:34,REAL,2924216095,6623,2924222718,2958522271
2025-06-19 14:26:36,REAL,2924222718,491,2924223209,2958522762
2025-06-19 14:26:38,REAL,2924223209,488,2924223697,2958523250
2025-06-19 14:26:40,REAL,2924223697,483,2924224180,2958523733
2025-06-19 14:26:42,FAKE,2924224180,241,2924224421,2958524215
2025-06-19 14:26:44,FAKE,2924224421,243,2924224664,2958524702
2025-06-19 14:26:46,FAKE,2924224664,241,2924224905,2958525179
2025-06-19 14:26:48,REAL,2924224905,486,2924225391,2958525665
2025-06-19 14:26:50,FAKE,2924225391,241,2924225632,2958526152
2025-06-19 14:26:52,FAKE,2924225632,241,2924225873,2958539968
2025-06-19 14:26:54,REAL,2924225873,10384,2924236257,2958550352
2025-06-19 14:26:56,REAL,2924236257,10313,2924246570,2958560665
2025-06-19 14:26:58,FAKE,2924246570,241,2924246811,2958570972
2025-06-19 14:27:00,REAL,2924246811,10246,2924257057,2958581218
2025-06-19 14:27:02,REAL,2924257057,10320,2924267377,2958591538
2025-06-19 14:27:04,REAL,2924267377,10253,2924277630,2958601791
2025-06-19 14:27:06,REAL,2924277630,6024,2924283654,2958607815
2025-06-19 14:27:08,FAKE,2924283654,241,2924283895,2958608299
2025-06-19 14:27:10,FAKE,2924283895,241,2924284136,2958608780
2025-06-19 14:27:12,REAL,2924284136,487,2924284623,2958609267
2025-06-19 14:27:14,REAL,2924284623,482,2924285105,2958609749
2025-06-19 14:27:16,FAKE,2924285105,244,2924285349,2958610227
2025-06-19 14:27:18,REAL,2924285349,486,2924285835,2958610713
2025-06-19 14:27:20,FAKE,2924285835,244,2924286079,2958611194
2025-06-19 14:27:22,FAKE,2924286079,241,2924286320,2958611671
2025-06-19 14:27:24,REAL,2924286320,484,2924286804,2958612155
2025-06-19 14:27:26,FAKE,2924286804,241,2924287045,2958612633
2025-06-19 14:27:28,REAL,2924287045,480,2924287525,2958613113
2025-06-19 14:27:30,REAL,2924287525,489,2924288014,2958613602
2025-06-19 14:27:32,REAL,2924288014,481,2924288495,2958614083
2025-06-19 14:27:34,REAL,2924288495,546,2924289041,2958614629
2025-06-19 14:27:36,REAL,2924289041,540,2924289581,2958615169
2025-06-19 14:27:38,REAL,2924289581,478,2924290059,2958615647
2025-06-19 14:27:40,REAL,2924290059,489,2924290548,2958616136
2025-06-19 14:27:42,REAL,2924290548,481,2924291029,2958616617
2025-06-19 14:27:44,REAL,2924291029,488,2924291517,2958617105
2025-06-19 14:27:46,FAKE,2924291517,244,2924291761,2958617593
2025-06-19 14:27:48,REAL,2924291761,484,2924292245,2958618077
2025-06-19 14:27:50,REAL,2924292245,476,2924292721,2958618553
2025-06-19 14:27:52,FAKE,2924292721,244,2924292965,2958619041
2025-06-19 14:27:54,REAL,2924292965,483,2924293448,2958619524
2025-06-19 14:27:56,REAL,2924293448,490,2924293938,2958620014
2025-06-19 14:27:58,REAL,2924293938,485,2924294423,2958620499
2025-06-19 14:28:00,REAL,2924294423,476,2924294899,2958620975
2025-06-19 14:28:02,REAL,2924294899,480,2924295379,2958621455
2025-06-19 14:28:04,FAKE,2924295379,238,2924295617,2958621934
2025-06-19 14:28:06,REAL,2924295617,486,2924296103,2958622420
2025-06-19 14:28:08,FAKE,2924296103,241,2924296344,2958622907
2025-06-19 14:28:10,REAL,2924296344,487,2924296831,2958623394
2025-06-19 14:28:12,FAKE,2924296831,238,2924297069,2958623872
2025-06-19 14:28:14,REAL,2924297069,485,2924297554,2958624357
2025-06-19 14:28:16,FAKE,2924297554,241,2924297795,2958624961
2025-06-19 14:28:18,FAKE,2924297795,243,2924298038,2958625437
2025-06-19 14:28:20,FAKE,2924298038,244,2924298282,2958625919
2025-06-19 14:28:22,REAL,2924298282,486,2924298768,2958626405
2025-06-19 14:28:24,FAKE,2924298768,244,2924299012,2958626892
2025-06-19 14:28:26,FAKE,2924299012,244,2924299256,2958635569
2025-06-19 14:28:28,FAKE,2924299256,243,2924299499,2958647991
2025-06-19 14:28:30,REAL,2924299499,10261,2924309760,2958658252
2025-06-19 14:28:32,REAL,2924309760,10250,2924320010,2958668502
2025-06-19 14:28:34,FAKE,2924320010,243,2924320253,2958678828
2025-06-19 14:28:36,REAL,2924320253,10248,2924330501,2958689076
2025-06-19 14:28:38,REAL,2924330501,10248,2924340749,2958699324
2025-06-19 14:28:40,REAL,2924340749,9203,2924349952,2958708527
2025-06-19 14:28:42,FAKE,2924349952,241,2924350193,2958709018
2025-06-19 14:28:44,FAKE,2924350193,241,2924350434,2958709557
2025-06-19 14:28:46,FAKE,2924350434,244,2924350678,2958710043
2025-06-19 14:28:48,REAL,2924350678,478,2924351156,2958710521
2025-06-19 14:28:50,REAL,2924351156,483,2924351639,2958711004
2025-06-19 14:28:52,FAKE,2924351639,244,2924351883,2958711497
2025-06-19 14:28:54,REAL,2924351883,478,2924352361,2958711975
2025-06-19 14:28:56,REAL,2924352361,477,2924352838,2958712452
2025-06-19 14:28:58,REAL,2924352838,477,2924353315,2958712929
2025-06-19 14:29:00,REAL,2924353315,491,2924353806,2958713420
2025-06-19 14:29:02,REAL,2924353806,485,2924354291,2958713905
2025-06-19 14:29:04,FAKE,2924354291,238,2924354529,2958714389
2025-06-19 14:29:06,REAL,2924354529,476,2924355005,2958714865
2025-06-19 14:29:08,FAKE,2924355005,244,2924355249,2958724546
2025-06-19 14:29:10,REAL,2924355249,11905,2924367154,2958736451
2025-06-19 14:29:12,FAKE,2924367154,238,2924367392,2958746827
2025-06-19 14:29:14,FAKE,2924367392,244,2924367636,2958757080
2025-06-19 14:29:16,REAL,2924367636,10314,2924377950,2958767394
2025-06-19 14:29:18,REAL,2924377950,10250,2924388200,2958777644
2025-06-19 14:29:20,REAL,2924388200,10322,2924398522,2958787966
2025-06-19 14:29:22,REAL,2924398522,8742,2924407264,2958796708
2025-06-19 14:29:24,REAL,2924407264,480,2924407744,2958797188
2025-06-19 14:29:26,REAL,2924407744,487,2924408231,2958797675
2025-06-19 14:29:28,REAL,2924408231,484,2924408715,2958798159
2025-06-19 14:29:30,REAL,2924408715,483,2924409198,2958798642
2025-06-19 14:29:32,REAL,2924409198,483,2924409681,2958799125
2025-06-19 14:29:34,REAL,2924409681,488,2924410169,2958799613
2025-06-19 14:29:36,FAKE,2924410169,244,2924410413,2958800096
2025-06-19 14:29:38,REAL,2924410413,486,2924410899,2958800582
2025-06-19 14:29:40,REAL,2924410899,532,2924411431,2958801114
2025-06-19 14:29:42,FAKE,2924411431,241,2924411672,2958801605
2025-06-19 14:29:44,FAKE,2924411672,243,2924411915,2958802079
2025-06-19 14:29:46,REAL,2924411915,483,2924412398,2958802562
2025-06-19 14:29:48,REAL,2924412398,480,2924412878,2958803042
2025-06-19 14:29:50,REAL,2924412878,545,2924413423,2958803587
2025-06-19 14:29:52,FAKE,2924413423,244,2924413667,2958804081
2025-06-19 14:29:54,FAKE,2924413667,243,2924413910,2958804565
2025-06-19 14:29:56,REAL,2924413910,490,2924414400,2958805055
2025-06-19 14:29:58,REAL,2924414400,487,2924414887,2958805542
2025-06-19 14:30:00,FAKE,2924414887,238,2924415125,2958806026
2025-06-19 14:30:02,REAL,2924415125,485,2924415610,2958806511
2025-06-19 14:30:04,FAKE,2924415610,244,2924415854,2958806993
2025-06-19 14:30:06,FAKE,2924415854,244,2924416098,2958807476
2025-06-19 14:30:08,FAKE,2924416098,241,2924416339,2958808017
2025-06-19 14:30:10,REAL,2924416339,478,2924416817,2958808495
2025-06-19 14:30:12,REAL,2924416817,487,2924417304,2958808982
2025-06-19 14:30:14,REAL,2924417304,485,2924417789,2958809467
2025-06-19 14:30:16,REAL,2924417789,491,2924418280,2958809958
2025-06-19 14:30:18,FAKE,2924418280,241,2924418521,2958810439
2025-06-19 14:30:20,REAL,2924418521,484,2924419005,2958810923
2025-06-19 14:30:22,REAL,2924419005,12248,2924431253,2958823171
2025-06-19 14:30:24,FAKE,2924431253,244,2924431497,2958833815
2025-06-19 14:30:26,REAL,2924431497,10249,2924441746,2958844064
2025-06-19 14:30:28,REAL,2924441746,10260,2924452006,2958854324
2025-06-19 14:30:30,REAL,2924452006,10256,2924462262,2958864580
2025-06-19 14:30:32,REAL,2924462262,10249,2924472511,2958874829
2025-06-19 14:30:34,REAL,2924472511,10244,2924482755,2958885073
2025-06-19 14:30:36,REAL,2924482755,7611,2924490366,2958892684
2025-06-19 14:30:38,REAL,2924490366,486,2924490852,2958893170
2025-06-19 14:30:40,REAL,2924490852,488,2924491340,2958893658
2025-06-19 14:30:42,REAL,2924491340,479,2924491819,2958894137
2025-06-19 14:30:44,REAL,2924491819,488,2924492307,2958894625
2025-06-19 14:30:46,REAL,2924492307,484,2924492791,2958895109
2025-06-19 14:30:48,REAL,2924492791,486,2924493277,2958895595
2025-06-19 14:30:50,FAKE,2924493277,238,2924493515,2958896081
2025-06-19 14:30:52,REAL,2924493515,479,2924493994,2958896560
2025-06-19 14:30:54,REAL,2924493994,12825,2924506819,2958909385
2025-06-19 14:30:56,FAKE,2924506819,244,2924507063,2958920235
2025-06-19 14:30:58,REAL,2924507063,10247,2924517310,2958930482
2025-06-19 14:31:00,REAL,2924517310,10320,2924527630,2958940802
2025-06-19 14:31:02,REAL,2924527630,10321,2924537951,2958951123
2025-06-19 14:31:04,FAKE,2924537951,238,2924538189,2958961430
2025-06-19 14:31:06,FAKE,2924538189,238,2924538427,2958971685
2025-06-19 14:31:08,REAL,2924538427,6887,2924545314,2958978572
2025-06-19 14:31:10,REAL,2924545314,475,2924545789,2958979047
2025-06-19 14:31:12,FAKE,2924545789,243,2924546032,2958979527
2025-06-19 14:31:14,FAKE,2924546032,244,2924546276,2958980014
2025-06-19 14:31:16,FAKE,2924546276,243,2924546519,2958980508
2025-06-19 14:31:18,REAL,2924546519,494,2924547013,2958981002
2025-06-19 14:31:20,REAL,2924547013,493,2924547506,2958981495
2025-06-19 14:31:22,REAL,2924547506,485,2924547991,2958981980
2025-06-19 14:31:24,FAKE,2924547991,243,2924548234,2958982463
2025-06-19 14:31:26,REAL,2924548234,478,2924548712,2958982941
2025-06-19 14:31:28,REAL,2924548712,478,2924549190,2958983419
2025-06-19 14:31:30,FAKE,2924549190,241,2924549431,2958983900
2025-06-19 14:31:32,REAL,2924549431,488,2924549919,2958984388
2025-06-19 14:31:34,REAL,2924549919,546,2924550465,2958984934
2025-06-19 14:31:36,REAL,2924550465,535,2924551000,2958985469
2025-06-19 14:31:38,REAL,2924551000,484,2924551484,2958985953
2025-06-19 14:31:40,FAKE,2924551484,238,2924551722,2958986438
2025-06-19 14:31:42,REAL,2924551722,485,2924552207,2958986923
2025-06-19 14:31:44,REAL,2924552207,483,2924552690,2958987406
2025-06-19 14:31:46,REAL,2924552690,486,2924553176,2958987892
2025-06-19 14:31:48,FAKE,2924553176,241,2924553417,2958988368
2025-06-19 14:31:50,REAL,2924553417,480,2924553897,2958988848
2025-06-19 14:31:52,REAL,2924553897,485,2924554382,2958989333
2025-06-19 14:31:54,REAL,2924554382,478,2924554860,2958989811
2025-06-19 14:31:56,REAL,2924554860,492,2924555352,2958990303
2025-06-19 14:31:58,FAKE,2924555352,244,2924555596,2959001679
2025-06-19 14:32:00,REAL,2924555596,10254,2924565850,2959011933
2025-06-19 14:32:02,REAL,2924565850,10373,2924576223,2959022306
2025-06-19 14:32:04,FAKE,2924576223,243,2924576466,2959032553
2025-06-19 14:32:06,FAKE,2924576466,241,2924576707,2959042866
2025-06-19 14:32:08,REAL,2924576707,10254,2924586961,2959053120
2025-06-19 14:32:10,FAKE,2924586961,244,2924587205,2959063439
2025-06-19 14:32:12,FAKE,2924587205,241,2924587446,2959069073
2025-06-19 14:32:14,FAKE,2924587446,241,2924587687,2959069564
2025-06-19 14:32:16,FAKE,2924587687,243,2924587930,2959070050
2025-06-19 14:32:18,FAKE,2924587930,238,2924588168,2959070527
2025-06-19 14:32:20,REAL,2924588168,492,2924588660,2959071019
2025-06-19 14:32:22,REAL,2924588660,482,2924589142,2959071501
2025-06-19 14:32:24,REAL,2924589142,484,2924589626,2959071985
2025-06-19 14:32:26,FAKE,2924589626,238,2924589864,2959072467
2025-06-19 14:32:28,REAL,2924589864,478,2924590342,2959072945
2025-06-19 14:32:30,FAKE,2924590342,243,2924590585,2959073479
2025-06-19 14:32:32,REAL,2924590585,490,2924591075,2959073969
2025-06-19 14:32:34,REAL,2924591075,479,2924591554,2959074448
2025-06-19 14:32:36,FAKE,2924591554,244,2924591798,2959074936
2025-06-19 14:32:38,REAL,2924591798,489,2924592287,2959075425
2025-06-19 14:32:40,FAKE,2924592287,241,2924592528,2959075964
2025-06-19 14:32:42,REAL,2924592528,488,2924593016,2959076452
2025-06-19 14:32:44,REAL,2924593016,486,2924593502,2959076938
2025-06-19 14:32:46,FAKE,2924593502,241,2924593743,2959077425
2025-06-19 14:32:48,FAKE,2924593743,241,2924593984,2959077904
2025-06-19 14:32:50,REAL,2924593984,484,2924594468,2959078388
2025-06-19 14:32:52,REAL,2924594468,481,2924594949,2959078869
2025-06-19 14:32:54,REAL,2924594949,476,2924595425,2959079345
2025-06-19 14:32:56,FAKE,2924595425,238,2924595663,2959079826
2025-06-19 14:32:58,REAL,2924595663,483,2924596146,2959080309
2025-06-19 14:33:00,REAL,2924596146,477,2924596623,2959080786
2025-06-19 14:33:02,REAL,2924596623,482,2924597105,2959081268
2025-06-19 14:33:04,REAL,2924597105,489,2924597594,2959081757
2025-06-19 14:33:06,REAL,2924597594,535,2924598129,2959082292
2025-06-19 14:33:08,FAKE,2924598129,241,2924598370,2959082774
2025-06-19 14:33:10,REAL,2924598370,492,2924598862,2959083266
2025-06-19 14:33:12,REAL,2924598862,485,2924599347,2959083751
2025-06-19 14:33:14,FAKE,2924599347,244,2924599591,2959084236
2025-06-19 14:33:16,REAL,2924599591,484,2924600075,2959084720
2025-06-19 14:33:18,REAL,2924600075,490,2924600565,2959085210
2025-06-19 14:33:20,FAKE,2924600565,244,2924600809,2959085686
2025-06-19 14:33:22,REAL,2924600809,7842,2924608651,2959093528
2025-06-19 14:33:24,REAL,2924608651,10773,2924619424,2959104301
2025-06-19 14:33:26,REAL,2924619424,10256,2924629680,2959114557
2025-06-19 14:33:28,REAL,2924629680,10254,2924639934,2959124811
2025-06-19 14:33:30,REAL,2924639934,10321,2924650255,2959135132
2025-06-19 14:33:32,FAKE,2924650255,244,2924650499,2959145383
2025-06-19 14:33:34,REAL,2924650499,10244,2924660743,2959155627
2025-06-19 14:33:36,REAL,2924660743,8927,2924669670,2959164554
2025-06-19 14:33:38,REAL,2924669670,492,2924670162,2959165046
2025-06-19 14:33:40,FAKE,2924670162,238,2924670400,2959165589
2025-06-19 14:33:42,REAL,2924670400,491,2924670891,2959166080
2025-06-19 14:33:44,REAL,2924670891,483,2924671374,2959166563
2025-06-19 14:33:46,REAL,2924671374,484,2924671858,2959167047
2025-06-19 14:33:48,REAL,2924671858,489,2924672347,2959167536
2025-06-19 14:33:50,REAL,2924672347,490,2924672837,2959168026
2025-06-19 14:33:52,REAL,2924672837,480,2924673317,2959168506
2025-06-19 14:33:54,REAL,2924673317,487,2924673804,2959168993
2025-06-19 14:33:56,REAL,2924673804,489,2924674293,2959169482
2025-06-19 14:33:58,FAKE,2924674293,238,2924674531,2959169973
2025-06-19 14:34:00,FAKE,2924674531,244,2924674775,2959170455
2025-06-19 14:34:02,FAKE,2924674775,241,2924675016,2959170939
2025-06-19 14:34:04,REAL,2924675016,544,2924675560,2959171483
2025-06-19 14:34:06,REAL,2924675560,482,2924676042,2959171965
2025-06-19 14:34:08,FAKE,2924676042,244,2924676286,2959172441
2025-06-19 14:34:10,FAKE,2924676286,244,2924676530,2959172927
2025-06-19 14:34:12,REAL,2924676530,485,2924677015,2959173412
2025-06-19 14:34:14,FAKE,2924677015,243,2924677258,2959173894
2025-06-19 14:34:16,REAL,2924677258,546,2924677804,2959174440
2025-06-19 14:34:18,REAL,2924677804,489,2924678293,2959174929
2025-06-19 14:34:20,REAL,2924678293,484,2924678777,2959175413
2025-06-19 14:34:22,REAL,2924678777,483,2924679260,2959175896
2025-06-19 14:34:24,FAKE,2924679260,241,2924679501,2959176381
2025-06-19 14:34:26,REAL,2924679501,480,2924679981,2959176861
2025-06-19 14:34:28,REAL,2924679981,486,2924680467,2959177347
2025-06-19 14:34:30,REAL,2924680467,484,2924680951,2959177831
2025-06-19 14:34:32,REAL,2924680951,481,2924681432,2959178312
2025-06-19 14:34:34,REAL,2924681432,478,2924681910,2959178790
2025-06-19 14:34:36,REAL,2924681910,482,2924682392,2959179272
2025-06-19 14:34:38,REAL,2924682392,484,2924682876,2959179756
2025-06-19 14:34:40,FAKE,2924682876,244,2924683120,2959180242
2025-06-19 14:34:42,FAKE,2924683120,241,2924683361,2959180731
2025-06-19 14:34:44,REAL,2924683361,479,2924683840,2959181210
2025-06-19 14:34:46,FAKE,2924683840,238,2924684078,2959181692
2025-06-19 14:34:48,FAKE,2924684078,241,2924684319,2959182232
2025-06-19 14:34:50,FAKE,2924684319,243,2924684562,2959182773
2025-06-19 14:34:52,REAL,2924684562,476,2924685038,2959183249
2025-06-19 14:34:54,REAL,2924685038,485,2924685523,2959183734
2025-06-19 14:34:56,REAL,2924685523,484,2924686007,2959184218
2025-06-19 14:34:58,REAL,2924686007,9998,2924696005,2959194216
2025-06-19 14:35:00,REAL,2924696005,10376,2924706381,2959204592
2025-06-19 14:35:02,REAL,2924706381,10319,2924716700,2959214911
2025-06-19 14:35:04,FAKE,2924716700,243,2924716943,2959225220
2025-06-19 14:35:06,FAKE,2924716943,243,2924717186,2959235466
2025-06-19 14:35:08,FAKE,2924717186,243,2924717429,2959245777
2025-06-19 14:35:10,REAL,2924717429,10249,2924727678,2959256026
2025-06-19 14:35:12,REAL,2924727678,7081,2924734759,2959263107
2025-06-19 14:35:14,FAKE,2924734759,244,2924735003,2959263583
2025-06-19 14:35:16,FAKE,2924735003,241,2924735244,2959264067
2025-06-19 14:35:18,REAL,2924735244,483,2924735727,2959264550
2025-06-19 14:35:20,FAKE,2924735727,238,2924735965,2959265035
2025-06-19 14:35:22,FAKE,2924735965,244,2924736209,2959265521
2025-06-19 14:35:24,FAKE,2924736209,243,2924736452,2959266060
2025-06-19 14:35:26,REAL,2924736452,478,2924736930,2959266538
2025-06-19 14:35:28,REAL,2924736930,492,2924737422,2959267030
2025-06-19 14:35:30,REAL,2924737422,484,2924737906,2959267514
2025-06-19 14:35:32,REAL,2924737906,485,2924738391,2959267999
2025-06-19 14:35:34,REAL,2924738391,480,2924738871,2959268479
2025-06-19 14:35:36,REAL,2924738871,487,2924739358,2959268966
2025-06-19 14:35:38,FAKE,2924739358,244,2924739602,2959269452
2025-06-19 14:35:40,REAL,2924739602,547,2924740149,2959269999
2025-06-19 14:35:42,REAL,2924740149,484,2924740633,2959270483
2025-06-19 14:35:44,REAL,2924740633,486,2924741119,2959270969
2025-06-19 14:35:46,REAL,2924741119,483,2924741602,2959271452
2025-06-19 14:35:48,REAL,2924741602,486,2924742088,2959271938
2025-06-19 14:35:50,REAL,2924742088,483,2924742571,2959272421
2025-06-19 14:35:52,REAL,2924742571,486,2924743057,2959272907
2025-06-19 14:35:54,REAL,2924743057,476,2924743533,2959273383
2025-06-19 14:35:56,REAL,2924743533,476,2924744009,2959273859
2025-06-19 14:35:58,REAL,2924744009,482,2924744491,2959274341
2025-06-19 14:36:00,REAL,2924744491,532,2924745023,2959274873
2025-06-19 14:36:02,REAL,2924745023,484,2924745507,2959275357
2025-06-19 14:36:04,FAKE,2924745507,241,2924745748,2959275838
2025-06-19 14:36:06,FAKE,2924745748,241,2924745989,2959276328
2025-06-19 14:36:08,FAKE,2924745989,238,2924746227,2959276817
2025-06-19 14:36:10,REAL,2924746227,486,2924746713,2959277303
2025-06-19 14:36:12,REAL,2924746713,491,2924747204,2959277794
2025-06-19 14:36:14,REAL,2924747204,489,2924747693,2959278283
2025-06-19 14:36:16,REAL,2924747693,487,2924748180,2959278770
2025-06-19 14:36:18,REAL,2924748180,493,2924748673,2959279263
2025-06-19 14:36:20,FAKE,2924748673,241,2924748914,2959279745
